sku_id,cate,brand,type_1,type_2,type_3,type_4,type_5,type_6,type_all
138778,8,403,17209,872,354,74,105,29432,48046
61226,8,30,21525,609,243,33,128,33309,55847
72348,5,159,16638,753,276,62,138,27324,45191
103126,4,174,7618,245,127,21,34,12863,20908
137328,6,159,4503,96,55,6,35,6488,11183
4732,6,375,13364,641,290,105,92,18834,33326
27659,4,752,4870,158,91,10,25,9412,14566
6998,8,545,2969,95,43,6,11,4619,7743
127189,5,159,15970,655,286,31,147,25037,42126
24679,8,658,8536,291,89,31,59,14752,23758
22387,8,30,625,12,4,0,1,1304,1946
145895,8,693,15836,558,281,19,96,25571,42361
107774,10,36,3260,65,35,0,14,4663,8037
87598,9,78,1720,54,36,4,13,2622,4449
153817,6,165,2175,55,31,3,12,3141,5417
123773,8,693,12741,363,146,24,63,19872,33209
41958,6,269,4758,150,57,6,38,7655,12664
126791,5,479,20164,721,287,47,180,33190,54589
91145,9,640,2959,53,35,5,20,5319,8391
13931,5,159,37656,1373,561,73,253,58302,98218
162108,4,306,17667,400,213,29,89,29025,47423
151327,8,403,45352,1940,721,134,256,73071,121474
165290,4,885,28598,796,451,53,137,42561,72596
9112,5,78,7465,250,123,16,53,11610,19517
11261,4,174,4075,141,88,13,20,6882,11219
136001,7,24,1343,17,10,2,5,1975,3352
115863,8,124,4432,151,51,12,23,7646,12315
157850,7,118,7285,271,122,62,44,10776,18560
5825,8,885,42710,1805,684,127,246,68944,114516
66968,4,231,23669,676,254,89,122,37985,62795
91043,5,306,1315,31,15,2,11,1846,3220
37368,9,95,29,1,0,0,0,29,59
104317,4,885,846,29,17,0,6,1617,2515
102034,5,78,14930,490,162,22,103,23823,39530
89434,5,159,28,0,0,0,0,32,60
15168,6,78,26576,528,250,25,130,40369,67878
83348,7,484,669,13,9,1,2,933,1627
143981,4,752,39274,944,406,44,256,64591,105515
157381,8,214,1126,11,4,0,4,1751,2896
122497,4,36,10113,267,135,15,71,18133,28734
126266,4,752,11346,162,77,2,71,15770,27428
170497,6,78,1774,39,30,1,8,2587,4439
146353,6,174,2714,184,91,36,31,4095,7151
34199,10,36,3283,59,30,1,48,15125,18546
93621,6,375,1264,36,21,7,8,1886,3222
88414,4,519,30806,446,302,46,123,53411,85134
73515,4,200,12529,280,136,10,55,21062,34072
6866,4,800,6612,270,130,49,36,10610,17707
12540,8,545,5875,210,86,15,51,9057,15294
36692,4,174,20555,524,234,42,127,33872,55354
73134,9,95,27,1,1,0,1,32,62
81131,7,38,11207,374,150,39,65,19612,31447
51852,4,306,13183,379,167,42,84,22875,36730
74655,4,752,11077,254,152,7,53,21848,33391
61796,4,752,19204,533,203,44,124,36041,56149
129711,7,630,3722,191,124,16,14,5510,9577
51307,4,752,5330,194,102,13,37,12053,17729
149290,9,302,456,9,3,1,1,723,1193
125188,5,479,57512,2041,861,175,432,88716,149737
117882,4,519,59565,1148,589,87,258,94363,156010
22030,8,403,1309,48,20,1,9,2230,3617
43449,8,693,3903,105,39,5,21,6178,10251
136276,7,587,14234,397,156,52,82,22790,37711
8952,4,885,810,10,4,0,7,1412,2243
87630,4,885,715,1,1,0,1,879,1597
116489,8,545,23421,724,285,71,132,34301,58934
117144,4,885,33553,682,281,31,180,48936,83663
150041,6,306,37794,1116,559,44,223,56045,95781
54209,6,306,52867,1592,692,117,347,78283,133898
166345,9,306,12882,943,509,102,60,20068,34564
80082,6,800,1624,49,37,5,13,3151,4879
169935,4,519,16900,182,84,8,52,24210,41436
98971,4,800,1278,28,22,4,4,2200,3536
116597,8,812,1883,51,22,1,13,3160,5130
141395,6,570,151,7,3,0,0,254,415
20719,4,519,76497,1948,785,303,338,125283,205154
28502,5,306,4228,127,69,2,32,6323,10781
115851,8,885,14847,541,227,42,88,22915,38660
28276,4,519,76066,1965,725,363,349,129514,208982
6931,6,570,84,6,3,0,1,162,256
56797,5,489,12570,541,301,102,72,17957,31543
22140,6,306,52484,1897,837,185,335,78758,134496
21457,8,214,16042,408,173,16,98,25278,42015
68774,9,630,5477,359,200,26,23,8158,14243
137805,4,159,23330,613,326,33,112,39200,63614
106647,4,885,16197,438,219,21,90,26557,43522
147796,8,489,37973,1352,567,73,146,61809,101920
86806,4,174,37,1,0,0,0,95,133
140741,7,587,21991,509,262,53,92,34925,57832
80499,4,752,21590,578,286,35,92,37135,59716
30199,5,159,2925,77,43,3,26,4478,7552
10711,5,118,210,7,2,0,0,384,603
43960,4,174,9284,361,183,23,56,14534,24441
68718,4,752,12835,376,182,30,81,23648,37152
92555,5,306,4046,109,73,15,19,5589,9851
7199,4,306,21037,587,310,51,106,32595,54686
143294,5,225,615,12,6,0,2,989,1624
128121,5,159,2443,67,29,5,15,3566,6125
158793,6,375,2433,75,27,5,15,3928,6483
157009,5,159,3157,95,47,2,22,4860,8183
2100,4,800,46022,1177,612,82,186,74278,122357
70888,6,885,1660,63,35,9,7,2477,4251
169819,8,214,50046,1499,624,39,314,74307,126829
121201,10,653,631,20,8,1,1,1062,1723
7295,4,199,10471,361,203,60,52,16891,28038
32796,4,675,19835,402,209,44,58,27934,48482
66220,4,658,5645,143,95,9,27,8321,14240
59259,4,658,14186,347,227,39,85,24430,39314
45656,9,640,48363,1345,665,118,224,73607,124322
55528,4,159,21430,545,243,31,79,35337,57665
8753,4,36,7543,262,141,19,55,13674,21694
31998,9,640,1882,90,31,6,12,2931,4952
1286,6,51,3187,94,26,11,11,5054,8383
26190,5,78,267,6,4,0,1,461,739
130017,4,658,4752,189,75,12,22,8123,13173
10677,4,800,22491,527,312,33,79,34845,58287
88975,8,214,1005,22,7,0,3,1570,2607
121196,6,489,5835,115,67,12,27,8475,14531
102166,6,375,15063,521,255,41,86,22560,38526
117175,9,640,181,1,0,0,2,275,459
170981,4,453,949,19,6,2,3,1513,2492
131473,5,489,148,1,0,0,0,214,363
78551,9,640,1699,2,1,0,13,3316,5031
42199,8,545,24623,1124,436,87,160,42227,68657
85518,4,200,7582,223,112,18,46,14180,22161
62330,4,200,8547,220,119,19,39,13245,22189
163680,4,306,24635,812,414,120,125,38115,64221
17529,7,693,3358,181,78,37,17,5552,9223
70491,6,306,44944,1507,702,164,339,66527,114183
105352,6,306,12019,349,130,11,78,19580,32167
107659,5,78,58,1,0,0,0,82,141
90621,8,306,7787,319,139,13,43,13069,21370
165190,4,800,72075,1867,862,143,333,116137,191417
22962,4,885,58377,1455,595,181,342,95213,156163
134176,7,587,3281,86,29,7,21,5490,8914
113675,4,453,34570,1004,529,33,191,51549,87876
126641,4,453,12947,379,211,29,72,19596,33234
71596,6,570,178,4,4,0,1,259,446
52283,4,306,7160,286,143,25,34,12159,19807
120803,4,375,5212,162,142,9,37,8556,14118
78894,4,375,9308,227,117,10,38,14888,24588
140511,8,214,192,0,0,0,0,279,471
117929,5,427,829,74,27,13,4,1534,2481
20308,8,306,24185,1037,400,91,161,38940,64814
42214,5,78,133,2,1,0,1,186,323
167985,8,214,4407,62,30,0,24,6481,11004
106895,5,800,1825,85,51,6,9,3067,5043
64167,4,752,4395,121,86,5,22,8543,13172
167890,9,4,115,5,4,0,0,169,293
94577,7,157,2311,46,27,6,7,3694,6091
112258,6,78,1112,10,11,0,5,1569,2707
32216,4,800,784,12,8,0,3,1309,2116
79122,6,51,5057,162,75,18,37,7449,12798
97289,4,658,1755,39,22,0,9,2940,4765
77571,8,489,26377,802,301,27,193,40776,68476
169331,7,587,1490,35,15,2,3,2312,3857
34608,5,78,52,0,0,0,0,81,133
37546,6,489,16591,715,300,90,111,23876,41683
83325,4,453,23617,620,261,27,145,34168,58838
133005,4,800,2675,120,56,11,18,5032,7912
134683,6,800,6507,278,102,24,47,10148,17106
55092,8,306,5687,137,51,4,31,10240,16150
75750,8,812,1712,35,12,1,6,2951,4717
24048,4,36,15670,538,240,45,97,25899,42489
155223,9,640,11926,307,125,27,58,18899,31342
124685,5,78,114,1,1,0,1,168,285
6533,8,214,52582,1615,689,35,309,79351,134581
114568,5,479,36657,1391,601,111,253,56075,95088
27203,7,489,356,6,5,0,0,548,915
98253,8,306,5678,111,45,3,29,9059,14925
105243,9,374,161,4,1,1,1,268,436
145586,9,630,678,0,0,0,4,2093,2775
113475,4,427,762,14,13,1,2,1188,1980
46136,6,200,158,3,3,0,0,187,351
20819,6,306,35707,1052,501,61,260,54574,92155
161168,9,374,54,3,2,0,0,94,153
17470,8,30,7853,313,121,29,57,13336,21709
60770,4,658,602,11,3,1,0,1009,1626
32465,8,489,107159,3873,1370,229,644,170981,284256
118238,7,306,7549,284,134,54,46,13281,21348
79080,6,269,20307,646,323,37,116,29996,51425
60755,6,489,20001,663,330,33,154,29838,51019
163550,4,306,17206,615,281,82,83,29866,48133
132879,5,159,881,22,4,2,5,1420,2334
152872,8,306,22238,758,301,26,136,36111,59570
73398,8,306,14600,623,213,34,110,25777,41357
126146,8,800,31732,1403,487,156,245,45969,79992
46906,5,489,15551,562,280,47,139,25457,42036
81462,8,489,48380,1199,509,46,319,71076,121529
163287,5,78,467,9,1,1,4,720,1202
37057,6,489,27749,959,379,43,201,42623,71954
7196,6,235,13430,704,354,91,91,20591,35261
122222,5,78,138,3,0,0,0,169,310
55456,7,587,7068,155,85,16,24,11277,18625
47290,8,403,58,0,0,0,0,77,135
39533,9,489,691,26,10,0,2,1042,1771
63006,8,214,194471,6296,2190,420,1205,311101,515683
62400,6,159,6178,162,84,4,40,9329,15797
95976,5,225,18368,633,278,62,133,29633,49107
101664,8,693,19134,384,187,17,86,28033,47841
83276,7,157,839,9,6,1,5,1083,1943
40454,9,95,89,1,1,0,0,112,203
18585,5,159,14414,620,284,66,93,22704,38181
100202,7,157,387,13,7,2,1,584,994
10321,8,214,910,48,13,1,6,1466,2444
170626,6,78,32872,994,474,78,188,47443,82049
57018,8,545,77007,3562,1187,307,571,119543,202177
123016,8,693,5145,176,75,16,40,8016,13468
40623,7,489,5822,164,66,16,49,10139,16256
105971,5,479,19832,755,333,125,145,30029,51219
139840,4,36,13499,484,202,61,76,20963,35285
36159,9,374,40,0,2,0,0,67,109
142606,4,174,8214,170,72,14,41,12618,21129
59252,4,174,11882,293,116,10,53,19372,31726
53658,8,306,460,2,2,0,4,564,1032
86551,5,479,13186,436,208,50,78,22439,36397
28443,6,165,12793,377,174,21,69,20098,33532
152762,4,174,1111,39,18,1,3,1790,2962
122369,6,235,12984,525,256,64,78,21336,35243
133121,5,306,6596,130,61,6,41,10399,17233
109287,4,375,891,24,14,0,1,1598,2528
124758,4,375,2673,111,60,11,12,5187,8054
45980,6,78,40912,1475,581,57,249,58132,101406
68615,8,403,15580,563,208,22,92,24347,40812
26229,9,640,30719,741,367,72,110,46657,78666
127313,8,306,494,0,0,0,4,618,1116
107012,8,306,42547,1445,598,49,227,64594,109460
52830,4,453,13742,483,239,21,94,21628,36207
58568,8,214,7063,143,46,5,45,10939,18241
136526,4,658,15157,410,279,78,59,23135,39118
93070,6,78,6257,109,41,4,31,10717,17159
102488,4,658,15059,437,243,25,74,23566,39404
25003,5,489,23919,943,382,101,173,36916,62434
77008,5,306,21842,748,373,112,138,33291,56504
1628,8,214,5633,62,27,0,17,9019,14758
167707,4,923,725,24,20,2,2,1177,1950
134817,6,124,3264,96,54,5,28,5543,8990
159184,6,124,7597,269,123,18,54,13030,21091
65174,6,269,3608,165,105,17,21,5343,9259
81163,6,306,25759,651,280,26,184,39372,66272
78508,4,885,24539,708,334,69,138,44774,70562
11809,5,479,700,9,5,1,7,1138,1860
23077,4,675,198,1,1,0,0,350,550
18412,8,214,75100,2688,1012,191,425,126310,205726
37578,5,78,22554,759,374,66,127,33059,56939
129413,4,519,120,0,0,0,3,148,271
26466,4,752,2901,45,15,2,24,4792,7779
147652,4,658,12682,422,205,47,61,20291,33708
135272,4,519,116736,2870,1144,456,502,184305,306013
160070,9,640,5822,139,58,8,30,8240,14297
168043,6,269,10930,393,198,34,76,16488,28119
20529,10,66,269,4,2,1,1,501,778
51752,6,71,1892,43,30,1,8,2779,4753
50763,9,306,401,0,0,0,4,1120,1525
103234,8,214,32942,574,248,21,160,54212,88157
83690,9,306,1099,0,0,0,6,2508,3613
1914,6,306,7463,233,152,10,69,11635,19562
10018,11,545,360,24,0,0,1,477,862
128286,6,174,2969,113,57,9,13,4288,7449
126109,6,174,643,16,15,1,4,948,1627
16579,9,640,16152,444,175,43,83,23568,40465
142831,9,78,2695,85,46,6,16,3860,6708
87057,7,216,8845,243,81,35,46,17340,26590
79520,8,489,49675,2098,840,172,337,79566,132688
2866,9,630,8680,35,14,0,80,13594,22403
48780,9,489,131,5,3,0,1,224,364
62655,4,581,12028,422,233,57,68,19567,32375
126655,5,489,293,5,5,0,3,479,785
16146,7,56,1845,40,19,6,11,2726,4647
8218,7,24,3219,70,35,13,9,4703,8049
155721,7,741,4290,108,43,10,20,7074,11545
12564,8,214,194920,6035,2258,359,1183,312005,516760
168573,5,124,27511,1099,460,130,132,39045,68377
124470,7,157,20605,677,286,98,110,31219,52995
99993,7,741,3872,150,71,19,21,6206,10339
70411,4,231,18847,463,190,46,111,32933,52590
21183,4,174,658,18,11,1,4,1182,1874
157909,9,630,9680,344,178,17,71,15400,25690
140996,7,842,1872,54,25,1,11,3208,5171
7431,8,244,622,39,13,0,1,1277,1952
72967,4,519,98130,1899,622,349,450,168230,269680
2448,6,174,1690,109,46,11,8,2413,4277
43062,8,306,12198,369,176,17,62,19605,32427
122461,4,36,8985,240,100,8,54,14672,24059
93490,8,812,1039,54,17,3,8,1711,2832
49758,5,479,20956,969,433,158,126,31919,54561
124500,7,38,10136,293,152,27,52,15869,26529
48895,8,489,32948,836,342,31,206,50963,85326
2378,7,306,9719,390,168,57,35,16778,27147
137196,4,581,6919,286,143,39,43,11899,19329
135859,7,587,18997,511,325,63,73,29458,49427
82752,6,78,209,4,2,0,2,411,628
136856,5,174,79,0,0,0,1,120,200
40336,8,545,32996,1216,388,121,251,55062,90034
129945,4,890,2265,76,53,9,13,3439,5855
153051,7,741,11550,315,137,38,65,17522,29627
165594,9,640,14187,475,236,37,79,21858,36872
153551,8,489,33260,935,346,52,222,52335,87150
107309,9,842,1880,149,98,14,4,2641,4786
152194,8,214,1161,19,12,2,5,2045,3244
84875,8,30,4,0,0,0,0,7,11
123578,8,214,4872,137,40,7,34,8091,13181
65914,4,200,32886,953,400,44,159,51494,85936
82103,4,174,5482,210,88,23,45,9570,15418
109349,9,842,13354,419,199,26,60,21425,35483
30971,7,489,2616,107,45,10,25,4306,7109
62351,8,306,16768,781,321,63,113,27609,45655
119632,4,800,1717,33,27,0,7,3380,5164
13891,4,174,570,33,17,3,6,979,1608
156,6,261,8436,195,72,18,44,12423,21188
139585,9,78,1846,68,27,1,11,3037,4990
153698,8,306,8832,401,173,30,66,15311,24813
149841,5,306,33907,1060,510,57,296,58050,93880
69015,9,65,301,5,1,0,0,475,782
131300,8,693,52298,2045,781,168,368,80820,136480
34547,5,479,8039,262,127,33,34,11743,20238
126623,5,479,7069,297,150,59,52,11472,19099
79616,4,36,17905,598,299,87,91,28031,47011
158354,7,214,1788,25,16,0,7,2597,4433
26372,8,489,9340,176,101,5,46,14863,24531
134183,7,842,843,21,18,0,6,1376,2264
49474,5,479,37528,1272,679,97,233,54168,93977
170198,10,66,77,1,0,0,0,168,246
108328,5,800,7287,372,150,89,50,12450,20398
84525,9,489,2941,174,82,17,17,5154,8385
168520,9,800,658,16,8,2,8,1575,2267
116421,8,214,1502,22,10,2,9,2150,3695
121984,9,640,30,1,0,0,0,48,79
160750,8,403,14583,429,186,16,83,22624,37921
152478,8,306,62185,2194,920,154,336,99604,165393
51429,8,244,2261,88,33,2,5,3538,5927
95309,4,658,5270,111,74,4,23,9479,14961
113202,8,214,2985,28,14,1,21,4745,7794
39425,8,214,28909,757,384,37,195,53217,83499
13915,8,214,566,2,1,0,1,901,1471
51358,4,519,1936,54,26,4,11,2965,4996
151484,7,489,923,48,17,5,6,1545,2544
81330,9,640,8365,228,120,16,40,14532,23301
108399,8,403,12404,428,165,18,71,18329,31415
47193,8,403,31835,1061,419,52,179,48333,81879
77109,4,174,3028,122,63,13,21,5204,8451
123453,8,214,105,0,0,0,0,172,277
75679,11,693,448,25,0,1,0,476,950
19233,8,857,1052,22,9,2,6,1591,2682
168230,8,214,3886,28,23,2,20,5735,9694
128026,7,842,139,4,1,1,1,211,357
96306,4,174,6653,183,125,13,36,9661,16671
10628,7,306,5784,236,113,22,31,10365,16551
39139,7,306,19677,571,257,63,113,32193,52874
162658,8,306,5436,132,70,2,38,10134,15812
97909,4,200,642,19,9,1,5,965,1641
139087,5,306,4412,113,72,4,30,6753,11384
170400,5,78,40020,1470,609,131,282,57469,99981
134084,8,693,17337,772,310,62,122,28506,47109
8875,4,36,3565,139,59,20,21,6518,10322
149400,7,489,3742,112,54,15,27,7107,11057
64151,5,306,10115,363,221,47,69,14384,25199
112819,4,174,2668,113,64,10,14,5045,7914
151743,4,658,7197,267,137,24,24,11987,19636
127838,5,78,15350,437,181,23,90,22502,38583
109728,8,489,29543,784,320,32,234,46077,76990
9702,8,693,22304,861,343,65,163,34637,58373
28870,6,263,2093,56,29,3,12,2939,5132
51938,4,885,384,0,0,0,1,514,899
133124,4,174,502,2,2,0,1,817,1324
50922,4,174,5058,174,102,5,30,9028,14397
85246,5,200,11245,310,151,18,87,16170,27981
140908,5,78,137,3,2,0,0,233,375
77743,5,78,3855,77,43,2,12,5961,9950
25685,9,145,633,6,4,0,2,828,1473
88448,9,341,1243,17,7,0,3,1718,2988
53785,4,174,9893,360,164,14,61,16383,26875
80462,8,30,8690,317,127,25,51,13672,22882
43873,4,174,11078,267,143,13,60,17830,29391
81708,8,489,26766,1179,462,77,203,43058,71745
128416,6,306,25026,666,275,31,163,39382,65543
88126,4,923,953,18,14,3,1,1404,2393
5888,4,519,27378,678,417,73,117,43117,71780
145460,6,78,2298,40,23,3,8,3329,5701
130947,5,78,2503,86,40,2,20,3465,6116
167184,8,489,1776,48,18,2,12,2567,4423
123263,8,214,3362,31,18,3,16,5654,9084
99415,5,479,10390,447,147,114,70,15409,26577
155998,4,581,2209,98,47,3,10,4677,7044
14163,8,306,43031,1296,522,38,229,64038,109154
11487,5,404,3,0,0,0,0,4,7
98445,4,581,6428,167,109,18,31,11508,18261
45034,8,545,76,5,3,0,1,108,193
98634,4,581,26971,720,382,71,108,43707,71959
157601,7,80,38,3,1,1,1,57,101
102735,7,80,236,6,4,0,2,378,626
116441,7,80,1030,41,11,5,5,1381,2473
97474,4,658,182,0,2,0,2,295,481
58756,6,165,1356,47,29,5,2,2268,3707
87127,6,78,3856,117,76,2,27,5753,9831
140921,4,174,25181,918,397,64,146,41129,67835
97149,5,124,88,4,2,1,0,136,231
58789,7,56,1087,171,37,48,9,1424,2776
168828,7,306,3067,77,30,7,21,4901,8103
56550,6,124,18135,589,272,35,141,28992,48164
166876,8,693,16326,650,344,43,142,24587,42092
37957,8,489,55806,1414,545,49,349,86263,144426
107162,4,581,287,8,6,1,3,526,831
126906,8,403,15317,613,247,56,120,28090,44443
103594,4,800,17330,622,304,85,92,27496,45929
161251,9,630,7725,261,111,18,51,13188,21354
111778,4,306,43993,1091,436,126,232,76771,122649
144549,8,545,5182,227,74,12,38,8333,13866
46059,4,174,3601,129,74,10,18,6225,10057
24979,7,842,7617,326,191,26,31,11887,20078
145328,9,842,434,10,8,1,3,621,1077
124256,4,800,336,4,4,0,3,515,862
111981,5,800,735,26,13,6,2,1919,2701
63231,4,174,12128,374,172,62,45,19472,32253
166536,9,302,17,0,0,0,0,29,46
126394,8,545,5211,169,85,3,42,8676,14186
155792,4,453,7775,241,137,21,47,11872,20093
85687,6,306,537,8,4,0,4,1100,1653
79636,8,489,36832,1487,542,106,267,59583,98817
86227,6,124,16131,461,214,25,98,25819,42748
36240,8,489,658,8,5,0,3,1042,1716
125699,5,489,9726,547,162,96,74,14683,25288
86246,5,124,6337,181,81,15,55,9534,16203
45678,7,489,11205,306,146,47,59,17955,29718
47895,8,489,47823,1245,439,55,308,70820,120690
160926,9,800,12,0,0,0,0,35,47
92145,6,124,418,4,6,0,4,655,1087
83140,7,741,781,34,23,1,1,1861,2701
54357,6,489,53607,2280,1085,270,356,79110,136708
148782,7,489,2030,87,46,17,17,4651,6848
96959,9,489,10631,368,177,60,51,15633,26920
90402,7,38,12127,328,144,36,73,19736,32444
47408,4,658,28884,848,358,60,139,46278,76567
30916,7,508,5,0,0,0,0,7,12
39253,8,403,10116,315,153,14,59,17485,28142
94944,8,800,16896,450,189,19,88,26963,44605
151424,5,124,115,2,0,0,0,165,282
136405,9,640,3979,102,73,7,26,7862,12049
43855,8,489,1259,33,9,0,6,3492,4799
84397,6,159,1193,21,16,0,12,1567,2809
60861,8,489,21829,769,294,46,171,34372,57481
139435,4,519,29,1,1,0,1,63,95
160501,6,514,708,14,10,2,3,1044,1781
20591,8,214,311,6,2,0,1,465,785
140183,9,341,138,1,2,0,0,254,395
28796,7,587,706,26,13,2,1,1084,1832
24371,8,545,78902,2597,1034,124,457,112663,195777
45173,6,800,7803,365,135,78,54,12399,20834
92712,6,200,6449,198,98,4,32,9258,16039
107481,7,741,2296,79,32,14,11,3762,6194
129010,8,545,10023,354,226,17,64,17102,27786
69623,7,741,17470,616,261,95,108,26025,44575
148421,8,214,9225,173,51,13,65,14546,24073
134286,4,691,11125,360,177,41,59,19556,31318
104129,6,200,13987,437,181,27,99,21451,36182
103161,6,200,768,14,9,0,1,1033,1825
94106,9,78,254,5,2,0,1,384,646
115215,8,800,11226,434,196,30,71,19112,31069
25263,9,800,845,22,9,0,12,1765,2653
103132,8,545,26689,941,323,59,192,44323,72527
124286,7,741,9521,331,167,38,53,14747,24857
139695,9,640,795,9,7,0,8,1190,2009
118464,7,216,304,8,3,0,0,498,813
7434,4,306,6829,207,126,27,25,10315,17529
87901,6,489,9898,307,150,17,58,16064,26494
26043,6,200,414,6,6,0,2,658,1086
19823,5,238,290,11,6,1,2,489,799
38741,5,489,4598,127,61,18,22,7174,12000
123277,9,570,72,0,0,0,0,119,191
6699,9,367,1739,50,26,3,6,2818,4642
74499,4,174,2941,107,49,7,13,4745,7862
162128,4,658,1133,56,35,2,6,2003,3235
141167,8,427,3417,149,70,9,19,6460,10124
55143,8,427,2347,103,41,12,15,4293,6811
114550,5,78,4018,104,69,6,37,6327,10561
91393,8,244,6139,201,73,12,26,10398,16849
112031,6,269,11775,359,141,25,67,17140,29507
86604,6,693,10168,455,264,62,63,15936,26948
157031,6,200,836,18,10,2,4,1181,2051
93267,6,225,89,0,0,0,1,103,193
123980,5,124,1048,32,16,2,8,1986,3092
38955,8,214,2989,98,39,2,20,4723,7871
34697,8,214,5729,110,69,7,34,10916,16865
57161,8,489,32024,1195,478,54,211,49721,83683
63206,4,375,14278,408,213,27,81,23675,38682
15259,8,545,36190,1450,574,75,237,53664,92190
27255,9,374,177,6,4,0,2,316,505
149223,8,658,4026,158,52,13,24,6764,11037
146233,9,374,97,5,4,1,0,180,287
106971,4,36,7963,256,139,26,40,14158,22582
112244,6,232,50,1,1,0,1,87,140
72055,7,648,2718,48,26,5,12,4461,7270
92380,10,653,342,7,4,0,1,630,984
128567,8,306,19597,744,282,26,121,32401,53171
146593,7,489,8075,318,156,35,61,13798,22443
117452,8,677,2723,121,54,4,33,4984,7919
165997,6,235,1939,118,59,18,4,3378,5516
19590,7,630,856,28,19,2,3,1651,2559
28754,8,214,1194,14,8,0,8,2060,3284
81495,8,812,743,21,10,1,8,1127,1910
30479,7,216,18898,479,220,47,93,33568,53305
3448,8,885,575,7,3,1,4,969,1559
86521,8,403,321,1,0,0,1,664,987
28413,7,216,5527,142,83,5,16,9933,15706
20739,7,693,7952,299,142,60,41,13259,21753
102335,4,375,6767,244,142,34,39,12186,19412
58262,5,306,2549,74,35,11,12,3832,6513
73775,7,157,652,18,12,1,1,1146,1830
37427,6,489,38226,1344,636,69,234,58211,98720
103114,6,78,11578,419,175,33,64,16856,29125
112550,6,306,10623,469,224,61,62,16113,27552
59366,5,225,21489,820,348,74,159,37374,60264
23016,4,800,2272,66,30,1,11,3827,6207
165614,5,306,23249,796,297,104,186,38242,62874
901,8,214,1467,29,11,1,16,2404,3928
26249,4,212,375,5,3,0,2,589,974
140702,8,623,803,3,8,0,5,1130,1949
166707,8,489,50325,2129,738,160,315,77041,130708
499,8,214,3371,30,16,1,19,4955,8392
18133,4,800,307,11,11,1,0,456,786
7832,9,630,1657,36,21,0,10,2489,4213
52343,8,489,106721,4620,1683,245,702,168273,282244
88295,8,489,29473,1028,368,62,184,46131,77246
7881,8,885,6469,208,109,12,38,10849,17685
79460,4,200,799,7,7,0,3,1116,1932
5505,8,214,61126,2031,818,109,380,104047,168511
2677,8,427,3366,86,46,7,25,6182,9712
99425,7,489,27533,961,423,127,141,44424,73609
22705,10,752,0,0,0,0,8,2807,2815
14319,5,200,193,8,5,0,2,263,471
95850,8,800,8818,377,127,22,50,13819,23213
153807,6,885,3711,111,47,11,18,5788,9686
120509,7,216,1810,44,18,3,10,4185,6070
34851,5,489,4049,244,95,41,19,6301,10749
3882,8,489,1334,21,12,0,6,2000,3373
24520,8,214,2001,13,9,4,6,3113,5146
90456,5,479,10292,370,199,29,69,16870,27829
32876,4,885,21548,659,312,58,103,34643,57323
1041,9,367,191,0,0,0,1,350,542
122179,6,200,1722,19,17,0,10,2327,4095
160143,9,640,534,12,6,0,3,731,1286
29827,6,306,10203,344,178,42,52,16066,26885
52757,9,640,986,25,22,0,2,1477,2512
130992,4,36,760,15,5,2,0,1179,1961
166341,8,489,86,0,0,0,0,417,503
78285,6,306,12309,349,175,34,65,17988,30920
15598,4,658,1858,43,29,4,9,3132,5075
147622,4,36,6812,204,106,23,48,12285,19478
154636,8,545,145897,5779,2003,691,769,220151,375290
138310,5,489,1311,33,16,2,6,1971,3339
32361,8,885,738,21,11,0,4,5062,5836
55813,10,653,119,0,0,0,0,184,303
128193,8,489,385,2,0,0,0,1767,2154
10281,8,766,892,19,9,1,6,1443,2370
150957,8,677,1123,30,10,4,9,2069,3245
75906,4,752,2169,32,18,0,18,3956,6193
31448,5,375,619,25,18,2,3,852,1519
116470,4,36,11051,368,155,21,70,18788,30453
106487,4,800,7752,233,124,30,53,12851,21043
97025,8,885,31058,1319,513,79,200,49444,82613
93295,8,30,8595,255,112,6,58,13443,22469
72354,9,489,2718,177,103,16,7,4673,7694
164544,8,30,12866,409,173,30,85,22643,36206
118051,4,752,12621,236,103,16,96,27043,40115
19042,4,800,5387,145,74,9,35,9727,15377
78694,8,244,14106,436,148,33,86,22295,37104
141680,5,375,115,5,5,0,0,154,279
35464,5,489,19233,929,375,223,130,28953,49843
112332,8,214,17178,605,285,25,117,28215,46425
58639,5,375,398,27,20,6,2,645,1098
50986,4,306,10855,339,159,38,62,18757,30210
78335,8,30,6048,158,79,4,48,10214,16551
113494,4,159,14056,426,196,19,69,23066,37832
78327,4,885,9633,313,155,35,77,16847,27060
122720,8,124,364,0,0,0,2,631,997
104933,4,36,2497,86,30,13,12,5521,8159
80030,8,693,9638,228,109,7,61,16061,26104
122186,6,693,2779,254,139,11,20,3933,7136
54265,5,479,7166,136,93,8,31,13013,20447
137219,7,484,411,11,3,1,3,620,1049
61023,9,640,2877,94,39,7,21,7543,10581
52695,9,640,1706,0,0,0,8,4534,6248
54934,5,489,3363,171,67,41,12,4985,8639
49551,4,199,13370,363,179,48,41,21950,35951
75877,8,545,42300,1903,688,124,315,67124,112454
142240,4,519,1008,16,10,0,6,1317,2357
149462,6,165,2475,61,34,6,7,3795,6378
141243,9,842,25647,776,383,66,126,39211,66209
116746,8,214,3607,20,4,2,16,5678,9327
104937,6,269,4222,214,95,28,42,6581,11182
5916,6,800,21504,520,227,37,117,32859,55264
115727,5,159,1178,28,11,1,9,1778,3005
88312,7,306,32088,1061,510,144,156,48957,82916
166354,8,545,40115,1262,496,105,259,62284,104521
38953,7,489,50,1,0,0,0,93,144
11036,9,640,31975,876,385,81,140,52563,86020
4595,9,640,6088,153,69,18,37,9618,15983
156650,6,269,3332,151,68,25,24,5181,8781
92909,8,885,14983,412,167,13,84,22793,38452
8466,8,545,3483,39,17,3,14,4762,8318
125363,8,800,3592,93,39,3,17,6193,9937
21159,4,375,5526,190,82,27,32,8822,14679
65280,8,800,1181,50,23,3,1,2091,3349
94704,8,214,4469,101,40,2,28,7320,11960
3706,4,658,5032,212,100,21,26,8267,13658
124172,4,427,673,8,7,0,1,1084,1773
171182,8,812,528,17,7,0,7,990,1549
41103,6,269,1995,53,32,9,11,3389,5489
77275,4,658,2770,120,66,9,19,5081,8065
13207,4,200,7863,121,63,2,55,11190,19294
137795,4,890,722,23,15,0,4,938,1702
9069,6,885,9820,384,187,26,72,14843,25332
27254,8,427,4533,103,50,3,27,7813,12529
13007,7,587,7238,197,147,13,42,11883,19520
119697,4,199,5238,181,97,30,27,9244,14817
112141,6,306,21242,894,383,105,144,31788,54556
51670,8,658,1379,63,25,4,7,2680,4158
107120,4,800,2078,87,35,3,16,3367,5586
21916,8,214,742,1,0,1,0,992,1736
6774,9,741,1327,96,47,19,8,2181,3678
86619,8,306,2233,47,26,0,10,3469,5785
7418,7,306,20463,713,309,96,139,32967,54687
8244,9,640,1587,48,19,5,6,2105,3770
153102,8,693,494,0,0,0,3,671,1168
50705,4,200,1629,48,19,1,10,2138,3845
97007,6,269,24139,843,396,98,171,36932,62579
79514,4,752,5848,170,48,9,27,9966,16068
47419,5,427,1838,63,29,5,20,2706,4661
50365,6,200,3054,70,39,2,19,4208,7392
157215,7,306,14990,655,270,123,85,26146,42269
146386,7,306,3602,149,79,18,17,6626,10491
86803,4,427,221,10,11,0,1,441,684
108071,8,214,1305,7,3,1,2,2026,3344
44042,4,885,28701,665,286,44,139,46484,76319
29411,5,78,41902,1506,661,86,264,62447,106866
10598,9,306,10701,990,545,78,59,16203,28576
31962,5,479,5133,179,90,9,37,8748,14196
24648,4,752,1918,37,8,1,8,2887,4859
51706,8,693,581,0,0,0,3,849,1433
61394,4,885,7091,306,136,38,49,11926,19546
44957,4,885,5153,156,94,13,16,8956,14388
156484,7,306,37885,1186,560,153,210,57875,97869
32515,10,917,48,1,1,0,1,73,124
32529,4,36,8193,318,155,25,59,14454,23204
152524,8,214,1536,0,0,0,6,2205,3747
169990,4,752,713,14,7,1,6,989,1730
89555,8,677,731,24,16,0,5,1140,1916
139648,6,489,27791,1076,483,95,195,42027,71667
28159,7,306,1300,27,14,2,7,2179,3529
140458,4,36,8781,301,124,23,65,14702,23996
76637,4,200,776,21,11,0,4,1118,1930
22607,9,302,3645,168,76,17,10,5716,9632
124997,8,693,20546,648,240,55,122,32672,54283
97024,9,630,6406,606,311,41,27,10137,17528
18611,8,214,4258,7,4,0,12,6538,10819
150801,8,30,591,5,0,0,2,1214,1812
69534,10,917,4,0,0,0,0,12,16
148333,10,917,3,1,0,0,0,13,17
2192,10,917,1,0,0,0,0,13,14
77709,8,214,1106,4,2,0,1,1558,2671
136919,4,581,4806,134,69,27,30,7548,12614
153214,4,199,2424,91,60,10,16,4984,7585
108858,8,30,3397,107,35,13,17,6318,9887
86464,7,563,823,13,9,2,3,1291,2141
64230,4,675,1397,44,31,0,10,2194,3676
105085,10,40,94,1,1,0,0,106,202
7528,8,214,2417,61,27,2,16,4503,7026
25825,7,427,1965,47,33,5,13,3155,5218
130791,7,306,4543,160,85,14,29,7936,12767
23449,4,200,3352,47,32,1,14,4736,8182
20218,4,200,2038,51,27,3,10,2848,4977
10167,7,587,3103,66,38,12,15,4683,7917
17032,6,447,5519,123,44,6,22,8553,14267
135865,4,885,16768,357,188,22,84,26430,43849
85746,4,885,849,9,4,0,7,1339,2208
13035,8,214,419,1,1,0,2,736,1159
89720,7,207,78,2,1,0,0,171,252
87348,7,207,119,1,1,0,0,188,309
16203,4,306,4637,110,50,12,25,7416,12250
26951,4,200,782,14,9,1,1,980,1787
20248,6,885,2301,70,48,4,22,3784,6229
74782,8,658,1241,37,23,0,12,2088,3401
126918,6,159,3688,98,35,10,33,5331,9195
65785,5,693,19256,712,390,63,111,28625,49157
75588,5,306,33841,1113,551,117,280,55686,91588
130517,7,100,40,2,1,0,0,62,105
74900,4,36,18672,669,287,104,98,29486,49316
47057,6,269,1021,27,12,0,6,1519,2585
105559,8,214,3834,89,33,1,24,6444,10425
62877,8,214,2500,3,3,0,10,3842,6358
83144,8,693,9774,414,221,9,61,17176,27655
39265,10,200,28,0,0,0,0,41,69
151760,8,214,2344,26,13,0,10,3828,6221
128988,8,545,56826,2228,730,192,345,89850,150171
88798,6,885,4415,138,65,4,32,7313,11967
157595,4,581,6595,245,112,28,35,11424,18439
157367,10,701,152,0,0,0,2,272,426
45458,6,489,1267,35,37,6,11,1943,3299
141954,4,36,3330,132,79,11,23,6394,9969
19907,7,587,183,4,3,0,1,316,507
170413,8,214,575,1,1,0,4,825,1406
81226,6,269,92,0,0,0,0,160,252
68469,7,489,3561,56,22,1,13,5129,8782
146242,7,587,717,9,4,0,5,1009,1744
61516,7,587,1603,42,15,0,9,2488,4157
27651,10,29,4,0,0,0,0,5,9
77074,8,355,881,18,13,0,2,1532,2446
65675,4,752,254,1,1,0,2,411,669
94373,4,885,13727,497,242,93,65,21990,36614
63784,9,640,10551,261,147,18,51,14343,25371
5117,5,306,8708,299,148,44,46,13135,22380
66018,6,269,730,14,8,1,6,1048,1807
26588,6,159,2939,75,40,5,15,4074,7148
142140,8,30,14754,628,260,63,111,25417,41233
64197,7,306,7941,291,149,35,79,13738,22233
135334,8,30,587,12,5,0,4,988,1596
6754,8,214,5053,98,35,2,33,7884,13105
169404,10,797,43,1,1,0,0,74,119
37220,10,653,432,9,2,1,2,802,1248
68767,8,545,26943,1418,581,97,198,44715,73952
75006,5,885,965,36,24,3,8,1489,2525
42721,8,30,9382,326,169,23,72,16988,26960
3067,8,693,12423,529,248,44,100,19179,32523
91840,7,489,586,17,16,1,4,889,1513
26395,8,658,499,19,12,0,5,1037,1572
169374,10,200,37,1,1,0,0,52,91
70352,8,306,9188,142,51,8,59,17372,26820
44854,8,30,39810,1549,556,144,285,61469,103813
70873,8,693,5804,196,106,8,42,8812,14968
13110,5,225,3267,156,74,30,20,5723,9270
79106,8,623,1195,15,11,1,4,1656,2882
82251,4,36,1117,49,42,1,3,2732,3944
144305,6,200,2102,47,27,1,12,3101,5290
144742,5,306,10140,307,159,25,79,15477,26187
110904,5,693,13327,525,224,57,62,21026,35221
150835,10,111,299,4,1,1,1,462,768
80497,6,585,4394,224,113,48,37,7108,11924
42940,8,812,1048,26,8,0,4,1630,2716
71110,8,658,7416,305,136,14,47,12629,20547
148200,5,225,3923,186,84,41,22,6647,10903
44629,8,489,196,3,4,0,0,325,528
62872,8,658,3179,111,42,7,16,5641,8996
117892,11,489,81,8,0,0,0,94,183
140807,8,658,17117,451,230,27,105,26187,44117
140309,4,519,3045,45,42,0,14,4751,7897
124951,7,157,4596,137,63,20,16,6609,11441
54570,9,842,1826,41,16,4,4,3469,5360
71848,6,269,471,11,4,0,2,788,1276
47213,4,691,17457,605,212,115,71,25466,43926
97984,10,111,3058,56,28,1,10,4057,7210
62080,6,78,23601,738,273,42,163,35999,60816
109083,8,800,10100,445,143,41,73,15773,26575
145628,4,923,110,2,5,1,0,184,302
119079,7,74,1029,23,8,0,4,1527,2591
19436,7,74,17,0,0,0,0,16,33
50970,7,79,673,10,4,2,2,938,1629
47753,9,630,4371,151,84,6,18,7627,12257
60870,4,174,13392,341,147,30,68,21664,35642
60950,8,214,982,2,2,0,4,1615,2605
67829,8,812,1516,33,17,0,11,2133,3710
90902,6,489,25487,904,385,61,201,40038,67076
49940,4,159,1546,27,12,3,5,2176,3769
51762,8,812,295,4,5,0,2,464,770
36193,7,741,681,30,11,1,5,1255,1983
134555,8,885,953,43,17,0,3,1610,2626
109093,8,885,9728,389,134,15,68,14142,24476
37995,8,30,18891,652,259,45,116,29166,49129
21147,8,403,37752,1765,566,164,231,59943,100421
62629,5,570,125,0,0,0,0,193,318
42536,7,601,282,5,3,1,3,406,700
101001,8,885,1773,29,20,1,7,2846,4676
107427,10,790,667,10,7,1,3,964,1652
136020,7,427,2123,73,39,9,15,3044,5303
139847,7,306,3052,71,40,7,12,4552,7734
167310,8,214,6434,175,76,8,43,10102,16838
113161,8,800,257,7,2,1,4,471,742
158505,8,214,663,4,3,0,2,1020,1692
127367,8,214,1976,34,16,1,9,3549,5585
98592,10,752,0,0,0,0,11,3075,3086
150170,5,570,1948,62,37,3,8,2874,4932
95327,8,800,275,2,1,1,2,437,718
29593,8,545,309,4,3,0,3,470,789
48790,10,790,1251,18,14,0,8,1888,3179
83384,8,306,7079,108,46,6,43,13780,21062
56270,4,519,6288,31,30,2,32,9739,16122
169883,8,403,541,14,7,0,1,828,1391
83347,6,269,8877,260,152,9,66,13132,22496
160964,6,269,4891,152,57,3,30,7322,12455
41621,8,214,733,5,2,1,0,1027,1768
156471,5,78,47756,1738,683,67,286,67297,117827
51093,4,752,3468,69,28,2,14,4885,8466
57741,4,519,3609,65,22,0,8,5129,8833
167087,4,581,13763,410,199,37,69,22202,36680
48990,4,800,1377,52,26,3,7,2071,3536
85780,5,159,20455,967,368,61,155,35444,57450
112733,8,800,609,18,8,0,3,965,1603
75008,4,519,228,1,1,0,4,634,868
61178,4,174,452,18,10,0,0,758,1238
104388,4,519,325,7,5,0,1,689,1027
31662,8,545,72569,3357,1133,379,501,108983,186922
112750,7,306,2168,55,12,2,11,3942,6190
144635,8,306,4305,146,88,2,39,8371,12951
8929,9,306,2486,148,81,15,10,4164,6904
135376,4,453,46108,1454,551,102,257,67984,116456
12772,6,235,7292,216,106,9,41,12439,20103
111391,5,800,26045,1227,511,260,139,39861,68043
126335,8,812,627,13,7,0,5,1070,1722
104678,4,752,194,3,2,0,1,327,527
166697,8,214,1478,5,0,0,5,2189,3677
30460,8,800,169,6,1,0,0,228,404
24774,5,479,5381,269,104,40,21,8267,14082
107691,9,640,1341,10,0,0,0,1994,3345
128309,8,693,2172,61,26,5,17,3328,5609
59820,8,812,4520,112,53,7,29,6541,11262
30395,6,489,2121,42,23,2,13,3235,5436
2582,8,885,144,4,4,0,1,220,373
158979,4,453,1964,22,10,1,10,2615,4622
128462,8,655,1909,52,24,0,13,3135,5133
60656,4,375,603,18,10,0,2,1170,1803
60419,4,519,2000,44,10,2,12,3144,5212
6530,6,200,5857,166,77,5,33,9198,15336
163969,6,117,3364,88,61,3,18,4969,8503
19205,8,658,822,13,6,0,6,1433,2280
12046,10,36,739,10,4,0,3,1345,2101
14345,4,200,260,6,4,0,1,342,613
24219,4,453,163,0,0,2,0,189,354
93424,4,375,354,7,6,0,4,629,1000
95735,8,427,849,32,10,0,5,1610,2506
90891,6,518,89,0,0,0,0,147,236
72771,8,658,3551,114,52,8,23,5895,9643
121595,5,693,7554,237,147,23,48,11480,19489
41950,4,375,367,9,2,0,4,581,963
22784,5,800,930,17,5,0,3,1770,2725
26225,7,157,1699,55,44,7,8,2762,4575
53003,10,22,7,0,1,0,0,8,16
75398,4,174,1684,53,26,2,7,2681,4453
43109,4,800,2122,56,34,3,13,3464,5692
70309,9,367,1714,46,26,4,9,2435,4234
115495,8,214,4905,109,52,5,25,7914,13010
99141,6,159,831,11,8,0,10,1258,2118
65441,5,489,7270,291,131,30,55,12829,20606
12609,5,306,6633,266,125,57,33,10057,17171
110899,5,693,12710,447,255,46,76,19186,32720
145641,4,36,16052,466,157,27,108,28580,45390
23757,4,200,13231,319,159,13,74,22371,36167
50640,7,78,44,2,2,0,0,79,127
48091,5,693,5859,287,146,39,47,8392,14770
2474,5,159,235,2,2,0,3,381,623
25583,7,587,101,1,1,0,0,132,235
158864,8,812,1012,9,6,0,6,1910,2943
122299,6,200,333,9,6,0,0,577,925
108618,4,375,12505,332,158,22,84,21440,34541
32863,4,658,295,3,4,0,1,522,825
62377,10,355,67,2,0,1,0,78,148
48507,4,36,7032,274,133,18,46,12269,19772
159556,4,36,4387,137,76,4,28,7768,12400
135124,7,587,149,2,1,0,0,183,335
35636,7,214,186,0,0,0,0,288,474
164289,7,489,4988,207,102,46,18,7478,12839
20808,9,640,7295,306,148,20,23,10633,18425
138037,4,375,25936,865,383,156,113,40087,67540
97714,4,174,8204,231,139,18,38,12660,21290
13583,6,658,85,2,1,0,1,128,217
32322,10,172,465,9,6,0,6,698,1184
126018,5,693,9802,357,161,44,50,14712,25126
157508,8,214,616,19,9,1,6,919,1570
577,7,78,15,0,0,0,0,15,30
93994,4,752,9596,172,89,5,56,14449,24367
1468,7,741,7352,246,125,49,33,11454,19259
139100,5,159,22,0,0,0,0,39,61
108140,5,232,490,34,11,6,0,743,1284
144602,8,375,1126,37,13,1,9,1757,2943
168420,4,453,1973,27,13,2,13,3061,5089
167923,7,489,6083,287,102,44,37,9909,16462
30544,7,489,1374,28,22,0,8,2125,3557
156064,8,885,8279,355,129,28,60,13944,22795
162671,6,78,5594,167,65,8,30,7985,13849
131895,7,489,5922,231,92,29,25,10159,16458
9524,4,174,861,12,8,0,4,1242,2127
126092,5,489,8018,396,165,36,56,13199,21870
150354,6,306,4543,110,60,10,51,8012,12786
150879,4,36,6916,225,128,26,46,11384,18725
29727,4,453,5262,186,105,8,44,8871,14476
99780,4,800,66,0,0,0,0,105,171
66843,7,489,2317,80,42,7,9,4478,6933
63846,5,375,3720,205,86,57,27,5794,9889
140015,4,752,6040,112,57,3,26,9049,15287
8065,7,545,142,2,2,0,0,177,323
62863,8,489,45927,1411,637,58,242,79696,127971
149348,5,78,3008,93,51,4,27,4534,7717
44876,7,748,33,0,0,0,0,50,83
70893,10,797,2147,45,18,1,11,3156,5378
66022,9,640,1671,46,29,2,7,2530,4285
65469,4,891,2970,22,19,1,6,6352,9370
114668,4,174,1003,17,13,2,1,1579,2615
2069,7,489,393,6,6,2,4,567,978
101704,7,78,103,0,0,0,1,168,272
155389,7,306,11555,442,181,68,83,18471,30800
138639,7,489,215,0,0,0,0,320,535
159439,8,375,1577,62,25,3,8,2903,4578
36307,8,306,40366,1931,755,117,294,64662,108125
100894,5,489,1446,82,37,19,9,2494,4087
95155,8,214,181,0,0,0,0,276,457
61531,8,214,43939,1397,587,72,308,73635,119938
102755,6,159,335,2,1,0,1,516,855
85012,4,675,1053,21,10,0,8,1675,2767
50225,8,306,3376,66,36,2,24,6910,10414
26162,7,861,3708,40,27,2,12,5843,9632
152137,7,214,60,1,1,0,0,108,170
171183,6,165,5324,146,84,6,30,8353,13943
44724,8,306,1325,22,14,0,5,2637,4003
124431,8,306,3972,95,54,0,27,6706,10854
37510,7,861,614,15,5,1,1,1374,2010
105603,7,861,857,9,1,0,3,1500,2370
100178,7,861,386,6,4,0,2,924,1322
133589,6,235,105,0,0,0,0,150,255
1271,5,124,2061,30,16,3,9,2882,5001
22414,9,489,1743,59,34,8,11,3304,5159
151242,9,306,968,59,43,4,11,1591,2676
60199,4,159,2900,63,51,1,17,4970,8002
7975,6,165,2344,52,31,8,6,3354,5795
120107,5,58,53,1,1,0,0,93,148
165486,7,214,133,1,0,0,0,213,347
30183,10,917,5375,94,53,2,25,8267,13816
76223,7,175,1586,32,12,5,5,2565,4205
136243,7,489,19,0,0,0,0,16,35
5503,5,693,15263,285,167,38,83,22742,38578
74918,5,124,3016,67,33,6,11,4781,7914
112635,9,657,597,23,9,2,7,1103,1741
25706,6,200,82,1,0,0,1,91,175
81827,6,71,243,14,8,0,1,373,639
42959,4,658,7077,233,96,19,48,12390,19863
51384,4,36,15008,426,193,49,90,26229,41995
56171,8,214,1858,37,15,4,10,3054,4978
157597,8,214,6765,13,8,0,32,10865,17683
19062,7,306,3935,124,72,8,24,7044,11207
13334,8,214,32094,1233,573,22,232,56839,90993
39688,5,124,109,0,0,0,0,161,270
164532,5,124,1199,16,11,2,13,1803,3044
44605,6,200,12742,479,192,35,83,19691,33222
110107,4,174,1560,33,11,0,7,2313,3924
50688,8,306,5995,253,117,14,32,11046,17457
138041,7,306,990,18,14,2,9,1885,2918
70794,8,214,156,0,0,0,1,185,342
37441,6,78,4831,129,54,5,23,6770,11812
170284,6,885,1223,35,17,1,6,1893,3175
160693,10,474,13,1,1,0,0,23,38
47694,6,106,25,0,0,0,0,28,53
89939,7,489,341,9,8,1,4,598,961
126937,7,306,3722,115,64,11,25,7412,11349
93180,8,545,9435,116,66,1,60,16486,26164
47134,9,630,1391,46,29,2,7,1827,3302
66453,5,800,1610,47,31,4,13,3078,4783
67444,4,519,5953,115,43,4,26,8910,15051
66434,7,489,18384,545,205,60,95,28371,47660
128043,10,474,125,2,2,0,1,223,353
76924,8,545,3070,61,40,1,23,5658,8853
59724,5,124,2658,73,27,5,18,4572,7353
169,4,124,5547,131,76,3,35,8550,14342
76820,4,174,1894,35,9,1,11,3061,5011
31719,8,214,637,0,0,0,0,964,1601
111295,7,427,709,25,8,3,4,1288,2037
19253,5,306,24386,892,514,42,157,36979,62970
4372,7,207,990,17,6,0,2,1529,2544
51205,8,545,1714,49,30,1,15,2604,4413
82161,4,124,2119,61,27,4,14,3576,5801
111569,5,124,3470,113,38,10,27,5971,9629
1203,4,200,10550,365,161,19,56,16550,27701
159255,7,118,2332,106,48,19,5,4023,6533
93859,7,861,423,11,4,1,1,770,1210
166379,8,214,2539,59,24,4,17,4158,6801
64467,8,214,19576,506,279,28,140,35870,56399
49350,7,693,1394,60,38,5,10,2616,4123
116131,7,489,3824,122,62,19,25,7623,11675
25987,8,214,10984,176,76,8,66,15771,27081
123970,7,157,1318,53,31,4,8,2372,3786
61818,6,200,400,15,4,0,3,506,928
62143,4,800,350,6,3,0,2,532,893
171088,4,375,5809,174,107,25,34,10967,17116
114249,6,78,747,14,5,0,2,1202,1970
147042,6,489,345,8,4,1,2,538,898
33494,7,861,53,0,0,0,0,110,163
144964,8,214,1365,0,0,0,12,2110,3487
164258,8,214,55204,1158,528,87,343,110715,168035
16151,7,207,107,1,1,0,0,186,295
154416,7,713,47,0,0,0,0,97,144
85641,9,640,550,0,0,0,1,2326,2877
15511,8,214,1718,24,17,0,17,2703,4479
109726,8,214,9600,286,96,2,46,15304,25334
41009,6,78,35114,1151,470,66,210,49841,86852
73755,8,545,2330,31,10,1,11,5189,7572
142477,8,693,25516,1073,480,95,235,39726,67125
144170,8,214,3605,72,34,2,23,5957,9693
64693,10,474,12,0,0,0,0,24,36
98958,4,300,1171,35,17,1,8,2166,3398
88341,6,232,1171,59,34,0,4,1780,3048
98195,4,752,617,1,0,0,5,1214,1837
111453,7,306,4001,108,50,4,25,6765,10953
34648,7,489,8460,291,107,43,67,14799,23767
69209,8,800,29455,1504,504,166,250,45704,77583
85909,4,159,3372,98,45,8,16,6736,10275
107589,7,429,657,23,7,4,5,1161,1857
6156,6,165,4836,219,86,34,34,7639,12848
88764,5,306,31777,1037,470,134,287,51895,85600
25335,7,641,24,0,0,0,0,41,65
60591,4,159,6342,124,68,17,21,10059,16631
121622,8,306,1304,21,18,0,3,2122,3468
76996,7,489,11374,406,189,68,45,17748,29830
63937,7,713,50,0,0,0,0,107,157
71548,7,861,12,0,0,0,0,16,28
52337,10,474,2274,45,15,2,8,3494,5838
145145,11,306,328,15,0,0,0,383,726
124869,7,306,7645,276,121,32,38,13335,21447
14739,6,165,6503,300,126,57,30,9500,16516
36638,5,479,20008,846,344,178,115,29675,51166
79722,7,861,40,0,0,0,0,52,92
102548,4,658,2641,71,38,8,12,4546,7316
2358,10,692,1556,18,9,1,7,1946,3537
116244,7,587,1882,41,23,3,15,3247,5211
2090,7,587,1952,44,23,6,9,3309,5343
38805,10,36,5549,149,65,6,39,9278,15086
23296,7,429,236,3,2,1,0,437,679
16306,10,474,659,7,6,0,2,794,1468
90319,10,692,434,13,1,0,3,666,1117
140034,4,675,1516,30,21,0,5,2328,3900
164172,6,78,478,5,4,0,3,723,1213
59870,6,78,470,13,4,0,4,712,1203
85832,8,800,383,8,4,0,3,553,951
44743,7,587,759,16,8,0,8,1187,1978
83403,10,200,27,0,0,0,2,32,61
19073,7,306,565,8,6,0,2,1248,1829
89522,4,890,2888,46,19,1,9,4222,7185
37916,4,36,7107,246,130,17,37,13195,20732
20546,8,214,774,13,11,0,3,1091,1892
5325,7,589,2305,92,36,12,7,3584,6036
168200,5,306,8803,354,221,24,55,13743,23200
146523,8,489,17787,637,278,23,127,27518,46370
128670,4,675,6213,173,69,8,33,10144,16640
138434,8,124,3365,102,37,3,17,5826,9350
146525,9,367,1016,34,24,2,4,1650,2730
142120,4,891,2226,23,15,0,8,5655,7927
131056,10,105,104,3,2,0,0,157,266
62884,6,800,2441,69,36,1,13,4533,7093
41505,6,800,3745,126,76,5,23,6124,10099
110974,8,489,3066,28,8,2,10,4602,7716
162809,10,474,28,0,0,0,0,72,100
22376,11,30,1,8,0,0,0,0,9
142603,4,124,2319,55,35,3,20,4047,6479
15547,7,56,5042,139,79,29,28,7009,12326
74306,9,302,1364,38,27,7,11,2240,3687
143527,6,78,18095,602,240,58,111,25590,44696
93773,4,891,6055,117,76,3,14,10380,16645
64155,9,78,1277,56,34,1,5,1950,3323
145367,9,842,1894,113,56,13,9,2944,5029
166549,8,489,1237,5,5,0,8,1976,3231
83321,4,890,2452,50,31,0,14,3471,6018
122237,4,453,1225,17,12,1,8,1791,3054
90811,4,159,797,24,7,1,3,1318,2150
66666,10,474,27,0,0,0,0,48,75
85221,8,214,528,13,6,0,4,755,1306
26634,8,214,1759,14,11,0,10,2962,4756
126574,7,693,3806,93,39,6,15,6479,10438
54709,8,885,5004,193,74,7,42,7564,12884
166884,10,474,151,7,0,1,0,357,516
162263,7,144,2860,64,28,12,12,3750,6726
155735,4,890,340,9,7,0,0,551,907
89440,8,812,336,5,0,0,1,479,821
163009,4,453,10093,268,126,30,43,15614,26174
88710,8,214,1172,0,0,0,4,1674,2850
50181,8,677,1559,55,24,3,5,2314,3960
15391,8,623,569,10,2,0,0,826,1407
89802,8,545,23185,941,412,107,153,41676,66474
106814,5,306,3552,134,65,12,30,5601,9394
81161,7,77,90,0,1,0,0,129,220
97026,4,200,1202,34,28,1,5,1940,3210
33186,7,563,2248,46,35,7,11,3585,5932
7069,8,812,147,3,1,0,0,210,361
168106,8,812,1040,17,13,0,7,1906,2983
114640,8,214,1621,32,16,1,10,2747,4427
2072,6,306,19234,585,284,24,131,28182,48440
70726,7,489,2809,85,50,13,9,4764,7730
116279,5,408,559,12,4,1,2,906,1484
147989,8,214,1144,0,0,0,7,1671,2822
78176,4,885,872,27,12,2,2,1538,2453
113058,9,489,848,1,1,0,9,1635,2494
124972,7,563,46,0,0,0,0,67,113
102110,8,812,3611,57,45,3,26,5963,9705
149854,8,800,22238,913,309,82,141,32624,56307
146189,4,885,656,11,9,1,2,1014,1693
98597,5,479,359,2,2,0,2,565,930
116881,8,214,3646,119,72,4,20,6617,10478
31628,8,214,2669,55,25,1,20,4410,7180
169872,4,519,2688,44,20,5,7,3736,6500
165016,8,214,387,2,1,0,1,520,911
33726,6,693,10501,436,294,41,74,15983,27329
87008,9,306,1626,0,0,0,9,3254,4889
19123,4,200,575,19,8,3,3,892,1500
85764,9,489,3793,225,121,29,17,5488,9673
33629,9,489,902,23,16,0,2,1317,2260
38604,9,489,12738,829,470,72,61,18195,32365
158230,6,693,2445,82,50,15,18,3774,6384
137100,4,230,7764,160,77,11,27,12731,20770
136295,8,375,527,7,2,1,7,890,1434
121665,7,489,3167,127,55,17,15,5175,8556
164211,8,30,12034,443,175,33,58,19633,32376
89041,4,200,191,4,1,1,0,268,465
131777,8,677,4340,126,51,5,26,6904,11452
93169,8,214,10683,271,125,14,52,21740,32885
53374,4,890,608,10,7,0,2,943,1570
22947,7,587,52,0,0,0,0,74,126
65749,4,36,337,10,6,1,3,549,906
30383,5,263,5624,191,104,11,34,8412,14376
136661,8,306,420,1,0,0,1,494,916
21078,5,78,11194,425,201,26,94,16396,28336
91957,8,214,6162,104,52,12,25,9667,16022
96325,8,658,554,18,10,0,2,867,1451
109840,4,885,5816,226,108,14,36,8732,14932
77210,4,890,66,0,0,0,0,93,159
56325,4,453,399,17,4,0,0,602,1022
21696,8,306,342,0,0,0,2,444,788
168478,8,812,2017,44,26,2,11,3176,5276
39230,6,306,681,11,6,0,4,1126,1828
100270,4,453,2154,27,21,1,9,3298,5510
34581,4,890,4533,135,68,2,21,6715,11474
160600,5,124,13200,513,259,57,90,19418,33537
103014,8,800,8577,391,142,14,57,14373,23554
10098,7,157,5376,217,115,38,39,7967,13752
37009,4,581,14987,427,228,52,79,25493,41266
75238,9,489,112,4,3,0,1,191,311
86851,4,453,133,4,3,0,0,235,375
646,7,489,15549,601,239,115,100,22309,38913
94482,8,658,3707,141,56,16,30,6002,9952
159187,5,225,12690,614,225,87,114,22791,36521
78256,7,587,5673,151,72,20,29,9718,15663
87344,4,36,4293,174,90,24,23,7992,12596
91237,4,581,3669,97,56,7,26,6869,10724
116670,8,214,1552,29,8,1,9,2373,3972
29806,4,752,1933,20,12,0,5,2604,4574
127836,6,306,8824,211,83,16,57,13052,22243
3468,4,890,809,25,10,1,3,1215,2063
15481,4,675,2162,51,34,3,13,2944,5207
120732,9,842,931,3,1,0,5,2412,3352
101157,5,78,277,9,4,0,1,382,673
31493,8,623,2307,39,16,1,18,3195,5576
68654,7,489,7253,276,136,51,35,11775,19526
54859,7,489,653,16,5,5,3,937,1619
69593,4,453,567,14,7,0,1,958,1547
91657,9,842,3376,253,136,25,13,5319,9122
44727,8,214,4816,21,13,0,14,6795,11659
134276,8,812,1334,36,18,1,8,2399,3796
26603,7,157,2607,97,47,9,12,5069,7841
145972,7,842,137,2,1,0,0,213,353
125652,10,40,314,3,0,0,0,393,710
146888,4,36,184,3,1,0,0,314,502
3869,4,300,1413,29,14,0,6,2477,3939
164737,4,36,4348,104,46,6,31,8236,12771
157827,8,124,13981,378,178,11,68,22135,36751
99504,10,40,62,0,0,0,1,103,166
110487,10,40,348,2,2,0,1,493,846
39517,4,115,462,2,0,1,1,663,1129
82495,4,581,4947,146,71,14,18,9618,14814
146427,8,214,1391,19,2,1,9,2141,3563
118317,10,36,1916,26,20,1,17,3130,5110
89847,6,306,7193,138,67,11,49,10661,18119
19973,8,658,3283,119,45,9,18,6007,9481
85204,10,474,374,6,2,0,2,703,1087
4285,8,658,3144,71,32,2,15,5024,8288
129598,4,174,42042,1228,517,102,234,66745,110868
160537,8,214,4074,84,24,7,16,7461,11666
19852,8,214,853,14,8,0,5,1123,2003
39387,8,214,3469,56,26,3,15,6307,9876
147573,4,36,4910,162,105,20,28,8922,14147
98685,7,306,11496,672,268,88,91,16569,29184
5977,6,269,4978,136,55,7,24,7287,12487
74049,8,214,3635,19,6,0,14,5416,9090
24082,4,453,70,0,0,0,0,82,152
11734,10,474,65,0,0,0,0,159,224
13245,10,474,422,13,7,0,5,739,1186
83201,8,489,1556,63,30,0,9,3417,5075
146484,4,174,248,3,2,0,2,350,605
112609,10,917,5853,48,38,2,18,7525,13484
8793,5,693,1029,32,21,1,2,1658,2743
118415,9,469,1021,27,9,2,5,1332,2396
162573,4,885,13052,488,257,49,87,20971,34904
51961,4,36,153,6,4,0,0,218,381
118107,4,581,1063,22,21,0,9,1697,2812
30179,4,453,541,3,3,0,2,976,1525
163392,8,214,3704,49,24,1,19,6051,9848
96241,4,159,222,1,1,0,2,411,637
135409,8,214,9169,293,113,6,71,16116,25768
102226,6,235,16440,584,287,34,97,26068,43510
24900,4,159,16296,506,242,27,71,26727,43869
108106,8,214,1436,0,0,0,5,1912,3353
164506,8,214,3337,64,22,2,21,5648,9094
159788,7,589,176,8,5,0,0,294,483
112219,7,741,296,6,4,0,0,797,1103
8304,4,36,316,12,5,0,2,536,871
18031,8,214,3965,50,15,4,31,6178,10243
170188,10,104,1537,32,15,2,7,2660,4253
63594,4,200,652,11,7,0,2,990,1662
72855,8,214,2876,76,32,2,22,5147,8155
160362,6,693,8367,406,209,57,58,12014,21111
134581,10,653,1209,15,6,1,3,1622,2856
142667,8,403,6126,312,130,13,46,12212,18839
64159,4,220,911,43,18,2,12,1401,2387
120084,7,157,2248,61,33,7,16,4180,6545
147929,8,623,825,4,0,0,1,1157,1987
15906,7,447,338,1,1,0,0,433,773
75043,9,427,5086,247,124,48,39,7987,13531
147936,7,741,4991,187,79,15,24,7261,12557
153645,8,124,1670,0,0,0,9,2324,4003
69342,7,427,4287,197,91,39,39,6263,10916
7962,6,159,70,0,1,0,0,111,182
56792,8,489,13773,461,198,39,97,23289,37857
117011,8,214,318,11,5,0,2,672,1008
9159,6,800,6485,272,142,29,46,10188,17162
10133,8,214,350,11,5,0,2,799,1167
105727,6,78,813,6,6,1,3,1118,1947
38403,4,675,2423,67,42,4,9,3832,6377
33474,8,489,94,0,0,0,1,111,206
170668,6,800,268,6,3,0,2,342,621
87261,10,790,257,5,4,0,3,361,630
99955,8,214,10,0,0,0,0,28,38
152279,8,214,1797,31,16,4,14,2667,4529
47157,4,885,11102,285,143,14,67,17336,28947
121013,4,174,570,28,7,0,1,962,1568
18341,4,36,10379,362,198,7,66,16123,27135
59334,10,917,125,5,4,0,2,238,374
142674,4,300,484,21,13,1,3,1010,1532
77837,8,214,1663,27,19,2,6,3371,5088
30816,10,692,196,2,2,0,1,326,527
39864,10,917,410,5,4,1,0,627,1047
84389,8,489,43356,1952,722,120,341,68905,115396
86159,4,159,575,20,6,0,2,835,1438
39625,8,214,4834,43,24,0,24,8230,13155
96887,8,214,4188,136,58,9,20,7248,11659
109802,6,165,574,21,7,4,2,871,1479
42675,4,159,89,0,0,0,1,183,273
118404,8,812,197,0,0,0,2,286,485
86942,8,214,6704,147,53,5,42,10932,17883
36171,8,214,5694,161,57,5,40,10310,16267
53368,10,917,137,4,2,0,0,281,424
118189,10,474,130,0,2,0,1,173,306
97097,8,244,2924,122,41,4,24,4706,7821
127896,8,244,4411,188,77,7,28,7465,12176
32423,6,447,1109,16,7,0,5,1556,2693
12000,8,214,740,15,7,0,3,1320,2085
136046,6,800,403,19,17,1,6,1039,1485
109131,4,36,2438,68,59,2,13,4625,7205
158931,4,519,2450,7,8,0,3,4031,6499
116420,4,174,4641,136,68,10,24,7671,12550
10408,4,36,2689,57,46,3,11,5541,8347
74280,4,159,12217,332,156,28,71,20091,32895
89811,4,752,1220,10,12,0,13,2305,3560
52947,8,244,203,3,1,0,0,529,736
143296,4,581,1968,58,45,3,11,3133,5218
54287,8,812,613,19,11,1,3,901,1548
53517,4,300,132,0,0,0,1,210,343
118799,8,244,2042,28,14,0,12,3336,5432
82600,7,587,3679,164,49,24,22,5566,9504
47328,7,587,4750,97,42,8,19,7260,12176
99320,6,306,4480,81,60,7,27,7366,12021
37010,10,752,4079,58,25,2,20,5920,10104
91182,6,261,2180,68,27,13,13,3583,5884
24920,8,244,228,0,0,0,0,293,521
161401,7,214,349,0,0,0,2,513,864
103793,4,300,1033,25,15,0,5,1792,2870
134727,6,404,1802,0,0,0,10,2750,4562
113087,4,36,1101,53,32,1,4,2470,3661
33553,9,796,3,1,1,0,0,8,13
105274,7,214,271,4,2,0,0,374,651
145461,6,306,330,2,2,0,0,547,881
91658,9,570,114,7,5,1,0,163,290
170713,9,570,138,18,4,0,2,142,304
86759,5,306,4491,129,91,11,38,6555,11315
39695,7,489,15245,574,295,64,99,23766,40043
22499,8,214,7287,152,63,6,42,11595,19145
143685,7,367,4231,152,63,21,20,6616,11103
116364,4,453,5035,99,63,1,41,7706,12945
41887,9,367,4600,144,79,18,28,7482,12351
59256,4,306,10423,262,131,33,60,16103,27012
160976,4,200,773,18,15,0,3,1168,1977
77391,8,800,686,14,9,1,2,1036,1748
38222,8,489,21596,857,350,31,152,34475,57461
118956,4,200,112,3,1,0,0,189,305
130924,4,200,47,0,0,0,0,78,125
116497,8,214,4688,59,20,1,30,7085,11883
163864,9,640,223,3,3,0,0,332,561
11640,8,214,9483,305,125,7,91,16764,26775
125446,5,225,10382,271,128,20,65,18009,28875
161265,8,214,2332,67,21,2,23,4578,7023
8316,8,214,673,0,0,0,2,828,1503
68019,4,174,1122,19,14,1,3,1728,2887
91180,4,752,840,16,14,0,2,3329,4201
131063,4,200,607,20,9,0,1,1016,1653
32904,8,214,791,18,2,1,6,1589,2407
7449,8,489,1877,49,27,3,11,2731,4698
7638,4,174,67,0,0,0,0,103,170
145705,7,427,5627,286,108,86,27,9764,15898
17586,9,302,649,25,6,1,3,1075,1759
123718,5,479,4571,133,65,8,25,7238,12040
5499,7,118,2327,81,43,12,15,3910,6388
114004,4,200,571,15,5,1,4,860,1456
161465,9,427,906,34,26,3,4,1608,2581
107220,8,489,687,6,3,0,7,1098,1801
41101,8,658,10831,362,135,35,61,18072,29496
71801,4,658,10356,353,167,66,38,16824,27804
82048,7,24,399,9,4,1,2,707,1122
138981,9,630,1628,1,1,0,9,3415,5054
67353,9,630,1239,0,1,0,7,2478,3725
11370,8,693,307,0,0,0,3,431,741
52270,9,842,4238,3,2,0,29,7387,11659
10373,7,306,8653,382,147,36,50,13156,22424
140917,10,474,1196,9,7,0,4,1768,2984
99393,10,519,614,28,11,2,15,3396,4066
36145,9,489,816,0,0,0,10,1655,2481
154701,8,489,932,8,4,0,3,1487,2434
160941,4,675,1735,51,38,3,4,2502,4333
27647,10,519,0,0,0,0,16,4858,4874
56234,8,545,3425,37,23,1,12,7450,10948
95399,9,842,12983,484,257,39,77,20232,34072
65145,9,842,4606,350,185,30,22,7449,12642
110086,7,489,4348,172,82,29,25,6428,11084
168136,8,545,4247,109,69,4,29,9251,13709
90365,4,200,2695,76,38,2,13,4011,6835
45149,9,630,4323,7,2,0,26,7533,11891
118987,7,589,287,6,9,0,1,736,1039
12068,7,589,829,29,21,2,4,1695,2580
122341,8,30,10156,287,106,8,61,16258,26876
95728,8,375,2264,58,42,3,18,3534,5919
87819,9,427,788,25,18,4,7,1658,2500
23823,6,235,975,31,24,5,5,1544,2584
171040,10,474,646,6,4,0,1,998,1655
151769,8,489,2034,64,26,0,10,3898,6032
44172,7,589,350,7,5,0,0,467,829
82765,7,489,1960,60,31,6,11,2607,4675
148735,9,306,2213,0,0,0,23,4262,6498
112301,4,375,8770,266,137,24,36,13836,23069
99755,7,521,181,3,2,0,0,249,435
98372,11,489,2,0,0,0,0,2,4
62502,6,263,3984,144,58,4,33,5983,10206
33351,4,115,165,0,0,0,0,211,376
59175,8,545,29514,1068,355,101,239,50713,81990
155447,4,174,165,0,0,0,1,246,412
114230,4,675,2770,64,37,4,12,5324,8211
69437,4,174,1052,30,11,0,3,1860,2956
63844,8,885,5226,147,60,3,34,8785,14255
123959,10,200,109,5,1,0,0,225,340
17429,5,427,787,48,23,2,7,1303,2170
123098,4,891,3402,35,23,0,21,7690,11171
132835,8,403,4803,192,79,8,32,8072,13186
46676,8,885,539,12,5,1,1,969,1527
81474,8,766,258,3,2,0,1,390,654
77745,6,269,13873,582,263,80,103,20595,35496
36503,4,885,9940,285,120,14,54,15955,26368
142295,6,78,19607,709,288,32,130,30438,51204
84639,4,658,4164,120,70,17,28,7429,11828
109138,5,58,991,34,20,5,3,1544,2597
63557,9,607,5529,145,64,17,21,7240,13016
154823,8,214,3798,23,12,0,13,5737,9583
19799,10,797,354,11,7,1,0,663,1036
113564,4,752,430,5,2,0,3,599,1039
60497,10,525,153,0,0,0,1,215,369
75489,8,124,8414,261,127,8,47,14085,22942
112919,4,890,1753,74,32,1,3,2747,4610
91463,9,30,204,4,5,0,2,341,556
42440,6,117,3155,107,56,9,18,4658,8003
145303,5,306,4834,136,73,10,35,7617,12705
17660,5,306,17962,714,348,119,102,26410,45655
116740,4,752,418,7,2,0,5,511,943
128490,9,489,184,6,4,0,1,308,503
117734,7,587,9130,265,121,34,57,15828,25435
25362,8,355,1466,37,15,0,4,2388,3910
151068,9,607,2212,66,32,13,18,3315,5656
3887,9,640,8924,190,107,11,39,12939,22210
78832,7,306,7072,235,121,22,42,11469,18961
82326,4,658,181,4,1,0,1,334,521
99491,5,78,6480,217,88,17,41,9532,16375
91771,9,306,1059,0,0,0,9,2070,3138
51405,10,474,2138,28,16,1,12,3173,5368
145990,8,885,6225,234,82,14,63,9769,16387
170453,5,306,5323,203,106,23,20,8417,14092
153411,4,800,3366,95,45,2,23,5412,8943
75647,9,374,325,11,5,2,0,536,879
75018,9,630,28437,933,425,67,123,43744,73729
48061,6,375,1040,26,17,0,4,1644,2731
163835,6,165,83,3,0,0,0,159,245
45504,10,917,4762,91,38,5,15,6781,11692
101412,5,225,14027,484,251,37,90,24057,38946
14181,8,214,7339,171,69,7,40,11841,19467
10922,6,165,1989,50,30,0,14,3267,5350
126804,5,225,178,3,2,0,2,326,511
47107,8,214,21422,713,349,29,123,35988,58624
15987,5,225,8968,294,147,25,47,15464,24945
104993,4,174,4733,149,81,10,21,7857,12851
56382,6,561,329,7,3,0,2,453,794
23764,8,885,111,2,1,0,1,134,249
99357,5,821,22,1,1,0,0,32,56
28688,4,174,10085,281,159,13,41,17922,28501
73870,7,56,1504,65,30,26,16,2034,3675
133431,9,282,2,0,0,0,0,2,4
90761,9,630,35241,970,449,79,158,54483,91380
49611,9,607,6517,217,66,28,46,9078,15952
21700,9,489,57,1,1,0,1,189,249
63894,9,117,35,0,0,0,0,52,87
78647,4,658,558,20,15,0,3,995,1591
46174,7,306,3991,118,67,8,33,7311,11528
115836,6,269,15468,518,253,12,95,23918,40264
154264,4,658,65,0,0,0,0,112,177
5757,9,489,17756,528,240,52,87,26314,44977
64160,6,232,8030,344,136,90,44,11789,20433
64558,4,375,288,2,4,0,0,435,729
45135,6,427,7530,251,111,12,44,11389,19337
44530,6,306,6082,116,47,2,37,9425,15709
155589,9,427,919,33,14,4,7,2072,3049
120492,4,800,283,5,3,0,6,458,755
130834,4,375,1620,49,18,2,7,2428,4124
17933,6,518,30,1,1,0,0,48,80
159398,4,752,12236,250,119,6,47,21381,34039
150239,7,157,2540,101,68,7,8,4943,7667
33445,8,489,10489,263,115,13,53,16287,27220
59038,8,214,3334,51,21,2,20,5937,9365
165682,7,157,170,6,4,1,0,251,432
142936,7,489,9475,339,169,38,34,15165,25220
25587,5,479,2351,57,34,1,13,3817,6273
169620,6,489,3509,107,48,7,26,5730,9427
7030,8,623,892,20,6,0,5,1248,2171
125460,5,200,9938,309,140,27,71,14779,25264
14143,9,380,769,16,12,2,5,1396,2200
127413,9,306,217,0,0,0,2,1016,1235
148822,7,207,263,3,3,0,0,487,756
72724,5,427,1410,77,40,9,12,2268,3816
111840,5,200,4364,137,74,1,24,6282,10882
113697,6,263,2573,72,46,1,17,3454,6163
95771,5,200,3311,113,55,4,16,4561,8060
13057,8,545,4180,85,38,1,22,6764,11090
141200,8,355,1777,36,23,1,8,2994,4839
80906,5,427,407,12,11,1,2,641,1074
70839,8,545,13355,632,216,83,94,21532,35912
122281,5,159,185,5,3,0,0,248,441
151916,5,427,156,5,1,1,1,186,350
79982,8,214,422,1,1,0,2,612,1038
49178,8,545,2495,58,26,2,12,5303,7896
160735,9,630,1112,31,16,0,4,1419,2582
118243,9,306,998,0,0,0,7,1695,2700
126031,8,214,2430,32,13,3,11,3638,6127
78412,8,214,3944,73,29,1,26,6983,11056
8648,7,306,5824,153,128,24,11,7660,13800
22724,7,306,982,20,9,3,13,1949,2976
88179,9,630,1358,69,32,1,3,1984,3447
129842,4,200,4510,104,47,1,18,6252,10932
125756,8,30,20129,818,309,51,155,34728,56190
49926,11,800,326,14,0,0,0,393,733
133030,7,306,1798,66,38,2,6,3372,5282
128036,9,427,721,0,0,0,2,1464,2187
11257,6,235,15144,382,201,23,86,24008,39844
129803,6,78,1634,33,16,0,12,2469,4164
60533,5,306,2001,45,22,10,13,2888,4979
145828,8,403,370,8,5,1,6,581,971
20169,4,200,5501,143,53,8,23,7503,13231
89629,6,800,8452,250,130,11,44,13798,22685
166779,8,214,1089,45,9,0,7,1912,3062
87114,4,200,7949,149,73,7,29,10498,18705
19863,9,469,419,10,3,2,1,673,1108
14433,8,30,17586,740,240,60,130,30382,49138
2480,4,891,8853,164,72,8,37,15938,25072
144267,8,214,5668,185,77,13,61,9249,15253
96120,4,174,2765,88,36,5,16,4352,7262
130563,8,214,524,15,8,0,2,836,1385
91915,8,214,2255,55,19,4,16,3617,5966
143741,8,214,255,6,3,0,1,481,746
165814,8,214,1308,28,15,0,6,2152,3509
153395,8,545,33040,1518,551,93,247,52256,87705
130914,4,174,2406,56,34,0,13,3663,6172
65783,8,214,441,6,5,0,1,710,1163
5484,8,30,1164,21,12,1,4,1833,3035
69355,8,800,25377,953,387,86,154,37662,64619
75525,8,857,5702,59,14,3,26,10082,15886
122544,8,214,501,12,7,0,1,896,1417
119338,8,214,63,0,0,0,0,115,178
124672,7,306,216,0,0,0,2,312,530
65488,4,658,13828,469,234,41,52,22492,37116
153514,4,174,190,2,2,0,2,319,515
2340,8,214,1880,57,28,4,11,3087,5067
65274,4,174,1053,30,11,3,1,1624,2722
11840,8,30,1887,0,0,0,8,3193,5088
82971,8,214,2416,39,21,1,11,4555,7043
67876,7,306,772,19,11,1,6,1379,2188
44096,9,469,372,15,4,2,2,610,1005
134445,4,519,1804,40,20,2,7,2621,4494
164147,7,306,2645,74,41,5,23,4456,7244
132915,8,214,862,30,13,1,11,1363,2280
155707,8,214,4143,89,29,2,29,6622,10914
90452,8,214,33,0,0,0,0,50,83
74138,7,207,2140,42,21,3,9,3208,5423
148409,8,214,305,3,1,0,1,509,819
37117,8,214,77,1,0,0,1,116,195
94441,8,214,55,1,1,0,0,107,164
51539,8,214,91,2,0,0,1,131,225
26211,4,200,537,16,8,1,6,817,1385
98249,6,306,8587,228,117,11,72,13454,22469
148750,6,427,1685,96,32,4,8,2741,4566
65823,6,78,18757,591,243,55,115,28152,47913
116016,4,200,331,10,5,0,0,411,757
4817,4,375,208,0,0,0,0,311,519
115882,7,56,549,17,7,6,3,687,1269
1396,11,214,28,3,0,0,0,37,68
50267,11,214,11,1,0,0,0,2,14
28295,8,214,9914,303,136,13,60,15849,26275
129184,9,374,82,0,0,22,0,110,214
143482,7,144,661,17,6,8,1,906,1599
73834,7,527,333,14,10,3,1,459,820
20827,4,800,10766,308,134,23,54,18059,29344
130683,8,658,3431,101,43,7,19,5399,9000
84711,4,658,552,14,9,0,3,940,1518
17123,7,527,140,11,8,0,1,207,367
1427,8,800,828,26,12,0,4,1166,2036
37179,4,200,90,0,0,0,1,185,276
42667,8,885,2177,62,22,3,15,2980,5259
155704,4,200,520,6,4,0,1,847,1378
47284,5,200,1604,44,16,3,14,2486,4167
42876,4,890,2559,63,23,1,9,3820,6475
67589,5,800,9437,478,216,51,52,14857,25091
119809,7,56,255,7,1,1,0,344,608
37279,8,427,11,0,0,0,0,21,32
125975,4,885,904,8,4,0,7,1435,2358
77911,8,885,29,0,0,0,0,42,71
90294,8,214,18705,691,355,31,113,32437,52332
122607,8,214,1102,25,6,3,8,2028,3172
91204,8,885,59,1,0,0,0,89,149
129943,6,200,832,13,5,1,2,1192,2045
123278,6,200,345,7,3,0,3,499,857
51558,6,200,16998,516,211,19,77,26520,44341
164954,4,36,7120,186,87,9,31,12052,19485
58246,8,214,4980,113,45,3,33,7974,13148
102069,4,200,677,6,3,0,4,1006,1696
25670,7,713,131,2,1,0,0,223,357
149058,8,214,1522,20,6,0,9,2553,4110
27844,4,375,5246,185,101,20,24,8999,14575
76778,7,800,171,5,2,0,0,355,533
125372,6,235,7569,190,118,10,47,12659,20593
27333,5,200,5153,161,79,6,33,7353,12785
78351,5,885,627,18,11,1,5,1002,1664
82824,5,489,6038,245,103,25,35,10321,16767
83894,9,597,21,1,1,0,0,36,59
106992,9,374,41,0,0,0,0,79,120
12002,11,489,216,9,0,0,2,283,510
39778,7,527,549,66,33,10,1,743,1402
158650,9,813,137,0,0,0,1,265,403
143289,6,728,1939,92,43,9,5,3044,5132
84503,8,885,42,0,0,0,0,71,113
31895,7,800,291,2,0,0,3,448,744
69760,10,104,0,0,0,0,1,175,176
170215,4,658,5033,177,106,18,25,8617,13976
36371,8,214,8001,202,69,13,66,13446,21797
41668,7,489,826,30,16,6,7,1887,2772
128254,8,623,851,8,6,0,5,1547,2417
85138,7,24,127,1,1,0,2,214,345
12251,7,587,531,6,3,0,0,744,1284
135187,8,800,6376,102,29,5,37,10641,17190
70073,9,597,42,1,1,0,0,69,113
121346,9,374,95,1,0,0,0,137,233
147882,4,658,2139,75,47,8,8,3894,6171
16740,6,885,1448,42,15,0,7,2096,3608
17354,4,36,4155,101,49,0,39,7791,12135
41840,8,545,2189,36,20,1,14,3672,5932
96112,8,403,1431,30,15,2,7,2580,4065
92275,5,489,803,24,15,1,3,1164,2010
160476,8,545,32588,1191,398,50,217,48674,83118
46990,8,403,10200,367,143,23,81,19586,30400
137535,10,63,276,5,5,0,2,375,663
67884,9,597,19,0,0,0,0,21,40
167518,8,306,346,3,4,0,1,502,856
15733,9,597,455,9,5,1,1,683,1154
32527,4,675,139,2,0,0,0,275,416
145982,4,752,2756,89,58,7,17,4957,7884
66291,8,545,5015,224,66,18,43,9535,14901
78639,6,453,106,4,1,0,0,150,261
22217,6,124,140,3,2,0,0,197,342
79113,8,427,1103,42,19,1,1,2026,3192
141831,4,306,1313,48,25,2,7,2111,3506
48154,8,214,2031,53,15,0,11,3004,5114
134289,8,812,5340,129,52,14,29,7767,13331
123170,9,597,6,0,0,0,0,7,13
56608,6,165,3717,127,58,12,23,5874,9811
121467,9,597,32,0,0,0,0,40,72
114331,8,800,200,4,4,0,0,278,486
83393,8,623,588,15,3,2,3,956,1567
2148,6,165,16029,672,278,149,91,23657,40876
12272,6,885,3052,176,65,14,23,4610,7940
107818,9,630,1091,26,14,2,4,1444,2581
134942,8,800,15,1,1,0,0,24,41
113783,6,489,5541,204,120,25,49,7537,13476
70671,4,581,313,1,0,0,2,490,806
155513,6,263,7515,267,111,12,41,10502,18448
46530,8,800,2164,77,37,5,19,3236,5538
35308,8,800,158,2,1,0,1,250,412
7498,8,885,4561,151,58,8,31,7929,12738
100709,9,597,31,2,1,0,0,53,87
28973,4,800,1237,26,16,1,2,2066,3348
168238,8,244,1115,32,16,0,4,2042,3209
88792,8,427,405,15,6,0,2,845,1273
159222,4,923,789,29,14,4,4,1414,2254
7420,8,124,541,0,0,0,2,819,1362
139559,8,800,574,44,16,1,4,784,1423
139014,9,597,31,0,0,0,0,51,82
165952,5,218,301,11,8,0,6,453,779
3553,5,570,1083,41,24,4,7,1545,2704
169726,8,427,1402,64,26,5,17,2549,4063
147763,4,581,276,2,2,0,1,432,713
24217,6,78,196,5,1,0,0,298,500
46734,10,36,0,0,0,0,19,7780,7799
53495,10,752,1084,30,11,3,10,2323,3461
111225,8,693,12384,507,252,35,85,21080,34343
82596,5,296,394,15,9,4,4,564,990
128195,6,263,402,4,2,0,1,605,1014
30272,8,677,5332,134,68,8,23,7810,13375
127497,10,111,761,9,11,0,1,1102,1884
151139,10,36,6827,91,62,6,35,10367,17388
45981,6,263,112,4,2,0,1,167,286
63022,6,263,4,0,0,0,0,4,8
130416,4,581,420,16,5,1,2,686,1130
46239,5,570,1545,52,25,6,6,2505,4139
9961,10,36,1012,21,7,1,6,1598,2645
116733,4,174,4794,78,35,5,20,6769,11701
59300,10,820,283,3,3,0,1,399,689
149928,5,218,158,1,1,0,0,245,405
58722,10,474,900,7,8,0,4,1306,2225
164617,5,699,88,4,3,0,0,130,225
16824,5,375,1355,87,37,19,7,2012,3517
93829,7,367,566,37,27,4,3,1066,1703
25413,5,66,74,3,1,0,1,89,168
119505,6,263,22,2,0,0,0,23,47
48275,7,448,9430,230,102,37,24,15481,25304
113418,5,371,244,8,5,0,0,404,661
92021,7,448,1434,61,31,8,1,3169,4704
43894,4,752,3973,80,43,1,20,5939,10056
55787,6,200,654,13,9,0,2,955,1633
139999,4,752,281,9,3,0,2,353,648
87399,6,200,175,3,2,0,0,240,420
157857,9,489,5314,147,75,12,28,7340,12916
74326,4,885,598,6,2,0,4,958,1568
8585,6,570,17803,556,219,56,92,27172,45898
3487,4,752,1293,31,12,0,7,1798,3141
149451,4,885,1237,38,25,3,8,1794,3105
95983,6,78,1101,15,8,0,7,1606,2737
87703,6,78,526,13,5,0,1,694,1239
36548,7,157,463,21,11,1,0,1082,1578
5140,4,890,2768,80,39,2,12,4153,7054
169234,4,800,6736,176,75,9,42,11038,18076
123857,6,124,1771,54,38,2,22,3062,4949
26360,6,124,357,7,4,0,2,539,909
20440,6,235,5674,215,128,6,39,9093,15155
130641,6,124,385,9,4,0,3,596,997
120043,6,124,160,3,1,0,2,273,439
133770,4,800,423,6,4,0,4,1273,1710
115537,8,214,1091,22,11,0,4,1793,2921
64974,8,214,11842,216,99,4,71,16470,28702
60158,4,159,57,0,3,0,0,96,156
131313,8,214,44,0,0,0,0,75,119
134851,4,800,5840,129,75,4,30,9083,15161
115634,4,800,4916,126,46,3,21,7626,12738
73167,5,479,1250,66,21,12,6,2035,3390
129183,10,525,116,0,0,0,3,181,300
164215,8,403,3283,110,40,6,11,5304,8754
50227,7,563,1898,37,18,7,7,2816,4783
41098,5,699,211,7,4,1,0,251,474
137111,5,699,548,27,13,3,4,835,1430
40491,7,489,1391,53,19,8,12,2954,4437
16760,6,263,1438,47,21,1,12,2010,3529
35199,6,200,790,21,9,0,0,1204,2024
14948,6,821,314,19,8,0,1,456,798
129889,8,214,2538,65,25,3,15,4229,6875
64891,8,623,389,6,2,0,2,739,1138
41510,6,124,28,1,1,0,0,34,64
41547,6,402,467,7,5,2,1,754,1236
21850,6,159,247,5,3,0,1,361,617
97454,8,214,128,0,0,0,0,212,340
137054,8,214,595,8,1,0,5,1017,1626
126759,4,375,5692,203,106,23,29,9875,15928
54256,6,140,90,3,1,0,0,121,215
145964,6,402,262,6,3,0,1,463,735
168067,8,885,2370,86,33,4,22,3559,6074
91652,6,103,11,0,0,0,0,18,29
106797,5,667,125,5,4,0,2,173,309
32339,6,263,13,0,0,0,0,21,34
98489,5,667,82,1,1,0,0,122,206
69473,7,489,4478,80,29,5,15,7297,11904
151241,6,238,36,2,0,0,0,69,107
69823,5,159,104,4,2,0,0,160,270
118960,5,238,1736,31,17,0,7,2174,3965
67743,6,570,148,7,4,1,2,257,419
166955,8,30,1745,37,18,1,6,2786,4593
45209,6,103,31,0,0,0,0,53,84
134223,6,71,44,0,0,0,0,59,103
22990,6,518,53,1,1,0,0,89,144
116137,4,675,189,9,9,0,1,292,500
144962,6,366,49,1,1,0,0,73,124
94564,6,518,176,3,2,1,3,242,427
57876,4,200,1708,34,24,4,3,2746,4519
94480,6,238,53,2,1,0,0,96,152
32484,9,630,272,3,2,0,1,401,679
96889,7,489,944,19,13,5,1,1948,2930
133541,9,630,216,5,5,0,1,314,541
44353,7,842,1015,40,17,5,8,1756,2841
65520,8,30,28822,1040,340,111,177,47038,77528
19792,7,693,1445,16,12,2,3,2620,4098
67930,7,306,2951,66,46,1,17,4279,7360
66131,7,741,1723,61,22,5,11,3423,5245
43533,7,489,2767,104,59,23,18,4694,7665
17602,8,214,190,8,5,0,1,355,559
9439,7,741,4168,130,61,15,24,6284,10682
119879,9,157,4499,147,77,24,17,6896,11660
133803,8,800,842,40,15,2,4,1367,2270
64711,8,214,2511,69,33,3,19,5000,7635
140687,8,489,9010,246,125,17,31,15949,25378
94561,8,885,8087,261,92,16,65,13257,21778
43405,6,489,9816,530,243,70,65,14316,25040
70936,4,885,13472,552,259,78,64,22050,36475
94682,4,800,1479,40,20,3,8,2461,4011
153952,4,752,248,0,0,0,0,383,631
137551,4,800,94,2,1,1,0,125,223
89103,4,885,1419,26,15,2,9,2319,3790
108097,4,885,9404,350,146,61,62,15509,25532
98840,7,306,2582,65,47,7,16,4423,7140
58768,6,124,12617,303,161,7,72,20024,33184
79309,5,693,3623,112,81,7,23,5560,9406
140689,5,124,473,21,5,3,3,750,1255
75279,5,124,5397,131,54,10,30,8662,14284
3532,4,752,63,0,0,0,0,87,150
6809,8,800,5274,182,84,11,43,8996,14590
150585,7,587,5093,220,105,27,33,7831,13309
56126,7,587,463,9,4,1,3,815,1295
48000,6,489,3826,114,46,10,25,5474,9495
144208,4,453,3255,70,30,0,16,4746,8117
20077,6,800,4367,193,94,14,51,6783,11502
4488,5,124,928,12,12,1,1,1270,2224
158502,5,124,566,11,7,2,3,827,1416
78697,5,124,3130,98,28,4,23,5441,8724
76301,5,232,6136,353,136,67,45,9019,15756
57239,9,630,1670,50,30,1,5,2336,4092
67078,9,630,545,9,0,0,0,737,1291
133709,4,581,1037,35,19,1,3,1582,2677
134619,8,885,19012,674,205,24,157,32333,52405
53371,9,640,7048,166,84,16,37,11010,18361
116246,8,214,2174,32,15,2,10,3785,6018
82813,9,640,529,16,9,1,5,779,1339
17152,7,836,84,4,2,0,0,126,216
127269,6,306,519,3,3,0,1,830,1356
151981,6,124,5011,105,47,6,27,8126,13322
94380,9,589,1981,57,33,8,14,3189,5282
113079,5,306,7380,212,129,20,52,10466,18259
129699,9,489,3013,1,0,0,10,5108,8132
154549,5,159,2944,107,61,5,18,4614,7749
59769,5,800,2582,131,73,10,18,4534,7348
27006,9,306,543,7,4,1,6,989,1550
146846,9,380,412,7,7,0,2,673,1101
9523,5,124,2329,73,39,8,15,3277,5741
128081,6,124,798,9,4,1,9,1545,2366
120078,9,157,682,25,16,3,7,1241,1974
157560,6,124,1195,17,10,0,8,2214,3444
27770,5,124,2451,52,27,2,12,4258,6802
129336,6,235,3504,66,31,3,17,5173,8794
163754,8,489,1237,40,9,4,10,2050,3350
62541,5,821,289,3,2,0,3,695,992
115885,9,367,430,15,6,2,1,856,1310
124394,6,306,2278,27,12,0,15,3617,5949
88360,5,655,484,11,2,0,4,727,1228
157815,5,124,1794,59,46,3,6,3131,5039
22641,9,741,786,101,52,13,6,1406,2364
69694,9,302,131,6,2,0,0,226,365
9397,9,607,2090,87,39,12,6,3029,5263
891,9,575,148,2,1,0,0,259,410
169290,5,124,3653,102,50,8,31,5992,9836
3995,4,581,456,23,11,1,1,842,1334
166041,7,489,1552,58,27,2,15,3270,4924
25837,6,124,3210,114,54,6,17,6479,9880
3471,4,800,200,3,2,0,0,284,489
53543,4,800,773,20,8,4,5,1216,2026
170225,5,124,397,5,1,2,2,587,994
12183,5,655,202,10,3,1,3,325,544
85557,8,800,13290,583,244,36,104,22069,36326
55567,4,581,125,2,1,0,1,198,327
77744,4,800,517,22,9,1,5,873,1427
84544,6,306,26158,1040,421,148,163,38575,66505
78869,4,375,2857,126,92,11,18,6363,9467
27582,4,885,13394,361,204,47,82,24461,38549
60845,6,306,3639,62,36,5,28,5929,9699
139760,4,159,1271,22,16,0,13,1895,3217
86427,5,225,8239,253,133,45,54,13152,21876
74352,4,752,11754,224,153,10,69,19392,31602
30678,5,78,4926,167,110,10,38,7882,13133
117692,6,235,10786,453,202,33,63,17016,28553
114777,4,752,589,14,10,0,0,837,1450
101181,8,800,24493,1000,338,100,158,39928,66017
26788,8,812,753,8,4,0,2,1057,1824
110310,5,306,1881,74,44,8,20,3130,5157
67673,6,78,924,4,5,0,2,1433,2368
15919,5,78,520,22,8,0,1,801,1352
141602,7,521,1870,68,22,7,2,2713,4682
144960,4,800,1223,25,15,1,4,1796,3064
24423,8,214,2948,63,30,0,16,5116,8173
7433,9,78,1044,42,25,1,15,1483,2610
66788,5,489,526,13,6,1,2,608,1156
129519,4,174,410,4,0,0,2,592,1008
106586,6,124,3895,108,55,6,35,6296,10395
116220,4,581,3837,80,28,3,21,6343,10312
62951,8,214,312,3,0,0,2,438,755
53365,11,885,55,0,0,0,0,52,107
169741,4,174,1924,87,33,2,9,3399,5454
44882,6,124,936,20,11,1,7,1864,2839
10710,7,306,731,8,5,1,3,1927,2675
76879,6,124,249,4,3,0,0,371,627
152179,8,214,3364,94,42,5,17,5396,8918
9087,7,306,6600,264,113,34,39,11901,18951
46008,6,124,2,0,0,0,0,3,5
1681,6,124,595,15,7,0,3,855,1475
75527,8,214,3406,56,22,2,22,5697,9205
79488,11,545,237,7,0,1,0,319,564
109144,8,623,905,21,8,1,6,1211,2152
157099,7,448,178,4,3,0,0,578,763
51862,7,448,463,29,12,5,2,1446,1957
131391,7,448,118,9,5,1,0,550,683
141173,7,448,245,19,11,1,1,1059,1336
8484,10,525,21,0,0,0,0,27,48
147218,8,812,1078,34,16,0,6,1887,3021
78370,5,78,34,0,0,0,0,43,77
49028,7,556,469,4,5,1,5,578,1062
165696,11,214,44,1,0,0,0,49,94
59934,5,404,31,0,0,0,0,19,50
6468,4,691,17962,540,279,62,88,27330,46261
16141,8,214,13100,389,179,20,75,21531,35294
61840,6,159,149,0,0,0,1,227,377
136019,8,800,1385,51,15,7,10,2237,3705
7406,5,251,8,0,0,0,0,6,14
52948,4,658,575,13,8,0,2,1011,1609
150854,9,302,605,22,22,1,4,876,1530
45512,4,581,1397,50,27,2,3,2415,3894
27069,8,800,1692,56,29,3,6,2595,4381
13526,9,489,146,7,2,0,1,201,357
53482,9,607,455,20,6,1,7,716,1205
156602,9,800,336,17,10,2,2,380,747
31068,9,800,3595,126,56,8,25,4750,8560
111608,9,607,67,9,1,0,1,87,165
145671,9,607,25,6,1,0,0,47,79
94127,9,800,28,7,2,0,0,60,97
59409,9,489,24032,630,266,50,129,37079,62186
33750,9,462,262,3,3,0,0,459,727
161479,8,214,191,2,2,0,0,287,482
143076,9,302,124,5,4,2,1,185,321
49367,8,545,5218,120,48,12,54,8592,14044
99471,9,380,360,10,3,1,0,464,838
12942,4,752,165,3,2,0,0,251,421
18912,4,885,6002,134,64,8,41,9620,15869
48379,9,693,313,28,15,1,1,433,791
66134,9,640,298,4,5,0,3,433,743
75124,7,489,213,7,8,0,2,422,652
139945,4,885,431,4,2,0,1,691,1129
81802,7,306,6293,170,74,23,39,11013,17612
903,9,302,423,4,3,0,1,561,992
7760,7,489,100,7,0,0,0,126,233
147856,5,235,1235,72,34,8,9,1824,3182
105835,8,885,177,5,2,0,0,275,459
74036,7,306,2357,77,46,3,19,3746,6248
95254,4,752,4498,122,53,2,39,9868,14582
130948,4,885,15560,521,251,35,83,24430,40880
112665,4,200,259,3,0,0,1,357,620
143045,5,232,1102,54,27,12,10,1653,2858
142488,5,489,6312,175,88,11,33,10460,17079
18103,8,214,21711,488,255,30,127,42387,64998
161118,7,496,332,1,1,0,3,630,967
97526,8,658,1239,40,13,2,12,1854,3160
116510,5,821,6032,109,49,7,33,8755,14985
112979,5,800,2112,109,46,16,11,3286,5580
125987,5,489,4061,175,67,59,14,6057,10433
128842,4,300,23,0,0,0,0,38,61
91585,6,159,715,10,5,0,6,1112,1848
121378,4,890,223,4,3,0,0,362,592
142414,4,923,707,19,12,0,2,1119,1859
66165,8,658,739,14,3,1,6,958,1721
63360,5,489,1678,16,10,0,7,2543,4254
130066,4,519,2160,65,32,4,4,3092,5357
113933,4,923,1480,35,21,1,1,2343,3881
97954,8,812,501,21,6,1,4,917,1450
73945,5,489,60,0,0,0,0,66,126
128104,4,300,1253,18,6,2,8,1770,3057
62944,8,812,648,13,8,0,3,1210,1882
99318,8,812,929,36,17,1,10,1738,2731
167983,8,355,1634,54,15,3,9,2775,4490
109022,8,812,365,16,2,1,3,628,1015
7205,8,801,195,2,1,0,0,240,438
125081,8,800,129,0,0,0,0,231,360
170404,5,489,311,2,0,1,2,496,812
94898,4,675,1261,35,25,1,8,1763,3093
62476,8,214,10542,221,70,12,52,18075,28972
60293,8,623,2036,73,28,1,3,2723,4864
3752,6,489,9815,294,128,15,79,14235,24566
155119,7,78,446,20,13,1,2,719,1201
70845,8,623,222,3,4,0,5,334,568
70261,5,479,80,1,1,0,0,143,225
17344,10,653,550,7,5,0,5,716,1283
137629,4,800,1101,23,14,1,2,1556,2697
25948,5,479,945,20,10,1,6,1413,2395
51931,5,404,259,0,0,0,0,417,676
141460,8,677,1441,37,18,2,14,2644,4156
114106,7,78,551,17,10,0,3,908,1489
69858,8,214,4533,115,50,4,42,6974,11718
69943,9,741,3815,128,81,9,24,5743,9800
51898,8,214,450,16,5,0,0,694,1165
154504,5,489,6256,127,68,6,45,10932,17434
28712,4,200,1587,49,23,3,7,2474,4143
157554,4,891,8108,148,74,10,24,13906,22270
32744,6,489,4493,143,79,12,27,6738,11492
71940,6,800,13635,610,212,143,67,21783,36450
149641,8,403,71861,2508,990,129,417,111650,187555
75963,5,159,883,30,9,0,8,1248,2178
74360,4,200,1448,39,22,0,8,2220,3737
46733,4,800,5080,152,90,11,28,9681,15042
106667,4,800,11541,280,131,28,43,19683,31706
44747,9,741,1499,0,1,0,12,2530,4042
52195,8,214,1796,50,23,2,14,2980,4865
72508,8,214,1509,40,16,1,16,2519,4101
138952,9,302,40,7,1,0,0,66,114
14829,4,800,521,7,4,0,2,905,1439
76624,5,479,2773,88,40,3,14,4337,7255
133533,8,214,1691,13,6,0,14,2862,4586
31522,8,355,710,22,11,0,2,1299,2044
51612,11,403,641,21,0,0,0,678,1340
36239,9,630,1156,49,29,2,5,1914,3155
169586,9,630,740,17,8,2,2,1315,2084
142160,4,891,12301,171,110,0,28,19090,31700
24290,4,891,4910,69,51,6,15,6884,11935
39550,8,800,340,5,2,1,2,633,983
23620,5,479,77,0,0,0,0,102,179
51371,8,214,1426,40,18,2,7,2785,4278
49103,8,306,1011,18,10,0,7,1669,2715
124874,7,587,2819,45,27,1,16,3609,6517
157917,9,302,32,0,0,0,0,53,85
156897,8,545,459,15,7,1,3,747,1232
33723,5,489,5006,188,71,26,27,7051,12369
87802,7,214,667,4,4,0,1,1148,1824
3787,7,489,299,4,2,0,3,476,784
164869,9,302,37,0,0,0,0,55,92
99287,7,46,1110,24,11,3,2,1524,2674
4635,7,214,67,0,0,0,0,111,178
60058,4,200,3302,76,45,3,21,5514,8961
21465,10,355,46,0,0,0,0,75,121
98086,9,46,74,0,0,3,0,103,180
85755,8,545,357,5,3,0,0,601,966
45576,5,200,113,0,1,0,0,160,274
4079,10,653,273,11,5,0,2,533,824
146161,7,693,708,22,20,1,3,1154,1908
83590,4,200,75,3,2,0,0,109,189
76743,9,842,1169,0,0,0,13,2519,3701
140391,7,693,204,6,3,1,2,365,581
89634,4,752,4902,91,59,1,16,6847,11916
126267,6,117,545,18,7,1,5,812,1388
143661,4,885,1038,24,15,1,7,1672,2757
166550,7,508,4,0,0,0,0,4,8
3776,6,800,5353,186,108,9,26,9585,15267
24688,6,78,6735,218,107,13,43,9657,16773
112068,6,885,5393,194,85,8,28,8732,14440
170776,6,235,1359,40,23,5,10,2220,3657
95205,9,78,747,10,12,2,8,1283,2062
91048,6,78,12489,285,112,14,52,19356,32308
33107,10,172,143,4,3,0,1,318,469
145687,8,623,213,4,4,0,2,324,547
148966,8,623,289,10,5,0,1,456,761
89356,8,623,135,2,2,0,1,195,335
46191,8,623,130,2,2,0,1,221,356
15258,8,623,6221,115,47,9,32,9294,15718
58475,8,214,3856,46,18,3,10,5618,9551
127425,8,214,2168,56,20,0,11,3286,5541
61126,10,781,1106,32,18,0,3,1484,2643
112274,8,214,7461,134,52,3,49,10973,18672
87589,10,200,341,10,4,0,1,528,884
21099,5,821,61,1,1,0,0,96,159
128237,5,821,88,0,1,0,0,113,202
16679,5,375,1374,92,45,8,10,2019,3548
13743,5,821,102,3,2,0,0,196,303
128974,7,489,337,6,1,0,1,552,897
38594,8,244,1978,45,28,0,15,3083,5149
10446,7,587,1171,28,16,2,6,1535,2758
73341,5,885,5576,281,119,50,33,8006,14065
135560,4,220,211,4,2,0,1,342,560
24810,8,545,3129,90,54,9,15,5031,8328
119979,8,214,17822,391,148,3,125,27487,45976
15734,8,214,1949,57,21,0,10,3122,5159
31107,7,587,4218,107,58,13,19,7014,11429
23696,8,885,7120,223,90,6,50,11246,18735
143930,7,587,5621,106,55,13,25,9860,15680
138651,4,581,557,6,8,0,1,1016,1588
33051,7,587,3436,72,36,6,16,5503,9069
167197,7,587,1225,23,14,0,4,1872,3138
123049,4,581,230,6,1,0,2,451,690
107711,8,214,8282,196,83,5,51,13029,21646
131615,8,214,1319,34,14,0,5,2285,3657
36685,8,214,1873,40,9,1,7,3067,4997
60796,7,587,956,19,8,0,2,1417,2402
81848,8,214,1592,25,8,1,4,2647,4277
73265,8,214,1050,21,4,0,9,1912,2996
27230,7,587,155,10,6,0,0,211,382
67942,4,581,133,0,1,0,0,234,368
89672,4,581,1263,22,10,2,6,2155,3458
62085,8,812,2807,62,26,3,14,4300,7212
107617,7,587,188,3,2,0,2,267,462
113120,7,587,265,1,2,0,1,397,666
5106,7,587,1139,19,7,1,3,1788,2957
107572,7,587,6,0,0,0,0,8,14
150296,7,587,46,0,0,0,0,65,111
4735,7,587,78,1,0,0,0,114,193
114289,7,587,33,0,0,0,0,51,84
102963,9,243,63,0,1,0,0,93,157
46482,5,800,4195,232,121,40,17,7830,12435
71736,8,596,872,23,14,1,3,1465,2378
67610,7,56,974,35,25,10,9,1343,2396
40399,8,214,2933,74,32,4,10,4326,7379
117652,4,306,784,21,19,0,3,1216,2043
139586,8,214,2663,66,18,4,20,3938,6709
46216,4,923,289,7,3,0,0,515,814
7746,8,214,7172,163,51,7,59,12890,20342
110233,7,214,641,3,3,0,2,823,1472
107764,7,306,1516,55,26,4,17,2709,4327
103026,7,56,1541,39,22,9,5,2065,3681
128116,7,587,121,0,0,0,0,152,273
48721,7,484,215,11,5,2,2,349,584
158152,8,812,2133,48,14,4,15,3554,5768
35154,9,842,130,0,0,0,1,201,332
70550,9,243,19,0,0,0,0,15,34
1480,4,306,3946,101,55,5,16,6387,10510
130264,7,710,64,3,3,0,0,110,180
6992,5,655,234,13,3,0,2,385,637
27799,7,645,3,0,0,0,0,10,13
54170,7,578,121,8,10,1,1,211,352
159285,7,214,244,2,1,0,1,405,653
97948,8,812,1070,28,13,0,5,1747,2863
118008,8,214,2115,40,12,2,18,3813,6000
153599,9,306,6175,1,1,0,44,9901,16122
165120,8,214,1426,9,2,0,4,2061,3502
157806,7,489,523,15,11,1,2,910,1462
34330,6,306,2125,41,22,8,8,3122,5326
116426,4,800,4827,61,31,9,22,7309,12259
91471,9,842,618,0,0,0,3,1699,2320
140042,9,78,1265,28,10,1,7,1878,3189
157514,9,842,728,0,0,0,3,1919,2650
51621,9,640,463,13,6,0,3,708,1193
162341,8,214,4252,69,23,1,30,6622,10997
95020,9,399,251,8,4,2,0,417,682
47576,9,487,0,1,1,0,0,0,2
112568,9,54,2,1,1,0,0,2,6
31990,4,375,49,0,0,0,0,68,117
8138,4,200,1048,15,12,0,5,1718,2798
66874,4,800,3911,79,43,3,22,8260,12318
140520,9,78,2097,75,37,8,7,3021,5245
127914,4,678,2510,61,41,7,16,3949,6584
108381,4,159,2848,32,16,0,16,4201,7113
68039,8,214,1354,16,6,1,6,2317,3700
140029,4,375,12535,420,223,29,66,20765,34038
98008,8,214,2661,73,15,2,11,4717,7479
131542,4,658,2539,92,66,8,15,4856,7576
53638,8,545,3376,115,55,5,38,4692,8281
164346,4,675,1957,42,34,1,14,3053,5101
111017,6,235,4990,348,144,46,34,7866,13428
19480,4,678,497,23,13,0,3,806,1342
19213,6,489,6042,254,135,14,35,9204,15684
131955,9,640,1834,61,36,4,8,2719,4662
5702,6,489,99,0,0,0,1,134,234
32453,9,640,7885,242,129,13,51,13071,21391
111615,9,842,4998,128,71,8,16,8520,13741
90300,7,842,3219,104,62,2,8,5467,8862
10292,4,678,1024,46,21,6,5,1646,2748
117325,9,741,107,0,0,0,0,128,235
105690,9,842,102,0,0,0,1,164,267
3673,9,842,3186,104,64,5,15,5048,8422
8710,6,165,6082,212,114,35,27,8919,15389
8832,6,489,5376,165,82,19,22,8809,14473
108410,7,741,9519,318,145,40,58,14512,24592
101333,9,630,0,0,0,0,5,1045,1050
78955,9,741,222,0,0,0,0,336,558
54290,9,741,304,0,0,0,0,485,789
33095,8,489,459,7,4,1,4,714,1189
153900,9,741,104,0,0,0,0,141,245
104429,8,214,125,1,0,0,1,137,264
140399,9,741,86,0,0,0,0,96,182
163495,8,489,1560,36,15,1,9,2671,4292
67193,8,489,721,12,2,0,0,1104,1839
56618,7,38,4141,119,76,9,26,6730,11101
64110,4,427,897,14,13,0,4,1528,2456
13659,7,587,1728,12,12,1,3,2318,4074
74623,7,885,371,8,6,0,2,915,1302
96379,6,209,574,29,10,1,3,824,1441
68096,7,741,1289,34,9,9,9,2001,3351
81515,6,174,6857,405,173,72,39,10104,17650
162344,6,306,8396,297,126,43,56,12822,21740
59410,4,453,588,1,1,0,9,1359,1958
67422,6,78,483,8,3,0,2,774,1270
81090,4,375,766,20,13,0,5,1416,2220
119774,8,214,1350,31,15,2,10,2893,4301
6701,9,399,69,1,0,0,0,126,196
135240,6,78,928,25,9,0,7,1300,2269
25870,6,78,137,1,2,0,0,212,352
152131,6,238,177,4,0,0,0,237,418
38469,9,630,9396,240,123,20,43,12822,22644
41200,6,235,2428,101,49,10,8,3744,6340
34535,6,165,474,15,8,0,1,1204,1702
57804,6,165,292,7,6,0,1,1062,1368
71184,6,306,8648,264,124,40,55,12990,22121
26958,6,159,828,31,23,0,6,1267,2155
133029,8,214,4946,105,40,6,39,7515,12651
134748,6,261,3346,77,34,10,11,5770,9248
96686,4,800,50,0,0,0,0,72,122
82259,6,306,8479,165,86,25,34,12277,21066
19246,5,375,12443,616,295,103,64,17826,31347
158437,6,78,36,0,0,0,1,45,82
88867,4,581,1678,63,20,5,6,2818,4590
59041,4,36,2965,120,85,6,21,5903,9100
96941,6,489,2667,54,23,10,22,4047,6823
168788,4,453,431,4,2,0,3,920,1360
116730,9,630,7291,224,132,11,38,11375,19071
142287,9,456,9,0,0,0,0,10,19
51916,6,375,7152,479,218,79,103,11286,19317
6894,9,630,289,0,0,0,0,543,832
22150,7,521,909,27,12,4,0,1483,2435
55994,4,427,339,7,6,1,3,752,1108
92367,7,521,906,19,15,3,1,1155,2099
164693,7,587,722,8,6,1,1,1145,1883
23629,8,545,734,26,18,0,1,1153,1932
167131,9,367,2536,96,46,19,14,3986,6697
170561,8,545,4428,49,30,0,26,7381,11914
67952,4,519,0,0,0,0,2,6628,6630
85650,6,489,17214,547,234,24,119,25848,43986
40845,9,640,2049,0,0,0,12,4717,6778
67052,9,640,2497,0,0,0,13,6216,8726
168373,4,638,1081,11,5,2,2,1463,2564
141146,8,623,536,2,1,0,0,827,1366
16826,4,923,172,8,5,0,0,311,496
14577,8,677,18484,658,258,74,143,27713,47330
40774,8,623,31,0,0,0,0,45,76
120532,8,30,4304,67,36,1,21,6448,10877
132831,6,235,2048,85,41,8,11,3508,5701
77221,8,545,2724,75,30,1,12,4053,6895
100251,6,375,6028,275,117,42,29,8428,14919
118111,7,157,1874,68,38,5,10,3246,5241
89271,8,623,395,1,1,0,0,619,1016
147579,4,638,256,3,2,0,2,394,657
156398,8,800,1712,58,26,2,14,2331,4143
108078,8,623,210,2,2,0,0,314,528
103219,4,658,2140,81,59,4,12,4207,6503
28250,8,677,917,17,17,0,5,1460,2416
140359,8,885,329,10,4,0,5,578,926
98628,4,174,408,10,7,0,2,720,1147
402,6,200,328,8,1,0,3,479,819
66320,4,923,3014,95,39,12,21,4886,8067
146568,6,124,96,3,1,0,0,135,235
112248,6,124,625,10,7,0,4,1218,1864
73994,6,416,1002,8,7,0,2,1473,2492
21438,4,453,383,11,6,0,0,545,945
136267,8,623,87,2,2,0,0,118,209
155524,8,623,175,5,3,0,0,300,483
128600,4,115,135,0,0,0,0,193,328
34017,8,623,107,0,0,0,2,195,304
6660,4,200,1008,15,8,1,3,1540,2575
146691,7,429,182,11,3,1,2,531,730
129138,9,800,433,12,7,2,5,711,1170
87207,4,174,448,8,5,1,0,698,1160
130730,4,200,853,20,12,0,1,1324,2210
127735,8,214,16953,303,118,16,101,27508,44999
19935,4,200,68,0,0,0,0,87,155
118053,6,263,4605,123,52,10,21,6304,11115
15112,8,124,182,1,2,0,1,291,477
167030,4,658,783,29,12,1,2,1370,2197
160931,8,214,3937,71,23,4,20,7184,11239
102675,8,623,542,22,9,1,1,815,1390
20869,9,630,8320,181,91,9,42,13808,22451
9075,9,630,686,0,0,0,3,1729,2418
169580,4,174,851,16,11,0,4,1295,2177
36100,8,124,1047,47,23,2,8,1434,2561
3159,4,923,744,30,19,5,2,1281,2081
110492,7,489,755,19,3,3,5,1312,2097
29466,4,365,8,0,0,0,0,17,25
12994,9,489,6711,187,101,21,42,9999,17061
91827,8,596,987,26,16,1,7,1561,2598
94014,8,693,961,39,16,0,6,1449,2471
90646,6,489,17279,581,259,53,131,25251,43554
128466,4,752,12227,224,100,9,61,18719,31340
128068,9,427,547,0,0,0,5,975,1527
59051,4,453,2368,135,59,6,9,4065,6642
19553,6,570,778,20,10,4,2,1173,1987
139998,5,800,537,23,12,7,2,1896,2477
68625,10,653,123,0,0,0,0,198,321
65755,6,306,6225,228,119,17,51,9236,15876
19662,8,885,2304,84,40,7,15,4111,6561
127944,4,800,630,18,8,0,3,1035,1694
122027,6,885,3372,141,49,12,27,5663,9264
76150,4,174,208,5,4,0,0,349,566
146121,4,800,4097,170,75,9,15,5996,10362
170081,10,653,90,0,0,0,0,178,268
107665,4,300,516,15,10,0,5,758,1304
52,4,519,1113,19,13,1,4,1626,2776
81838,6,489,4772,147,87,18,28,6887,11939
167851,4,675,59,1,1,0,1,75,137
145832,8,214,95,2,0,0,0,185,282
107950,7,563,219,7,4,3,3,282,518
116802,4,890,1765,31,12,1,14,2567,4390
109124,4,890,587,13,7,0,3,1000,1610
124575,7,578,11,1,1,0,0,17,30
36609,4,890,302,6,2,0,0,512,822
136567,6,427,2888,85,50,2,23,4261,7309
93434,5,118,153,9,6,0,0,228,396
38639,8,800,19770,950,404,27,130,33738,55019
168637,4,885,583,13,5,1,2,953,1557
66449,8,214,575,13,7,0,3,977,1575
57523,5,78,210,1,0,0,1,314,526
11990,10,752,3724,63,33,1,18,5988,9827
145936,6,489,825,1,1,0,4,1279,2110
80600,4,453,1447,38,9,2,12,2717,4225
65239,10,752,611,11,8,0,3,1120,1753
101585,6,404,1022,0,0,0,5,1648,2675
37390,8,214,757,22,8,1,9,1339,2136
166673,6,306,1139,15,7,0,16,1956,3133
24369,7,741,4455,129,71,22,34,7470,12181
96594,7,379,58,0,1,0,1,105,165
35272,4,174,973,17,8,0,1,1507,2506
144137,4,453,5175,126,60,2,41,7464,12868
45156,7,306,307,8,5,0,0,461,781
89689,4,200,225,2,0,0,1,219,447
37589,4,453,1183,7,2,0,2,1523,2717
113504,7,489,524,28,9,2,3,807,1373
1303,4,200,1502,19,13,0,5,2117,3656
71068,6,375,2483,69,38,9,22,3942,6563
81844,4,890,314,1,1,0,1,436,753
120818,4,800,1315,41,26,3,10,5884,7279
113963,5,232,3941,221,96,53,20,5997,10328
6424,4,800,16107,371,192,30,61,26621,43382
159211,4,800,44,0,0,0,0,77,121
31700,5,479,6912,243,117,23,44,10367,17706
112316,5,174,1509,119,55,23,16,2262,3984
142069,4,800,1390,60,31,7,11,2764,4263
41390,9,489,6328,1,0,0,46,9550,15925
46583,10,200,800,10,8,1,2,1154,1975
171188,10,200,287,6,4,0,3,463,763
19352,10,200,146,2,2,0,1,269,420
111472,10,519,1155,31,8,1,6,2239,3440
66413,10,200,62,3,1,0,0,115,181
25550,10,474,158,5,3,1,5,430,602
93163,5,479,11148,358,191,30,69,17944,29740
111856,9,302,2752,59,34,7,19,4196,7067
130001,10,474,180,6,1,0,0,357,544
101083,8,885,390,1,1,0,0,599,991
53536,7,741,3208,102,38,14,9,5063,8434
57740,5,269,115,1,1,0,0,175,292
97162,9,630,6288,194,112,13,43,11145,17795
85949,7,570,3174,109,56,13,13,5328,8693
119955,10,172,799,16,7,1,5,1304,2132
150863,7,570,2016,73,35,7,14,3090,5235
103085,7,741,3035,114,50,8,21,4855,8083
70757,7,741,1111,53,32,5,13,1989,3203
37165,5,693,1203,57,23,2,11,1939,3235
72831,10,81,18,0,0,0,0,26,44
99918,10,66,39,0,0,0,0,38,77
59836,7,611,54,0,0,0,0,72,126
45725,7,842,531,10,7,0,4,780,1332
52783,10,790,110,2,2,0,1,212,327
83714,10,790,187,5,5,1,4,411,613
117932,10,790,303,7,7,1,2,467,787
30897,9,489,639,0,0,0,1,2227,2867
122871,5,800,2116,48,30,1,9,3221,5425
15122,7,842,646,17,11,0,2,878,1554
126433,7,587,1244,13,6,1,2,1701,2967
129669,7,842,44,2,2,0,2,117,167
28481,7,100,19,0,0,0,0,44,63
43025,6,885,4722,156,60,15,35,8063,13051
5867,7,100,410,21,7,1,0,714,1153
64288,7,379,114,3,0,1,0,209,327
86283,9,640,1707,39,23,5,9,2535,4318
34302,4,658,580,11,6,0,3,1069,1669
169209,9,741,253,0,0,0,0,538,791
49126,8,427,3863,104,39,2,22,5816,9846
10122,9,95,29,0,0,0,0,41,70
108856,6,78,1484,26,14,0,5,1916,3445
158297,4,519,1325,21,12,0,6,1939,3303
117771,7,489,4075,119,57,17,52,6710,11030
147901,8,214,5927,75,65,3,28,10010,16108
57845,8,214,4174,67,37,2,11,7204,11495
67042,7,713,94,0,0,0,0,177,271
33943,4,658,33,0,0,0,0,43,76
109320,7,489,423,14,4,2,1,683,1127
7968,5,159,358,3,2,1,5,609,978
126710,8,489,1245,12,8,3,6,1932,3206
39465,8,489,1400,32,14,2,13,2389,3850
29228,4,519,1412,28,14,1,6,2021,3482
23540,10,790,123,0,0,0,1,178,302
3475,4,885,979,27,19,0,3,1591,2619
94652,8,214,5986,154,70,7,38,10357,16612
121440,4,200,378,11,4,1,2,482,878
136401,4,200,40,0,0,0,0,68,108
61802,4,200,92,1,1,0,0,153,247
120521,7,741,1485,64,28,7,11,2166,3761
87502,8,214,2818,61,24,3,14,5355,8275
50054,4,270,111,2,2,1,0,203,319
15642,4,923,39,2,1,1,0,83,126
148209,9,427,3083,170,94,35,14,5598,8994
72123,9,741,3540,164,70,25,22,5264,9085
77481,4,923,259,7,7,2,1,465,741
20476,7,306,563,8,4,1,5,1011,1592
87252,5,106,143,3,2,0,0,216,364
160010,10,653,312,0,0,0,3,353,668
118632,8,214,798,1,0,0,6,1275,2080
10187,4,691,8216,167,73,10,33,12374,20873
67198,6,489,195,3,2,0,3,285,488
56183,7,842,2485,77,55,7,10,4028,6662
129444,7,842,1909,70,40,3,9,3524,5555
7345,4,678,1101,29,13,3,4,1741,2891
17643,7,842,567,23,11,2,5,1134,1742
165365,9,658,106,2,2,0,0,173,283
41227,4,923,105,3,3,0,1,234,346
119358,10,242,2,0,0,0,0,3,5
75192,7,842,634,20,10,4,4,1186,1858
36256,4,270,858,14,11,0,3,1189,2075
160128,9,216,245,12,2,1,0,424,684
69502,7,216,2535,58,29,8,15,5201,7846
140203,4,174,6139,255,103,27,33,11325,17882
72095,4,200,1860,21,16,0,12,3180,5089
43576,9,306,310,0,0,0,1,622,933
126608,9,306,234,5,2,0,4,590,835
50700,7,74,227,5,2,0,0,380,614
139429,7,521,170,3,2,0,1,276,452
132424,7,56,192,7,4,4,0,277,484
62818,5,159,469,22,5,1,5,812,1314
15921,8,244,2871,100,38,4,21,4826,7860
117210,5,800,6535,331,121,89,40,9715,16831
162028,9,306,645,0,0,0,11,1617,2273
68999,5,58,803,30,17,4,3,1311,2168
143343,5,479,8063,328,174,46,60,12139,20810
129855,5,225,3624,192,85,22,23,5660,9606
49671,5,225,2955,84,63,5,17,5469,8593
69163,7,587,364,4,3,2,3,445,821
99407,5,479,10931,464,224,95,75,16048,27837
11451,9,640,1811,67,26,2,8,2777,4691
33854,4,174,556,21,6,0,1,810,1394
58930,7,429,620,23,14,2,4,1188,1851
156105,9,842,645,4,1,0,6,1715,2371
115931,7,367,166,8,6,0,3,261,444
9968,5,58,5298,306,115,72,34,8102,13927
128977,8,214,2761,49,18,4,28,4419,7279
96652,9,640,4342,106,44,12,34,5904,10442
54184,4,174,1267,25,16,0,6,2107,3421
17381,9,427,336,29,15,1,1,1030,1412
105780,6,453,47,0,0,0,0,90,137
72126,6,427,3127,91,46,11,23,4853,8151
77937,8,885,718,30,8,1,4,1226,1987
120990,7,175,204,3,1,0,0,417,625
22215,9,427,34,0,0,0,0,109,143
73267,7,306,621,5,7,0,4,1523,2160
13223,7,587,955,19,3,2,1,1763,2743
97672,7,175,1183,42,16,4,6,1878,3129
139567,5,885,1624,65,19,6,11,2435,4160
78012,4,200,239,8,4,0,4,352,607
121878,9,842,212,0,0,0,0,580,792
46403,7,535,97,6,2,2,0,380,487
84409,8,800,32900,1113,364,36,186,51095,85694
46894,6,269,2268,70,32,5,13,3636,6024
105395,6,269,5458,200,94,12,42,8652,14458
167161,9,842,983,49,20,0,4,2170,3226
83968,4,581,70,1,0,0,0,141,212
109511,7,842,319,6,0,0,1,499,825
108547,7,842,269,13,3,1,1,503,790
17707,7,30,40,0,0,0,1,69,110
44527,11,489,1011,36,0,0,1,1199,2247
4888,4,923,262,4,5,0,0,433,704
64709,6,885,1437,84,32,12,10,2198,3773
117316,10,790,227,0,0,0,1,302,530
34517,8,800,3398,119,45,7,32,6199,9800
141188,4,658,591,20,12,0,1,953,1577
112465,11,800,158,11,0,0,0,173,342
99110,5,570,2047,67,35,10,10,2765,4934
166384,9,842,4087,106,55,8,11,7670,11937
115791,7,842,252,4,1,0,2,431,690
27734,4,890,785,22,11,0,6,1090,1914
79103,6,885,441,14,10,1,3,658,1127
41739,9,800,108,6,1,0,1,418,534
4366,8,214,2992,74,35,4,11,4814,7930
147757,8,545,1018,25,18,4,5,1539,2609
64767,7,842,187,5,1,0,1,328,522
131576,8,214,1393,34,17,1,5,2393,3843
116820,9,813,8634,333,131,91,41,16855,26085
90478,11,214,11,0,0,0,0,11,22
98989,6,885,3109,179,88,42,17,4755,8190
116122,5,570,424,3,2,1,1,647,1078
105881,4,890,782,18,13,0,2,1226,2041
158569,8,545,6890,161,76,19,43,10032,17221
166124,8,306,35,0,0,0,0,45,80
132919,8,693,177,3,1,0,3,286,470
24316,7,741,1409,55,27,7,11,2960,4469
100087,4,658,1074,15,15,2,10,2294,3410
164643,6,263,825,28,11,0,3,1367,2234
116332,10,653,533,10,3,0,6,744,1296
77978,9,800,97,4,3,0,0,485,589
94795,8,375,2270,90,46,6,17,3812,6241
124894,7,489,1510,58,29,7,13,2695,4312
3499,4,220,241,8,1,1,0,471,722
82855,4,36,2235,59,46,8,14,4032,6394
616,4,159,431,1,1,0,0,621,1054
14292,11,244,26,5,0,0,0,20,51
128089,8,306,3063,120,50,3,17,5268,8521
46265,9,741,2573,94,51,13,19,3532,6282
41512,6,375,1681,60,43,2,10,2612,4408
127533,11,244,29,5,0,0,0,36,70
120189,8,214,7431,77,38,2,35,11643,19226
18622,7,216,60,0,0,0,0,97,157
159541,10,790,487,11,7,0,3,730,1238
63371,4,519,1834,36,17,1,8,2575,4471
16609,4,752,1490,8,5,0,3,2737,4243
117241,7,427,907,32,16,5,5,1503,2468
40511,7,427,702,19,9,6,6,1082,1824
139948,7,427,486,20,7,3,5,966,1487
133436,8,800,4299,218,81,20,28,6717,11363
122664,8,214,7378,189,72,2,40,12527,20208
129637,4,200,826,4,2,0,2,1401,2235
14653,9,374,26,1,1,0,0,72,100
120523,4,159,167,2,3,0,2,289,463
22977,6,78,838,14,6,0,9,1374,2241
29562,7,79,2806,63,33,11,11,4240,7164
67241,8,658,14987,450,177,37,69,22654,38374
24433,6,78,376,6,2,0,3,516,903
69460,5,78,6468,255,89,13,43,9608,16476
79297,9,800,66,1,1,0,1,161,230
135772,9,158,3356,58,25,5,17,5224,8685
162498,8,800,4272,172,55,10,28,7497,12034
67973,8,214,1743,10,3,0,7,2544,4307
51317,8,214,1435,8,4,0,6,1924,3377
133621,7,741,145,1,1,0,0,253,400
41335,10,653,990,14,11,0,5,1517,2537
81442,11,545,931,16,0,1,0,1009,1957
28632,10,653,127,6,2,0,1,274,410
144140,10,653,116,1,1,0,2,204,324
26547,8,214,974,7,5,0,2,1337,2325
96753,4,658,1594,30,19,0,5,2692,4340
46764,8,214,163,1,1,0,1,243,409
141829,10,701,163,3,2,0,2,227,397
116758,8,214,1782,6,1,0,6,2748,4543
65085,8,214,369,0,0,0,1,479,849
110379,9,341,15,0,0,0,0,27,42
18155,11,545,46,2,0,0,0,54,102
162302,4,519,1055,43,16,1,3,1384,2502
92785,7,144,82,1,1,0,0,94,178
68227,4,800,478,3,1,0,1,710,1193
78413,7,429,276,7,2,1,0,635,921
27447,7,214,1314,10,5,0,3,1833,3165
142933,4,174,2159,46,24,0,11,3232,5472
35085,4,658,5722,194,98,22,27,10078,16141
122840,8,214,1099,16,10,0,11,2010,3146
20330,5,306,9300,352,168,50,58,14563,24491
152061,6,489,1867,41,19,2,10,2864,4803
64141,9,842,8683,268,160,16,42,12995,22164
44705,5,306,5547,216,102,41,31,8154,14091
52341,9,630,2109,3,2,0,12,3622,5748
105696,9,630,525,11,6,0,5,1675,2222
59097,11,306,348,22,0,0,0,358,728
76955,4,800,467,4,4,0,4,636,1115
36733,8,489,103,3,1,0,2,188,297
123624,8,489,315,1,1,0,4,570,891
148673,8,489,564,11,5,0,3,951,1534
161133,8,489,59,1,0,0,1,87,148
147997,4,800,1298,41,27,1,14,2081,3462
76041,8,214,280,0,0,0,1,402,683
40296,8,214,47,0,0,0,0,67,114
84948,8,214,328,1,1,0,0,400,730
122954,4,890,16,0,0,0,0,27,43
50524,7,489,2363,46,25,2,9,3444,5889
168185,6,263,519,12,10,1,3,762,1307
140412,4,885,4899,161,80,15,34,8478,13667
71098,8,214,3534,60,29,0,18,4840,8481
70115,5,800,282,3,4,0,2,438,729
159981,8,30,2505,85,62,9,12,3847,6520
153854,10,104,171,0,0,0,0,254,425
88204,10,474,222,2,3,0,1,404,632
149812,5,200,2697,78,33,3,18,4063,6892
1884,10,474,70,0,0,0,0,226,296
135031,10,474,24,0,0,0,0,63,87
55115,5,124,2370,83,43,12,9,4193,6710
90105,6,263,550,7,4,0,5,873,1439
160619,7,427,1087,37,14,6,10,1880,3034
110779,8,545,2922,22,14,0,10,3966,6934
137701,4,800,228,0,1,0,0,331,560
126535,8,545,9783,438,184,32,60,17690,28187
41304,10,66,43,1,4,0,0,116,164
116257,5,479,1482,42,28,5,10,2291,3858
91629,4,174,2221,26,13,0,5,3017,5282
154864,9,489,1806,0,0,0,13,3382,5201
18344,8,214,616,7,4,0,6,1019,1652
156714,8,214,476,11,7,0,3,831,1328
36379,8,214,7,0,0,0,1,10,18
78116,6,306,5045,77,43,2,46,9058,14271
102070,4,800,2804,88,52,8,9,4637,7598
141920,4,174,802,11,5,1,5,1196,2020
157120,8,306,2011,69,33,3,11,3388,5515
19950,5,306,7228,309,156,64,39,11059,18855
77176,4,800,430,12,3,0,2,772,1219
104604,9,158,10,0,0,0,0,47,57
49542,4,923,361,10,5,2,1,619,998
71797,4,220,494,9,5,1,1,824,1334
91436,9,158,4,0,0,0,0,9,13
27775,4,658,697,25,16,1,4,2010,2753
138151,8,30,14900,669,236,83,123,23875,39886
15781,8,403,2844,94,49,5,13,4768,7773
89114,8,214,74,0,0,0,0,102,176
142853,9,341,74,1,1,0,1,174,251
141771,4,923,80,4,3,0,1,121,209
67821,9,302,43,0,0,0,0,53,96
124926,6,165,286,1,2,0,3,524,816
78797,8,596,1983,47,16,3,7,3104,5160
93191,9,532,4,0,0,0,0,6,10
148255,4,174,169,1,1,0,1,258,430
122278,6,165,1407,23,11,1,3,2271,3716
165884,9,570,1362,52,29,7,7,2082,3539
135906,4,923,175,11,2,0,0,237,425
53150,6,117,2088,89,46,24,29,3403,5679
17010,7,741,491,8,7,2,1,716,1225
71416,4,174,663,11,9,0,6,1225,1914
101016,5,800,888,43,18,7,8,1670,2634
31584,6,232,358,12,7,0,2,614,993
127158,4,752,566,7,2,0,2,737,1314
24703,9,800,2072,42,20,3,17,5221,7375
100895,7,521,374,6,6,1,1,734,1122
138842,8,885,76,2,1,0,0,95,174
73467,5,225,2418,80,35,22,14,3942,6511
54701,4,174,1264,21,11,1,4,1888,3189
89586,7,427,891,19,15,1,4,1309,2239
88572,4,890,240,3,1,0,0,333,577
31001,7,448,1131,47,24,7,5,2782,3996
112179,4,890,406,11,4,0,1,560,982
42838,6,117,2799,77,35,4,11,4276,7202
49891,4,800,2255,41,8,1,6,3288,5599
16894,4,453,519,3,4,0,3,737,1266
128747,8,489,13737,562,210,35,77,22353,36974
75842,7,563,1835,38,18,8,11,2963,4873
109843,9,570,1276,45,22,6,6,2019,3374
120580,8,124,1002,13,8,0,9,1861,2893
58682,9,570,525,0,0,0,3,856,1384
153396,8,545,2890,24,12,0,12,4758,7696
25008,8,545,249,0,1,0,0,397,647
124893,4,923,240,6,5,1,0,393,645
165923,4,923,36,0,0,0,0,83,119
148856,8,658,1282,46,17,3,5,1988,3341
113139,6,232,952,16,9,2,10,1669,2658
80650,7,587,224,0,0,0,1,319,544
91554,5,479,2752,90,39,10,28,4090,7009
124608,7,563,543,17,9,1,3,1021,1594
65233,8,800,4858,165,74,8,27,7730,12862
133792,5,174,5218,203,102,32,35,8060,13650
155680,8,124,754,28,7,0,6,1316,2111
140567,10,790,75,0,0,0,0,120,195
135663,10,628,37,1,0,0,1,51,90
149044,4,752,1619,41,20,0,11,2431,4122
123556,7,157,1534,33,19,4,5,3749,5344
54084,7,157,2192,42,23,4,16,5104,7381
51349,7,489,835,23,10,4,5,1233,2110
68445,7,527,607,49,26,12,1,820,1515
146537,7,570,748,25,17,1,0,1231,2022
139018,9,640,1870,51,37,2,10,2662,4632
26401,8,306,164,2,2,0,1,192,361
100684,6,232,1283,54,23,5,9,1927,3301
85045,7,56,739,34,22,6,6,933,1740
152517,4,596,177,4,0,0,1,250,432
145161,10,790,364,7,5,2,1,628,1007
37649,10,790,362,9,8,1,0,556,936
154898,4,752,188,0,0,0,0,291,479
61679,7,216,664,11,6,1,2,896,1580
146838,7,157,1621,27,28,2,6,3974,5658
11881,4,752,185,0,0,0,0,297,482
61701,7,157,940,20,14,3,4,2903,3884
12599,7,216,751,10,11,1,5,1115,1893
148347,4,581,311,1,1,1,1,476,791
54042,7,306,3773,101,56,8,23,5488,9449
169585,11,214,32,0,0,0,0,39,71
23231,4,200,389,0,0,0,3,616,1008
123052,10,790,92,7,4,2,0,177,282
116089,10,790,137,11,6,4,2,230,390
155791,11,489,227,15,0,0,0,250,492
37627,7,79,13,0,0,0,0,18,31
99646,8,30,4335,146,61,9,21,6714,11286
73469,8,545,12487,540,167,47,84,18366,31691
7643,5,479,6096,149,91,10,36,9296,15678
59750,4,890,583,13,6,1,1,950,1554
90203,7,216,314,5,4,0,2,491,816
151395,4,200,1370,26,12,1,9,1980,3398
79496,4,200,332,6,5,0,2,465,810
118400,4,752,874,15,6,0,6,1158,2059
117054,7,521,29,0,0,0,0,48,77
16569,4,230,3548,53,31,6,12,6332,9982
105683,5,174,866,41,14,4,5,1416,2346
164318,8,214,7992,309,128,16,59,13366,21870
114132,8,214,1534,29,6,3,8,2438,4018
138631,8,214,83,1,1,0,0,90,175
53857,8,214,3636,109,49,5,22,5834,9655
15117,8,800,3573,136,94,9,18,5580,9410
35703,11,885,106,0,0,0,0,122,228
38067,4,752,185,2,1,0,0,245,433
37389,7,216,1061,27,12,0,6,1676,2782
31216,7,216,3943,152,82,7,16,7735,11935
81221,4,453,638,17,7,0,5,1091,1758
36632,4,174,2160,60,33,0,10,3441,5704
39455,8,214,2831,32,8,3,12,4566,7452
140389,6,827,95,2,2,0,0,167,266
40787,7,563,109,5,3,1,2,222,342
73751,4,220,160,3,0,0,0,308,471
139448,8,214,2120,23,9,2,12,4286,6452
164060,4,220,674,21,9,3,5,1211,1923
104599,7,563,23,0,0,0,0,34,57
107318,8,214,1017,25,17,1,9,1594,2663
119103,4,220,179,6,3,0,1,323,512
85566,7,587,8119,173,90,16,34,13089,21521
30041,7,587,1285,26,14,1,6,1796,3128
73640,4,174,140,2,0,0,1,201,344
342,4,375,376,10,4,0,2,706,1098
63609,10,653,1954,53,22,3,12,2976,5020
17143,8,489,240,6,1,0,2,355,604
136780,7,56,101,5,2,0,1,150,259
26374,8,489,151,5,2,0,1,266,425
117029,8,489,242,5,1,1,1,399,649
127894,7,755,46,1,1,0,0,61,109
135089,9,367,1237,40,17,5,6,2418,3723
25832,4,638,288,7,3,0,0,497,795
60214,4,159,4172,137,71,10,22,7379,11791
75376,9,842,968,25,16,2,5,1450,2466
87181,8,214,3547,42,17,0,23,4732,8361
57612,4,174,2660,82,20,5,16,4116,6899
55497,9,489,2725,113,65,20,14,4382,7319
10768,9,100,921,54,33,5,2,1654,2669
17320,9,100,624,31,17,0,1,1104,1777
20106,7,157,80,0,1,0,0,134,215
64625,9,630,3892,84,50,4,7,6438,10475
132762,7,56,679,18,8,3,3,1091,1802
138727,7,157,355,7,3,1,1,719,1086
5948,7,587,665,10,8,0,1,960,1644
37409,4,200,6511,158,74,6,33,9571,16353
135933,5,124,20,0,0,0,0,28,48
102920,8,214,130,1,1,0,1,173,306
130603,9,640,655,6,6,0,4,1060,1731
32260,5,78,4850,119,46,4,29,7629,12677
53136,4,174,169,2,1,0,0,217,389
58705,7,157,896,27,12,1,3,1660,2599
113574,7,61,130,0,1,0,0,190,321
5018,5,78,628,16,8,2,4,899,1557
167415,4,638,18,0,0,0,0,31,49
17290,9,630,2455,133,76,6,8,4347,7025
49808,9,630,1057,37,24,2,6,1390,2516
96063,5,306,2518,68,37,14,10,3561,6208
78371,7,216,2273,69,27,6,6,3770,6151
77402,7,484,95,4,0,0,1,96,196
10307,7,864,30,0,0,0,0,44,74
107065,8,214,1235,38,16,2,10,2594,3895
103890,8,214,6253,125,64,3,26,10155,16626
157934,7,492,228,3,0,1,0,341,573
120076,6,235,3329,94,61,5,16,6006,9511
42238,7,492,9,2,0,0,0,39,50
142289,5,447,265,1,1,0,2,416,685
162333,8,489,766,5,3,0,1,2118,2893
101254,9,813,1131,47,27,6,0,2467,3678
6716,6,117,783,24,10,6,3,965,1791
9906,7,842,1571,58,26,8,6,2680,4349
125663,4,174,539,18,12,2,0,896,1467
137323,6,78,472,6,4,0,1,746,1229
169130,6,78,1153,17,14,0,3,1896,3083
107239,8,214,922,5,2,0,4,1459,2392
120190,6,78,779,5,5,0,3,1242,2034
19597,6,78,233,3,2,1,1,344,584
155017,8,545,7312,311,109,21,35,11653,19441
16024,7,56,160,7,5,2,1,229,404
129763,6,78,398,2,2,0,2,575,979
74990,7,484,5,0,0,0,0,5,10
75572,7,484,2,0,0,0,0,2,4
24683,5,124,1056,37,12,4,3,1615,2727
12987,8,124,45,0,0,0,0,91,136
90134,9,374,2,0,1,0,0,1,4
86002,6,78,1639,28,16,0,12,2569,4264
143828,10,36,110,1,0,0,0,326,437
143748,9,489,217,2,2,0,3,308,532
9979,9,100,2381,51,21,1,12,3552,6018
113008,8,124,199,0,0,0,1,310,510
136282,5,159,449,11,4,1,3,715,1183
135111,4,885,1628,35,20,1,9,2529,4222
106310,7,489,1617,63,19,9,18,2854,4580
107061,7,489,2346,46,38,4,10,4592,7036
155392,8,124,372,3,2,0,1,679,1057
32760,5,408,294,8,4,0,3,478,787
157841,4,638,201,5,2,1,1,275,485
5567,10,36,0,0,0,0,1,705,706
102049,4,581,1413,44,32,1,6,2267,3763
127670,7,489,600,13,8,2,5,1637,2265
56737,6,800,3639,113,39,14,20,6321,10146
109472,5,479,981,25,14,3,6,1476,2505
74630,7,489,5990,227,106,31,45,9568,15967
120793,9,462,660,13,5,0,6,1008,1692
143037,9,100,1413,36,22,2,8,2241,3722
211,9,489,6371,193,101,23,43,9955,16686
161260,4,36,1553,52,20,2,5,2379,4011
85907,7,648,137,4,2,1,0,222,366
84312,7,306,2538,63,31,8,8,3758,6406
20522,5,58,376,11,7,0,0,606,1000
138580,4,220,228,0,3,1,1,451,684
92836,5,375,159,4,3,0,3,192,361
53528,5,118,1644,51,22,7,18,2339,4081
64531,8,124,354,5,3,0,4,531,897
145457,9,100,1509,36,18,0,5,2118,3686
33237,6,78,77,0,0,0,0,112,189
81591,10,36,5049,28,19,2,19,7417,12534
123160,8,623,128,1,0,0,0,142,271
52042,9,100,457,13,3,0,1,562,1036
25359,5,118,462,8,2,0,3,800,1275
132417,8,214,6874,142,53,20,27,11399,18515
36057,4,800,182,1,1,0,1,243,428
81887,9,589,80,1,0,0,0,131,212
114391,5,427,5091,164,81,23,20,8277,13656
136734,8,489,880,24,12,0,13,1599,2528
84205,6,165,5761,189,82,13,47,8878,14970
124069,4,375,711,29,31,0,4,1055,1830
61972,8,124,449,9,5,0,2,651,1116
39674,8,655,1451,38,13,0,4,2433,3939
167843,9,100,217,11,4,0,1,260,493
41778,5,306,2962,78,49,8,24,3942,7063
63129,10,618,5,0,0,0,0,31,36
164833,5,693,4065,120,59,11,23,6824,11102
107760,4,885,2049,29,15,0,18,3080,5191
25968,10,104,227,4,3,0,4,350,588
114597,8,812,1193,32,21,0,9,1731,2986
169080,5,306,1494,34,18,4,8,2141,3699
25328,8,489,79,0,0,0,0,162,241
113182,5,263,1554,30,22,1,3,2031,3641
131478,6,78,1341,30,11,2,3,1892,3279
128117,9,86,82,1,2,0,0,111,196
2645,11,545,36,13,0,0,0,39,88
134330,8,693,2013,70,22,6,25,4084,6220
20576,9,78,262,11,3,1,1,376,654
135987,8,124,11,0,0,0,0,18,29
59491,5,78,1933,42,43,3,16,3026,5063
109690,5,263,2341,109,52,6,17,3677,6202
4470,10,36,377,2,2,0,2,670,1053
140829,5,118,1135,56,38,7,1,1891,3128
4008,4,174,825,33,13,3,4,1417,2295
147080,4,800,45,0,0,0,0,57,102
18254,6,427,1913,79,46,5,11,2934,4988
148685,4,36,1776,71,93,3,6,3814,5763
160198,5,225,1278,49,28,5,8,2268,3636
60230,8,800,8096,312,97,31,47,13128,21711
158892,8,214,6,0,0,0,0,8,14
50805,4,752,1784,29,20,0,17,3867,5717
22238,5,489,2489,149,63,28,15,4062,6806
17099,6,453,18,0,0,0,0,33,51
28470,8,623,42,0,0,0,0,50,92
35939,4,800,169,1,0,0,1,282,453
116296,8,489,844,22,7,3,4,1228,2108
136441,4,306,709,21,16,2,8,1409,2165
24580,4,453,161,1,0,0,3,261,426
57227,6,78,1093,17,9,0,9,1681,2809
102113,8,916,5,0,2,0,0,0,7
18152,4,885,508,0,1,0,2,715,1226
76270,8,885,8663,274,85,5,79,14658,23764
38518,5,728,95,6,1,0,0,149,251
163073,4,923,37,2,2,0,0,64,105
120650,11,489,233,4,0,0,0,251,488
147328,10,617,145,2,3,0,0,242,392
84089,8,693,1336,49,22,0,8,2260,3675
74612,9,306,703,0,0,0,6,1800,2509
64826,11,545,448,22,0,0,0,518,988
130812,4,200,226,3,2,0,3,410,644
126552,6,78,2478,75,42,2,18,3778,6393
35868,8,214,537,0,0,0,5,771,1313
143962,4,159,3677,67,40,0,27,5605,9416
68358,5,479,855,10,17,0,3,1494,2379
120419,9,427,2943,299,163,36,17,5433,8891
51622,6,78,1251,34,21,0,4,1867,3177
16373,9,427,2606,4,1,0,20,4349,6980
42045,4,453,102,0,0,0,0,159,261
8862,4,174,137,1,1,0,0,215,354
50684,8,214,1989,48,14,1,19,3193,5264
129830,9,545,66,2,2,0,0,80,150
69546,9,427,139,2,0,0,2,454,597
86610,9,630,44,4,0,0,0,64,112
111667,7,741,508,10,3,1,2,881,1405
126478,8,800,3697,138,72,6,34,6142,10089
151917,7,741,751,14,18,1,2,1152,1938
48092,4,200,249,1,4,0,1,329,584
45863,4,200,510,9,6,0,2,762,1289
75375,4,658,30,0,0,0,0,56,86
153462,8,800,16,0,0,0,0,34,50
27537,6,269,6238,188,81,9,49,10285,16850
123096,6,269,1489,48,32,4,13,2465,4051
138644,7,56,299,11,3,4,6,428,751
35988,6,78,739,1,3,0,3,1473,2219
84939,10,917,54,0,0,0,0,66,120
126144,8,545,4758,133,52,20,42,7389,12394
111355,4,800,225,3,4,0,2,456,690
74956,7,56,352,17,4,2,1,567,943
8600,9,306,598,0,0,0,4,1357,1959
149449,6,585,900,21,14,0,8,1414,2357
135244,7,844,73,3,3,0,1,80,160
50091,8,885,1843,72,24,3,19,2877,4838
50847,4,800,334,1,2,0,1,449,787
146791,4,581,3,0,0,0,0,5,8
32726,6,693,958,48,34,5,5,1511,2561
77723,8,30,3967,112,38,8,22,6150,10297
3919,8,800,798,23,15,1,2,1354,2193
1058,8,375,2277,128,72,9,14,3703,6203
30808,8,658,1618,56,19,6,10,2401,4110
26672,5,124,1718,51,17,10,9,3104,4909
88184,5,306,1592,54,34,5,9,2469,4163
45039,4,519,55,3,4,0,0,94,156
67032,7,118,981,45,15,7,7,1795,2850
4607,9,427,125,0,0,0,2,407,534
116349,10,831,384,15,7,1,5,758,1170
117262,5,427,1039,26,18,4,6,1616,2709
115591,9,427,74,0,0,0,1,204,279
54410,6,306,1289,16,6,1,13,1893,3218
142938,9,427,165,0,0,0,4,341,510
33059,4,885,181,0,1,0,0,282,464
159610,7,387,406,18,6,1,2,671,1104
56832,9,427,1453,4,1,0,11,2301,3770
103986,4,36,769,14,11,0,5,1339,2138
51684,8,306,369,6,1,0,1,570,947
12776,4,375,763,26,22,3,6,1238,2058
12607,5,78,578,9,5,0,2,937,1531
115907,4,658,1451,26,18,3,5,2404,3907
98384,5,375,299,10,4,2,1,401,717
24432,9,658,1107,41,19,4,13,1565,2749
53473,5,78,466,7,3,0,2,634,1112
7036,8,489,924,4,1,0,7,1463,2399
96119,5,78,509,16,9,1,1,807,1343
158171,4,306,115,2,1,0,0,162,280
39062,7,306,1445,27,16,5,7,2327,3827
117640,5,375,966,63,29,7,6,1509,2580
43222,5,78,8,0,0,0,0,8,16
8210,9,630,2837,113,57,11,12,4547,7577
30986,6,200,335,4,1,0,1,436,777
51528,5,58,2691,81,30,15,15,4203,7035
146750,5,225,1138,2,2,0,9,1797,2948
113920,8,306,2659,62,38,1,15,3893,6668
120627,7,489,979,34,15,2,2,1404,2436
15392,9,203,180,4,3,0,0,255,442
163206,5,225,1578,77,35,12,12,2720,4434
140573,8,306,63,0,0,0,0,99,162
28253,5,225,747,36,20,2,8,1708,2521
166370,5,225,1382,29,12,5,8,2098,3534
81908,8,800,105,0,1,0,3,173,282
95745,4,300,768,34,13,2,5,1530,2352
63807,4,675,562,3,6,0,2,1025,1598
82481,6,269,4666,204,113,32,34,6859,11908
114116,7,427,752,36,20,5,10,1352,2175
85272,6,885,812,27,13,1,1,1462,2316
116975,4,519,311,7,4,0,2,616,940
140170,5,78,117,0,0,0,0,189,306
52717,4,638,1660,48,31,2,6,2545,4292
158623,8,677,3359,122,59,7,17,5306,8870
74054,7,118,1020,84,49,11,15,1580,2759
153846,8,800,906,43,14,0,9,1277,2249
65312,7,118,176,4,1,0,2,275,458
23476,5,78,96,1,0,0,1,125,223
137586,9,302,22,0,0,0,0,28,50
92055,9,630,915,1,1,0,6,2432,3355
43843,9,630,581,0,0,0,5,1659,2245
136396,7,693,267,3,2,1,1,434,708
87230,7,157,1409,74,39,9,7,2352,3890
171042,9,302,225,13,8,0,2,449,697
109384,8,214,107,1,1,0,1,204,314
72551,6,306,309,5,4,0,3,534,855
31323,4,519,168,2,2,0,1,297,470
92024,7,521,392,4,4,0,0,622,1022
69667,7,24,428,23,5,2,0,906,1364
126114,5,225,547,9,5,0,3,960,1524
101824,5,78,1023,44,16,0,10,1486,2579
59580,7,535,3224,116,42,12,26,5670,9090
110464,7,535,389,21,11,0,6,921,1348
162621,7,521,2126,66,29,4,15,3039,5279
27858,8,677,3655,59,24,1,25,5884,9648
149211,9,6,433,14,6,0,0,623,1076
1233,6,800,150,7,4,0,1,188,350
50691,9,427,310,8,4,0,0,909,1231
143139,4,885,6129,247,115,27,27,9428,15973
64506,8,885,850,6,4,0,6,1293,2159
42988,6,375,14662,556,277,112,100,21529,37236
12736,5,427,1122,73,29,11,11,1615,2861
132926,8,214,748,21,9,0,3,1205,1986
120347,8,214,139,1,0,0,0,205,345
2720,8,214,9,0,0,0,0,33,42
26679,9,302,102,3,4,0,0,126,235
144589,8,214,3550,92,25,1,23,5899,9590
122293,4,885,977,11,8,1,5,1515,2517
52476,8,214,6285,163,57,7,44,10769,17325
140198,9,158,650,10,3,1,3,918,1585
33951,9,302,36,1,2,0,0,64,103
110080,4,200,190,0,0,0,0,221,411
149720,5,479,2089,62,31,3,11,3544,5740
7349,9,302,42,2,0,0,0,84,128
41474,9,873,149,2,1,0,0,178,330
59841,7,489,1525,32,16,0,4,3095,4672
160861,7,489,371,13,7,0,3,543,937
48413,6,235,84,4,1,0,0,121,210
71561,5,225,428,17,8,1,3,738,1195
131149,7,587,643,9,6,1,3,1035,1697
102801,5,118,196,8,4,0,2,348,558
99944,7,489,1166,25,9,0,3,1723,2926
91313,4,923,294,8,5,0,1,489,797
42381,9,427,34,0,0,0,0,234,268
137332,10,790,205,1,2,0,2,380,590
35533,4,306,6878,107,40,9,35,11234,18303
158534,5,293,48,5,1,2,0,91,147
14098,6,269,2422,94,55,7,16,3589,6183
31501,8,403,309,4,2,0,3,517,835
166369,4,174,170,2,2,0,0,274,448
36760,7,570,2511,71,30,7,10,3715,6344
64840,6,306,152,0,0,0,0,199,351
55874,5,306,262,1,1,0,2,439,705
24323,5,371,45,4,3,0,0,85,137
5458,5,489,270,5,3,0,1,391,670
77218,5,489,1065,20,11,1,6,1492,2595
33258,7,38,5881,162,61,17,47,9796,15964
81867,9,874,81,7,1,0,1,91,181
96058,10,790,122,8,1,0,0,246,377
55866,5,489,95,1,1,0,0,141,238
157750,5,306,13517,403,166,39,84,20891,35100
97094,6,269,1112,20,11,1,8,1600,2752
121026,4,885,976,27,16,1,3,1473,2496
150158,6,124,1595,73,26,3,10,2567,4274
52599,6,489,405,0,0,0,5,733,1143
105557,8,124,2590,86,40,3,9,4624,7352
57038,5,200,1181,33,10,0,7,1678,2909
39473,7,404,197,0,0,0,2,319,518
7545,7,587,548,17,9,2,8,862,1446
142304,9,151,2,0,0,0,0,3,5
85933,9,151,2,0,0,0,0,3,5
73013,8,306,1352,17,9,1,6,3600,4985
45797,6,235,1433,55,27,6,3,2173,3697
79819,8,214,207,1,1,0,0,267,476
31384,6,78,4,0,0,0,0,4,8
164866,5,800,2069,67,39,5,10,4001,6191
99056,6,570,224,3,2,0,0,361,590
60921,7,489,321,22,6,0,3,507,859
121522,8,214,843,0,0,0,1,1215,2059
119111,8,214,6291,155,59,4,31,9997,16537
154338,7,285,110,1,1,0,1,201,314
6033,8,214,768,24,10,1,5,1061,1869
142065,7,285,66,1,1,0,2,78,148
165291,11,403,280,9,0,0,0,341,630
150149,6,306,1147,7,3,0,6,1778,2941
23087,8,214,35,0,0,0,0,46,81
109660,6,78,1391,16,8,2,4,1956,3377
97777,7,587,261,5,8,0,4,417,695
74427,7,38,1653,42,25,4,4,3307,5035
10120,6,78,1240,21,13,0,2,1933,3209
20393,5,489,4170,80,41,6,21,7157,11475
86051,6,235,3975,122,42,3,28,7380,11550
38442,7,587,866,22,12,2,4,1321,2227
3601,4,890,752,21,12,0,4,1026,1815
45393,5,263,424,14,7,0,6,744,1195
75092,6,263,1234,44,24,2,10,1856,3170
144307,5,225,243,9,2,1,1,460,716
155118,4,519,254,9,5,0,1,462,731
89490,11,489,274,14,0,0,0,281,569
62184,6,296,361,8,6,1,3,622,1001
74232,6,306,1107,21,6,5,9,1936,3084
137135,4,124,81,1,1,0,1,133,217
111585,8,214,1337,5,4,0,4,2120,3470
123114,6,263,191,0,0,0,1,307,499
157380,10,66,245,4,1,0,1,422,673
171002,9,741,2549,224,123,20,10,3746,6672
148308,6,453,389,8,5,0,3,579,984
9333,6,489,50,0,0,0,0,80,130
68635,6,263,778,13,9,0,1,1132,1933
127467,4,519,1967,31,10,0,7,2644,4659
103881,8,596,1062,24,10,1,10,1762,2869
84014,4,519,1237,14,8,0,9,1591,2859
70494,4,800,1210,26,15,1,5,1775,3032
128439,6,235,234,6,0,1,2,503,746
106321,4,220,209,4,2,0,2,381,598
102374,6,269,1230,29,13,0,7,2011,3290
11650,6,489,68,0,0,0,0,77,145
124864,5,355,650,9,6,0,5,1034,1704
160870,5,235,1462,90,46,10,8,2258,3874
18436,6,296,44,0,0,0,0,81,125
115498,5,225,108,4,0,0,0,168,280
122446,9,630,2279,43,25,5,9,2931,5292
59547,4,174,423,3,3,0,1,661,1091
154208,5,570,4268,111,38,6,15,6268,10706
167632,5,225,103,2,3,0,0,145,253
61669,4,890,739,19,8,0,2,988,1756
107248,4,658,839,19,10,1,6,1407,2282
63521,8,214,443,7,3,0,3,692,1148
151789,7,196,20,0,0,0,0,37,57
104798,4,658,39,0,0,0,0,63,102
23163,5,263,1698,42,17,4,19,2492,4272
106045,7,427,1454,36,19,3,9,2157,3678
51153,4,885,451,13,1,0,3,680,1148
60006,4,174,1435,33,15,1,5,2185,3674
19707,10,66,6,0,0,0,0,9,15
112732,9,78,477,10,6,1,4,782,1280
24632,4,923,116,3,0,0,0,235,354
76807,9,538,607,11,7,0,5,831,1461
60819,10,550,24,0,0,0,0,32,56
95584,5,200,1484,40,23,1,20,2153,3721
110826,10,200,1136,20,23,0,4,1703,2886
46349,7,563,69,3,2,0,1,190,265
151653,11,545,306,21,0,1,0,362,690
162127,5,293,89,0,1,0,0,128,218
74134,4,174,365,9,10,0,1,597,982
78613,9,380,288,10,5,1,1,634,939
89278,7,489,305,11,10,1,1,594,922
24689,7,157,886,18,13,3,1,1368,2289
737,7,521,3319,137,52,27,23,4774,8332
109342,7,489,416,5,3,1,3,617,1045
6672,9,380,52,1,1,0,0,58,112
149442,5,570,2109,82,25,25,9,3193,5443
93518,11,545,1385,126,0,1,0,1613,3125
83048,8,214,3993,62,19,2,18,6040,10134
81010,7,216,4292,138,67,12,27,7237,11773
132190,9,306,2417,242,139,13,15,3846,6672
30972,6,489,2973,91,59,4,26,4667,7820
7913,11,489,232,17,0,0,0,286,535
74609,8,800,1483,68,31,5,8,2600,4195
34772,6,885,419,12,6,0,2,744,1183
97079,7,741,2034,65,24,3,10,2961,5097
34867,7,78,1534,73,25,7,1,2385,4025
8990,7,587,4039,105,53,4,18,6485,10704
118537,6,885,176,1,1,0,1,266,445
95376,4,890,2240,62,24,3,8,3579,5916
135524,5,479,641,11,8,0,4,1135,1799
7448,10,66,153,1,1,0,2,255,412
138027,8,30,255,5,3,0,3,565,831
167653,5,479,1190,72,25,19,10,2035,3351
130199,9,100,143,3,3,0,1,174,324
163493,8,306,319,2,1,0,1,447,770
96191,8,306,482,5,4,0,1,705,1197
45292,4,199,1726,48,38,4,15,2748,4579
97206,4,885,196,0,0,0,1,320,517
42497,5,479,3358,85,44,1,30,5060,8578
150117,8,214,177,0,0,0,0,231,408
136494,9,741,66,1,0,1,0,122,190
142616,11,623,1,0,0,0,0,2,3
53865,9,842,5323,198,107,17,43,8207,13895
112495,8,214,1960,8,4,0,7,2622,4601
5621,7,78,476,11,7,0,1,723,1218
136894,7,100,448,23,8,5,1,815,1300
92254,5,479,857,4,4,0,2,1253,2120
161594,8,623,2918,47,21,5,17,4287,7295
153257,9,301,107,0,0,0,0,159,266
9949,10,752,1398,26,15,1,12,2498,3950
97481,4,800,828,15,5,0,4,1287,2139
70532,4,519,297,1,5,0,3,496,802
49428,7,100,154,5,4,1,0,337,501
85106,7,521,666,26,19,0,5,1237,1953
166897,6,800,3032,138,66,13,19,5332,8600
86501,7,100,69,3,2,0,0,252,326
10348,6,235,3648,90,42,6,9,5876,9671
72597,7,741,2701,79,39,8,25,4668,7520
169009,7,78,711,17,8,0,3,975,1714
165029,6,800,1955,87,45,22,12,3638,5759
150966,7,429,302,13,6,3,4,858,1186
130134,8,489,35,0,0,0,0,44,79
57293,4,519,663,17,3,1,0,1157,1841
64274,4,519,1519,20,17,0,6,12977,14539
168156,10,474,132,0,0,0,1,160,293
163943,7,314,27,1,0,1,0,68,97
28958,7,100,140,1,0,12,0,182,335
42662,7,521,425,21,10,1,2,722,1181
157952,4,890,2210,51,30,1,14,3293,5599
145103,7,521,925,30,15,7,10,1397,2384
69347,9,640,179,5,3,0,0,303,490
113727,5,235,34,5,2,0,0,60,101
35208,5,293,1290,32,14,10,4,2070,3420
72471,8,214,7119,14,10,0,17,10835,17995
101408,7,741,28,2,0,0,0,49,79
73763,9,640,270,5,5,0,3,361,644
157064,4,752,260,2,1,0,1,378,642
138469,7,508,34,1,1,0,0,141,177
134610,8,214,1785,18,11,1,4,2714,4533
99863,5,232,103,0,0,0,0,170,273
54105,4,885,553,10,5,0,2,898,1468
51948,7,211,64,2,2,0,0,71,139
102952,4,800,828,21,14,2,5,1695,2565
58094,7,263,57,0,0,0,1,104,162
41745,8,214,368,0,0,0,1,564,933
48004,6,518,483,10,3,0,1,778,1275
72734,7,100,136,2,1,0,1,229,369
134224,4,885,353,0,0,0,0,390,743
66579,5,140,973,39,19,9,4,1669,2713
7099,5,263,1559,62,24,2,13,2550,4210
149014,6,140,33,1,1,0,0,59,94
71207,9,842,4313,134,74,8,34,6296,10859
103588,8,677,1133,35,14,0,8,1798,2988
155504,10,104,30,1,1,0,0,163,195
112532,6,427,651,11,9,0,2,933,1606
13717,6,306,334,2,1,0,1,568,906
159975,9,800,1642,45,25,1,12,2209,3934
30673,9,4,1177,50,28,2,11,1740,3008
143015,5,444,90,3,1,0,0,191,285
57967,9,640,2871,84,47,2,18,3867,6889
53068,8,489,370,7,3,0,3,597,980
89542,11,214,172,16,0,0,0,192,380
27903,10,104,180,3,1,0,1,280,465
64135,5,693,412,12,8,1,8,637,1078
51283,8,214,1354,22,16,1,8,2335,3736
71863,7,589,269,12,5,1,0,444,731
20759,7,527,299,7,7,0,2,498,813
90070,5,124,708,24,8,3,3,1103,1849
57149,6,124,611,8,5,1,5,816,1446
43737,6,800,1040,30,15,0,9,2362,3456
43215,4,36,1958,54,50,1,4,4354,6421
53362,7,214,161,2,2,0,0,229,394
85917,5,447,910,14,11,0,4,1329,2268
165713,5,124,876,19,11,1,1,1237,2145
46673,8,800,378,17,6,0,3,666,1070
72966,4,174,675,17,14,1,4,954,1665
140683,7,489,572,21,11,0,5,841,1450
130042,5,447,280,2,2,0,0,400,684
71487,8,306,1345,32,16,1,7,2159,3560
157668,9,842,1201,2,2,0,6,2879,4090
161397,7,38,5429,155,80,12,29,9201,14906
111527,7,38,22603,559,226,68,127,36126,59709
110214,4,519,566,10,4,0,3,914,1497
67138,5,225,84,2,1,0,2,173,262
74517,8,800,19088,836,341,56,159,31422,51902
52540,7,693,389,17,8,0,5,998,1417
145946,8,658,10425,510,162,52,84,17391,28624
13253,5,489,2560,75,33,5,12,4140,6825
112941,6,78,2264,31,22,0,13,3583,5913
167306,4,658,324,9,3,2,1,591,930
93867,4,200,3000,78,40,2,16,4816,7952
67160,5,489,480,16,13,1,0,715,1225
154495,6,800,3695,120,56,16,22,6223,10132
163312,4,891,49,4,0,0,0,57,110
87418,7,484,1368,17,12,1,5,2159,3562
37970,5,263,114,2,1,0,0,115,232
167669,7,78,38,0,0,0,0,47,85
22925,5,159,919,29,20,1,0,1377,2346
43700,9,842,486,16,11,1,2,900,1416
3704,4,174,1185,17,9,0,6,1566,2783
6819,7,78,558,14,11,1,3,867,1454
20544,4,519,153,1,3,0,0,219,376
158684,4,36,113,1,0,0,2,167,283
139483,8,214,1540,48,23,2,6,2699,4318
14113,7,24,327,5,3,0,1,496,832
67848,10,820,370,7,4,1,0,640,1022
79405,8,214,4657,70,37,3,35,7813,12615
79575,4,36,324,6,4,0,0,494,828
148549,6,728,135,4,2,1,0,235,377
107442,6,78,474,10,9,0,1,636,1130
32977,4,36,3315,129,82,4,16,6397,9943
91621,4,800,232,7,5,0,0,403,647
86716,4,519,434,8,5,0,1,706,1154
102765,4,800,244,2,2,0,2,434,684
147078,7,79,307,7,2,1,0,456,773
2020,5,159,179,5,2,1,0,298,485
2469,5,140,837,20,6,2,5,1179,2049
77692,6,159,316,5,2,0,2,501,826
4590,6,78,245,3,1,0,1,293,543
144797,4,346,86,0,1,0,0,156,243
144242,7,78,456,18,9,1,2,757,1243
156300,4,200,276,7,3,0,0,436,722
124765,5,78,3247,122,51,3,24,4902,8349
62777,4,800,1002,11,9,0,1,1411,2434
60494,4,519,1412,23,11,2,6,2064,3518
14127,4,375,6,0,0,0,0,8,14
145923,8,214,484,10,1,0,3,862,1360
108322,9,597,506,12,6,1,3,979,1507
119757,8,214,41,0,0,0,0,71,112
146826,8,214,185,1,2,0,0,337,525
102703,5,140,502,14,5,3,1,739,1264
86859,5,263,140,0,0,0,0,185,325
168651,8,214,13291,232,82,13,43,22494,36155
138374,8,812,663,9,3,0,3,1075,1753
56192,4,800,415,9,7,0,1,734,1166
145054,8,214,675,13,6,0,4,1215,1913
51196,7,78,1019,31,17,2,6,1580,2655
105280,5,71,423,8,3,1,3,561,999
152310,6,78,2199,60,21,1,12,2975,5268
87331,6,375,1231,30,12,5,8,1636,2922
163195,4,519,2481,47,25,2,5,3190,5750
89329,8,214,3221,80,35,4,23,5352,8715
35780,4,890,216,4,0,0,0,436,656
31996,5,479,1265,26,11,3,14,1973,3292
93850,4,519,184,4,2,0,3,349,542
58179,8,812,360,16,7,0,0,594,977
104845,9,842,3738,121,56,4,23,5392,9334
86850,4,519,202,3,4,0,2,286,497
109082,11,800,244,6,0,0,0,261,511
46632,4,890,1334,33,12,1,15,1967,3362
25450,4,519,249,7,4,0,1,443,704
25446,4,519,165,1,1,0,0,306,473
77791,9,640,1058,35,17,4,5,1481,2600
117902,4,752,542,13,8,0,1,700,1264
107498,4,800,173,2,0,0,1,257,433
47563,6,78,1994,43,27,1,7,2720,4792
110565,11,545,29,2,0,0,0,32,63
100874,9,367,4127,100,43,11,21,6644,10946
139389,8,885,185,4,1,0,1,223,414
40561,8,403,392,3,1,0,2,684,1082
78197,4,174,1129,30,27,1,3,1910,3100
15830,4,174,213,9,3,0,0,345,570
129537,7,216,1581,49,20,2,5,2337,3994
154046,4,658,71,1,1,0,0,83,156
158405,8,489,4711,57,23,3,14,7185,11993
52273,4,159,44,0,0,0,0,56,100
40676,9,842,167,0,0,0,2,422,591
120983,8,427,886,26,14,1,2,1424,2353
95367,7,100,740,15,9,2,2,1129,1897
40641,7,551,19,0,0,0,0,24,43
149851,4,800,409,7,5,0,1,659,1081
56518,7,367,846,50,29,3,2,1372,2302
34493,9,597,129,6,6,0,2,277,420
163184,7,551,213,9,4,2,2,246,476
99115,4,174,606,5,3,0,3,945,1562
1830,7,56,763,23,9,5,6,1176,1982
85406,9,640,1977,57,35,3,8,3027,5107
138684,8,545,2021,74,36,3,7,3378,5519
160863,7,228,843,10,4,1,3,1222,2083
121513,7,551,482,6,3,1,0,494,986
144871,5,479,896,27,15,2,4,2125,3069
7818,4,800,253,10,7,1,2,460,733
146926,6,375,4211,185,80,32,40,6168,10716
121641,4,375,46,2,0,0,0,67,115
38265,9,640,145,3,0,0,0,247,395
6857,5,225,535,11,7,2,4,855,1414
112986,5,159,670,14,8,0,4,984,1680
109084,9,640,7877,212,102,12,40,10521,18764
113185,8,214,1164,24,16,2,8,2144,3358
143402,9,469,1717,33,21,1,7,2419,4198
106472,6,375,242,3,3,0,1,348,597
105647,6,885,378,14,5,0,1,574,972
15010,8,489,928,33,9,0,11,1623,2604
13198,5,225,139,1,1,0,0,271,412
44711,5,479,865,12,3,1,8,1673,2562
133134,9,640,6461,180,88,17,35,9723,16504
39222,5,306,5178,171,81,16,45,8441,13932
55571,5,4,48,1,1,0,0,68,118
127795,5,773,645,21,12,2,0,1001,1681
21577,4,890,1054,20,12,0,3,1582,2671
171005,5,699,561,25,11,3,6,923,1529
66644,7,660,14,0,0,0,0,31,45
150540,7,589,423,11,6,2,1,758,1201
74491,5,296,591,22,18,1,2,922,1556
11865,7,157,54,2,1,0,1,101,159
22886,6,269,2165,99,47,16,13,3406,5746
154732,8,693,8893,242,108,9,42,15844,25138
136670,8,214,1914,47,18,2,12,2997,4990
31302,8,214,1250,6,1,0,5,1804,3066
168781,7,587,1494,49,19,5,7,2904,4478
26785,7,587,332,2,1,0,0,457,792
116910,7,216,3982,102,47,7,14,6297,10449
18653,7,563,543,16,7,1,3,890,1460
38273,4,300,1,0,0,0,0,1,2
47783,8,214,529,7,2,0,2,1356,1896
106946,5,181,234,9,1,2,0,296,542
153726,11,489,307,16,0,0,0,360,683
88344,4,36,129,3,2,1,0,345,480
143717,8,214,2456,54,21,0,14,3887,6432
60425,8,244,1748,62,27,2,9,3079,4927
116359,9,630,1231,47,27,2,5,2048,3360
151257,11,30,347,15,0,0,0,365,727
115750,4,159,3,0,0,0,0,16,19
34091,4,36,436,15,10,0,1,922,1384
116204,4,658,659,17,11,2,3,1105,1797
153304,6,800,3537,85,75,2,15,6207,9921
81530,5,479,86,6,0,0,0,116,208
130663,4,174,2,0,0,0,0,3,5
54657,6,235,3894,251,117,50,18,6282,10612
78270,7,660,30,0,0,0,0,65,95
124181,4,200,4707,99,48,1,22,6423,11300
132360,7,163,58,0,0,0,0,98,156
39973,8,214,1743,20,8,0,11,2855,4637
43012,4,908,2,0,0,0,0,7,9
99909,8,214,92,2,0,0,1,153,248
141439,4,453,810,31,15,0,0,1218,2074
73098,9,302,137,0,0,0,0,236,373
39955,8,214,299,2,0,1,1,545,848
16169,9,658,9,0,0,0,0,17,26
116618,4,453,267,0,0,0,0,349,616
82008,6,78,946,20,12,0,8,1415,2401
150728,9,630,440,0,0,0,2,892,1334
128887,7,24,323,5,2,3,1,522,856
66432,8,214,556,4,2,0,1,935,1498
3979,9,78,361,17,8,0,4,581,971
79694,5,58,242,3,2,2,3,369,621
1745,8,244,930,41,13,2,5,1775,2766
158383,5,78,450,10,2,0,4,708,1174
109680,8,214,780,17,8,0,2,1171,1978
30845,8,214,843,19,7,0,4,1467,2340
86312,9,640,260,7,4,0,1,357,629
13943,4,675,327,5,5,0,4,726,1067
63537,7,489,132,2,0,0,0,232,366
35831,8,489,54,1,0,0,0,60,115
85215,5,78,206,8,2,0,0,333,549
71248,9,640,563,0,0,0,3,755,1321
18369,6,800,327,13,8,0,3,709,1060
143232,7,100,1179,43,15,3,8,1798,3046
123591,6,78,317,0,0,0,0,470,787
65537,6,301,2084,18,7,3,5,3305,5422
159601,6,800,714,16,11,0,3,1848,2592
16971,4,800,546,10,10,0,1,837,1404
106912,6,800,761,22,12,4,6,1449,2254
92081,9,640,624,13,8,1,4,844,1494
142274,6,901,150,1,1,1,1,185,339
125509,4,36,880,16,10,1,1,2177,3085
24220,4,638,356,13,4,2,4,620,999
117226,6,585,617,18,13,1,6,1009,1664
21151,7,38,5415,151,58,8,31,9123,14786
160485,6,728,1516,104,44,28,10,2370,4072
97656,8,489,718,13,7,0,3,1206,1947
90973,8,214,1334,36,19,0,6,2360,3755
15272,7,563,346,11,8,1,1,626,993
119086,5,232,154,5,2,0,1,238,400
54254,5,140,68,4,2,0,0,129,203
128406,7,216,887,12,7,1,3,1570,2480
101320,5,176,16,0,1,0,1,42,60
138408,7,118,1095,49,23,9,3,1996,3175
140874,4,658,448,9,3,0,1,750,1211
161832,4,300,149,1,1,0,1,262,414
40426,4,569,3,0,0,0,0,5,8
35080,4,752,184,4,3,0,1,303,495
141583,9,640,3302,183,101,11,16,4759,8372
18307,4,581,595,9,8,0,5,928,1545
66986,5,821,1391,31,20,1,9,1725,3177
77570,5,118,55,0,0,0,0,88,143
23915,4,212,184,5,0,0,0,363,552
166862,4,691,94,1,1,0,0,130,226
124929,6,447,759,15,7,0,2,1235,2018
75796,5,479,1517,62,36,7,12,2195,3829
55312,9,117,80,0,1,0,0,127,208
51082,8,489,724,8,1,0,4,1319,2056
4021,4,658,1993,67,39,2,10,3389,5500
78546,6,800,223,19,7,1,2,365,617
65061,4,885,247,0,1,0,1,300,549
116959,5,118,254,6,6,0,1,391,658
105242,7,587,1228,24,9,1,4,1804,3070
40088,8,214,111,2,2,0,1,207,323
86242,5,800,10897,264,120,15,48,14795,26139
48847,10,917,1252,1,1,0,3,1912,3169
37964,5,404,342,0,0,0,3,518,863
86791,10,917,14,0,0,0,0,216,230
163254,5,140,166,5,4,0,5,333,513
54764,10,917,61,1,1,0,0,325,388
92556,10,917,59,3,1,0,0,282,345
15130,10,917,22,0,0,0,0,66,88
38108,6,375,2043,148,67,13,16,3374,5661
167298,6,489,2396,71,32,3,17,3778,6297
113067,9,597,520,24,12,0,3,795,1354
692,8,214,347,9,5,0,1,673,1035
75635,8,214,437,0,0,0,0,637,1074
153029,4,658,606,14,12,0,2,933,1567
94405,8,214,1575,31,13,0,12,2382,4013
137536,9,630,133,3,0,0,2,223,361
41854,6,269,139,0,0,0,0,165,304
115900,4,200,1889,14,11,0,8,2995,4917
82686,11,677,149,9,0,0,0,159,317
12949,7,563,81,4,3,0,1,242,331
45593,4,752,287,7,3,0,2,469,768
73427,8,214,5852,105,47,1,40,9585,15630
86842,8,214,1525,43,20,0,6,2029,3623
96865,4,174,1459,30,17,0,7,2256,3769
55247,5,570,368,11,4,2,3,458,846
43444,4,159,86,0,0,0,0,125,211
73696,4,159,353,1,3,0,0,516,873
114241,4,923,58,3,3,0,0,78,142
24981,4,890,1481,42,18,0,12,2380,3933
84688,8,489,620,10,3,0,1,1023,1657
16011,6,117,567,13,6,0,5,919,1510
91490,9,630,1673,59,34,4,6,2521,4297
111249,4,752,154,0,0,0,0,186,340
73364,4,800,243,3,2,0,0,352,600
23939,8,693,18,0,0,0,0,10,28
123557,5,218,913,32,16,3,1,1286,2251
148596,8,214,961,20,12,0,10,1626,2629
20196,9,427,100,0,0,0,1,413,514
149905,5,118,510,9,4,0,2,805,1330
114205,7,563,36,3,2,0,0,56,97
60722,5,118,266,6,7,1,4,412,696
90230,8,214,431,7,3,0,1,702,1144
112293,5,218,166,1,1,0,0,186,354
13093,9,630,357,0,0,0,1,1143,1501
151208,9,842,1858,116,62,10,7,3016,5069
104955,8,214,1831,29,12,1,13,2628,4514
24065,8,214,1687,31,16,0,12,2589,4335
31021,9,842,565,0,0,0,5,1127,1697
27894,6,885,246,1,5,0,1,350,603
165119,9,374,91,4,1,3,0,158,257
167199,9,374,31,1,1,0,0,58,91
114400,10,550,57,4,2,0,0,89,152
9595,5,293,332,11,6,2,2,477,830
112942,9,374,30,0,0,0,1,49,80
25566,6,124,3626,132,47,16,21,5335,9177
151949,9,427,79,0,0,0,1,252,332
81490,6,174,1646,95,46,22,13,2600,4422
76913,4,678,201,0,0,0,4,316,521
142200,5,800,695,40,19,6,5,1152,1917
117486,5,176,35,1,1,0,0,65,102
12336,9,597,307,19,9,0,2,482,819
67602,5,821,1879,41,18,4,10,2596,4548
44624,4,270,6,0,0,0,0,10,16
58629,8,214,1418,3,2,0,6,2435,3864
2687,6,124,297,2,1,0,1,467,768
111999,8,214,4603,63,26,2,25,6910,11629
109954,6,843,1607,25,14,3,4,2609,4262
113126,7,563,17,2,1,0,0,31,51
152307,4,885,698,0,0,0,2,1056,1756
112889,9,538,27,0,0,0,0,47,74
36748,8,427,3416,147,68,17,25,6050,9723
161458,4,174,313,1,2,0,2,437,755
698,9,538,3,0,0,0,0,9,12
75703,9,842,242,0,0,0,3,566,811
135424,9,538,5,0,0,0,0,5,10
104297,6,570,1179,20,11,1,10,1876,3097
113705,6,843,34,1,1,0,0,53,89
69439,9,489,107,3,3,0,2,169,284
35562,9,489,129,3,3,0,3,218,356
135394,4,923,75,1,1,0,0,153,230
137636,5,800,7128,373,171,29,53,11255,19009
32038,4,36,221,6,2,0,2,333,564
125581,8,885,1782,43,12,0,14,2976,4827
132502,5,479,610,11,4,0,3,1000,1628
33143,7,24,462,14,7,1,2,713,1199
97425,7,489,992,13,8,2,4,1618,2637
136435,7,24,93,0,0,0,1,173,267
144361,6,261,1669,41,17,7,5,3057,4796
43783,8,214,299,0,0,0,1,396,696
101746,7,508,142,1,1,0,0,266,410
19840,6,261,863,27,17,1,4,1596,2508
74497,8,693,80,0,0,0,0,122,202
24374,9,630,631,0,0,0,3,1801,2435
35035,6,261,827,29,13,5,7,1586,2467
113452,8,800,2897,131,50,7,17,4826,7928
27127,4,800,255,2,4,0,0,360,621
49160,9,489,5512,370,215,28,24,8732,14881
80704,8,717,1049,13,8,0,3,1685,2758
37133,7,24,493,7,7,0,0,762,1269
157872,7,508,35,2,2,0,0,88,127
131364,6,306,3999,124,78,11,38,6052,10302
61705,6,306,652,3,0,0,1,889,1545
170716,9,570,310,7,9,0,2,461,789
113089,7,508,6,0,0,0,0,11,17
26216,7,508,152,7,3,1,0,272,435
35253,5,78,3,0,0,0,0,5,8
39830,8,214,2307,87,36,6,17,4139,6592
116464,10,820,64,1,0,0,0,92,157
126617,6,404,857,0,0,0,2,1343,2202
66419,4,174,46,0,0,0,0,56,102
114167,4,36,184,6,5,0,1,285,481
112972,4,923,273,7,8,0,1,504,793
95465,7,207,280,14,3,3,1,794,1095
151195,8,214,814,23,10,1,2,1333,2183
13594,4,923,115,5,5,0,1,201,327
152945,7,861,685,5,2,0,2,963,1657
127061,9,630,1,0,0,0,0,0,1
162918,7,535,92,2,2,0,1,137,234
96813,9,630,894,1,1,0,6,2109,3011
127671,9,375,366,7,3,0,2,521,899
25762,4,519,1183,26,14,1,3,2119,3346
60520,4,36,2989,74,41,2,11,5321,8438
128784,4,885,488,1,1,0,2,695,1187
79606,4,658,281,7,7,0,3,520,818
5679,10,653,1824,42,23,1,11,3072,4973
154978,4,36,132,0,0,0,0,331,463
146390,11,545,91,0,0,0,0,116,207
141094,8,214,1612,20,10,2,14,2469,4127
75478,8,658,7,0,0,0,0,6,13
12224,8,403,1311,48,17,1,10,2182,3569
169659,7,535,145,3,3,0,0,232,383
55997,8,214,590,11,4,0,2,1023,1630
39509,7,836,28,5,1,0,0,44,78
108350,5,118,702,28,13,4,1,1170,1918
149711,8,658,2112,69,19,3,7,2932,5142
37381,4,519,447,8,4,1,2,633,1095
170286,7,489,944,15,5,2,1,1431,2398
146065,10,790,597,10,6,2,2,981,1598
108326,5,263,201,2,1,0,2,347,553
79644,9,640,2303,121,77,8,5,3495,6009
35586,5,885,2356,124,41,24,22,3942,6509
99162,4,658,22,0,0,0,0,28,50
162032,8,885,476,0,0,0,0,837,1313
46957,4,174,41,4,1,0,0,36,82
44655,8,214,17,0,0,0,0,22,39
94793,10,790,478,14,3,2,3,830,1330
137789,7,306,78,0,0,0,0,88,166
32405,4,174,29,0,0,0,0,30,59
87603,6,514,295,12,3,0,1,413,724
160209,8,214,4291,102,41,6,31,7750,12221
113962,8,214,2627,71,33,1,21,4499,7252
91922,6,306,5554,39,16,0,22,8532,14163
157604,5,225,19,0,0,0,0,14,33
131726,10,322,3,0,0,0,0,3,6
8821,6,375,544,0,0,0,4,817,1365
32746,10,322,35,0,0,0,0,47,82
91913,9,100,243,0,0,0,0,577,820
16815,4,519,479,5,6,0,2,762,1254
168303,8,214,501,10,6,1,3,753,1274
117667,9,100,90,0,0,0,1,335,426
6241,10,63,178,5,3,0,0,214,400
70654,4,800,1097,36,21,0,6,1799,2959
42197,9,100,1663,44,24,1,8,2589,4329
149698,7,306,1265,27,17,3,14,2115,3441
1561,8,677,567,1,1,0,1,1246,1816
85293,8,403,321,5,1,0,1,444,772
45813,8,677,1020,24,14,1,4,1674,2737
105857,10,111,312,9,4,0,0,441,766
2962,4,658,280,8,6,0,2,512,808
74294,10,111,35,0,0,0,0,72,107
57290,10,111,12,0,0,0,0,36,48
24546,10,722,757,19,9,1,4,1033,1823
82723,5,78,1529,44,29,0,7,2425,4034
75250,7,669,19,0,0,0,0,40,59
23687,9,427,1699,132,72,12,6,3828,5749
72576,9,427,131,1,0,0,0,355,487
57994,5,78,425,16,5,0,2,557,1005
48084,7,535,26,1,0,0,0,37,64
47827,4,800,247,2,3,0,1,380,633
150458,5,78,378,6,4,0,1,493,882
150166,9,469,15,1,0,0,0,18,34
36658,9,630,4468,110,43,7,20,7177,11825
86163,8,623,86,0,0,0,1,144,231
157937,9,630,15,0,0,0,0,22,37
54146,4,159,382,2,2,0,1,643,1030
75958,7,489,331,4,1,0,0,507,843
124604,7,800,29,1,0,0,0,74,104
12740,8,800,382,16,9,0,2,571,980
120975,9,427,110,0,0,0,0,310,420
38759,4,752,194,0,0,0,0,238,432
100031,4,752,125,0,0,0,0,198,323
136939,9,427,39,0,0,0,0,204,243
171174,8,214,38,1,1,0,0,46,86
39218,4,519,297,14,5,0,2,421,739
13107,4,36,191,4,2,0,1,290,488
34314,8,545,4665,192,70,17,38,8657,13639
157530,4,800,146,0,0,0,0,230,376
6303,9,630,486,0,0,0,0,574,1060
31126,8,677,446,9,3,0,3,613,1074
4662,7,587,391,12,8,0,1,535,947
124468,6,561,80,1,3,0,0,91,175
105341,4,885,269,7,3,0,0,415,694
140944,9,657,1688,38,23,8,7,2541,4305
10180,6,78,3929,112,67,5,26,5995,10134
116514,8,403,262,2,0,0,2,401,667
120522,4,800,1351,25,29,0,8,1932,3345
120173,9,630,7,0,0,0,0,7,14
141965,8,812,243,10,6,0,0,387,646
109606,4,200,248,12,6,1,0,464,731
68213,7,489,87,1,0,0,0,114,202
76877,7,489,659,18,17,1,5,1066,1766
109136,6,235,222,7,7,0,2,375,613
136538,8,403,1200,31,9,1,7,1797,3045
3660,9,427,46,0,0,0,0,151,197
104365,7,263,163,2,1,0,1,318,485
148205,9,427,285,0,0,0,2,539,826
63101,7,216,35,0,0,0,0,64,99
92383,5,71,1090,27,20,5,5,1470,2617
82316,4,691,72,0,2,0,0,105,179
148130,5,479,1947,35,19,3,9,3269,5282
77134,7,427,974,34,19,7,10,1516,2560
35337,9,427,144,0,0,0,2,306,452
117367,4,200,92,0,0,0,0,130,222
142436,9,842,512,21,7,3,3,850,1396
110585,6,261,1396,17,7,0,4,2245,3669
72839,4,658,265,10,7,0,0,468,750
103249,6,261,1100,11,7,4,2,1907,3031
130817,9,427,223,0,0,0,0,605,828
108907,4,658,403,8,5,0,2,657,1075
170346,5,71,54,2,0,0,0,109,165
148135,5,200,67,1,2,0,0,74,144
112604,8,812,1084,22,14,1,11,1657,2789
80322,8,623,277,3,3,0,2,353,638
58728,8,800,1024,47,18,3,5,1536,2633
51631,4,519,761,4,3,0,3,1357,2128
75787,5,200,54,2,1,0,1,98,156
157411,9,630,586,4,8,0,3,846,1447
30422,7,489,734,34,15,1,2,1119,1905
15054,4,885,217,1,0,0,2,282,502
142762,8,214,2359,26,23,0,18,3915,6341
154059,8,214,4391,64,37,0,21,6610,11123
73136,8,214,1673,56,25,1,8,2874,4637
6595,5,225,1783,56,21,3,6,2753,4622
119516,4,885,560,14,8,0,1,892,1475
99106,5,427,1635,50,33,2,8,2654,4382
46724,5,200,859,22,12,0,6,1323,2222
26439,8,885,1514,58,28,2,14,2716,4332
47669,5,225,413,7,5,0,1,598,1024
88171,5,225,482,19,9,1,4,768,1283
111500,7,489,507,23,9,0,3,849,1391
50809,4,519,63,0,0,0,0,102,165
77545,4,36,379,4,3,0,1,540,927
71601,5,800,281,3,4,0,1,516,805
3316,5,78,203,3,1,0,3,312,522
126529,5,263,2470,99,55,4,19,4147,6794
145538,5,783,338,5,3,0,1,650,997
148087,4,581,286,7,1,1,2,470,767
134857,10,200,156,1,0,0,0,241,398
23738,7,741,170,6,7,0,1,189,373
160516,4,691,34,0,0,0,0,66,100
48057,7,56,17,0,0,0,0,18,35
75544,4,885,65,4,0,0,0,138,207
117857,9,570,711,0,0,0,5,1076,1792
140667,4,752,2537,43,30,0,10,3837,6457
126321,9,570,103,0,0,0,2,247,352
50086,5,159,613,19,10,2,6,924,1574
14637,9,570,133,0,0,0,2,316,451
116276,4,800,1011,28,15,0,6,1392,2452
145038,4,200,410,2,0,0,1,508,921
44520,7,489,313,5,3,0,1,499,821
43292,4,200,1809,53,22,6,4,2774,4668
151348,9,570,86,0,0,0,0,198,284
112373,6,174,2882,172,66,34,14,4461,7629
23130,4,174,305,6,4,0,3,469,787
151856,5,489,770,40,13,1,2,1141,1967
94963,4,174,990,34,30,1,3,1697,2755
49650,4,200,130,0,0,0,0,205,335
142166,4,800,177,1,1,0,0,254,433
108096,8,545,206,9,6,1,2,299,523
144492,7,741,428,7,7,0,1,772,1215
157544,7,587,317,4,2,1,0,357,681
35870,4,800,531,6,2,0,2,835,1376
103372,6,235,4628,164,68,11,35,7830,12736
140266,7,741,466,15,8,0,2,802,1293
132457,6,800,3149,81,50,6,16,4696,7998
124967,5,200,59,0,0,0,0,82,141
106262,7,741,1811,75,41,13,7,3619,5566
46514,6,200,144,2,2,0,0,212,360
127494,6,235,23,0,0,0,0,27,50
13444,7,741,297,10,5,0,1,541,854
30991,5,159,326,1,2,0,2,450,781
154813,5,159,59,1,1,0,0,85,146
129619,11,489,2,0,0,0,0,2,4
131284,9,570,160,0,0,0,1,259,420
95532,5,159,70,1,1,0,0,90,162
87473,5,159,309,7,4,1,2,523,846
77792,9,374,2014,65,36,17,10,3046,5188
168397,9,367,2832,81,45,6,13,4305,7282
169415,8,214,1110,17,8,0,4,2085,3224
55350,6,489,49,0,0,0,0,65,114
57196,8,812,107,0,0,0,1,190,298
156486,4,658,489,5,3,0,6,911,1414
95533,4,174,580,18,19,0,3,928,1548
146236,4,581,172,0,1,0,1,321,495
137712,9,630,820,20,13,0,12,1169,2034
117344,5,106,54,1,1,0,0,59,115
13868,5,200,184,10,3,0,1,280,478
14223,7,56,60,2,1,0,0,86,149
68153,8,812,96,3,1,0,2,174,276
16127,8,658,2884,120,46,6,21,4817,7894
136992,10,820,135,3,1,0,0,189,328
165391,9,597,4756,182,86,27,18,7134,12203
93505,5,885,364,22,13,2,2,517,920
90338,7,427,5823,239,104,47,27,9271,15511
67920,4,800,740,26,8,1,0,1251,2026
43184,4,800,209,6,3,0,1,350,569
15661,8,427,3883,171,60,21,29,7435,11599
1287,4,885,524,0,0,0,2,822,1348
37670,4,200,253,0,0,0,0,323,576
129663,4,519,216,5,5,0,3,673,902
61258,9,489,539,0,0,0,4,973,1516
167974,4,519,497,3,3,0,3,732,1238
52185,9,306,3031,176,95,22,17,4943,8284
48720,4,174,176,1,1,0,1,284,463
126530,5,570,583,13,10,4,1,777,1388
87202,10,66,179,2,2,0,2,282,467
169736,4,800,168,0,0,0,2,265,435
12958,4,306,4260,106,47,9,31,7018,11471
104209,7,741,8,0,0,0,0,11,19
7762,9,489,584,0,0,0,2,783,1369
84965,5,200,300,20,9,0,3,400,732
22197,5,200,333,7,3,0,1,422,766
162217,5,58,484,21,4,3,2,746,1260
95521,9,489,402,8,6,0,3,630,1049
2222,9,489,298,8,10,0,2,416,734
54923,11,214,23,0,0,0,0,21,44
43316,5,479,647,26,22,11,3,1177,1886
157198,4,453,68,0,0,0,1,120,189
3821,4,752,69,0,0,0,0,130,199
24769,9,489,461,28,9,2,3,733,1236
89087,8,812,426,11,5,0,5,657,1104
96240,8,214,150,0,0,0,1,559,710
83581,4,658,24,0,0,0,0,30,54
116125,4,885,321,1,1,0,0,475,798
56409,4,36,252,1,2,0,0,566,821
21164,5,118,144,2,2,0,0,239,387
146230,6,235,1072,30,5,3,6,1453,2569
24108,10,172,251,4,3,0,1,432,691
66844,9,589,1886,48,29,13,9,2630,4615
34379,7,909,155,2,1,0,1,238,397
109111,5,371,507,10,7,1,4,841,1370
7447,6,235,1437,44,25,1,12,2427,3946
146952,9,607,1263,40,27,7,4,1959,3300
14781,5,118,121,1,1,0,1,187,311
164713,8,214,15,0,0,0,0,32,47
167118,9,630,7416,228,127,15,45,12019,19850
112124,9,693,1846,86,38,7,10,2806,4793
18356,10,752,0,0,0,0,11,3977,3988
128903,4,174,693,17,8,1,0,1219,1938
140904,4,691,74,1,2,0,0,141,218
29426,4,519,294,8,6,0,0,459,767
56211,4,800,1470,45,24,6,10,2350,3905
45311,6,235,447,18,8,0,3,691,1167
139941,7,263,185,6,1,0,2,270,464
160673,7,489,606,12,6,0,1,904,1529
105630,5,371,1255,37,20,2,14,2038,3366
87655,8,30,1716,0,0,0,6,2878,4600
42716,11,214,1482,59,0,0,0,1612,3153
26820,11,214,1420,44,0,1,0,1568,3033
46161,9,107,359,14,8,0,1,550,932
111277,4,800,5017,121,60,13,25,8835,14071
97420,4,800,616,27,17,2,4,975,1641
149600,7,489,81,1,2,0,1,128,213
160202,4,159,17,0,0,0,0,24,41
11223,4,519,111,1,1,0,0,162,275
52961,6,453,77,1,1,0,0,129,208
68124,6,489,2728,49,24,0,15,4374,7190
50229,6,453,148,2,0,1,2,188,341
131,6,453,38,0,0,0,0,47,85
9274,10,519,73,0,0,0,0,111,184
33948,5,821,54,1,2,0,1,72,130
131574,7,175,423,13,9,2,1,612,1060
105911,6,453,22,0,0,0,0,27,49
131360,7,587,45,0,0,0,0,67,112
115237,8,489,229,4,1,0,1,366,601
49338,6,453,75,1,0,0,0,113,189
9767,7,175,101,9,3,1,0,249,363
6997,7,175,210,5,2,0,0,404,621
48462,4,678,1037,33,18,2,7,1715,2812
80584,4,174,1257,38,23,2,9,1925,3254
63981,9,630,227,3,2,0,1,365,598
35316,9,306,978,0,0,0,8,2455,3441
161064,6,453,14,0,0,0,0,24,38
86589,9,306,609,1,1,0,5,1653,2269
35135,4,885,104,0,0,0,0,150,254
136697,6,489,142,2,2,0,2,207,355
8494,9,640,830,18,5,1,7,1074,1935
55792,6,269,5171,188,73,13,37,8010,13492
35525,8,306,452,8,3,0,3,661,1127
121524,5,489,1719,62,39,12,8,2693,4533
169766,6,453,87,4,1,0,1,142,235
116328,8,174,205,2,1,1,1,340,550
127103,8,623,349,4,3,0,1,475,832
74552,6,235,192,1,2,0,0,388,583
85387,4,174,321,5,2,0,1,534,863
126404,9,640,668,14,14,0,7,898,1601
2502,10,256,132,2,2,0,2,177,315
139834,5,78,145,5,2,0,0,219,371
9507,6,489,3503,61,33,3,19,4919,8538
131617,5,78,76,3,3,0,0,107,189
128228,11,214,204,1,0,0,0,242,447
16222,7,885,2989,43,25,4,10,4819,7890
19380,5,78,575,10,4,0,2,823,1414
165157,8,124,1287,35,10,1,9,1854,3196
75733,9,640,757,26,11,1,1,1041,1837
98836,9,640,1365,24,20,2,11,1840,3262
134406,5,78,204,4,3,0,1,317,529
88814,8,214,1116,22,9,0,6,1930,3083
102090,8,214,4363,80,36,2,28,7079,11588
5080,8,214,149,3,2,0,1,273,428
103350,9,640,5687,150,95,9,35,8135,14111
163735,4,159,127,0,0,0,1,196,324
115143,8,489,147,1,1,0,0,265,414
144217,8,214,1745,52,19,1,14,3117,4948
58124,7,144,160,6,3,2,0,326,497
120172,8,30,599,21,7,0,5,1298,1930
80079,6,78,449,5,2,0,1,668,1125
38245,7,556,307,8,1,0,2,413,731
139255,6,453,31,0,0,0,0,41,72
121537,4,453,674,9,3,0,0,1151,1837
66595,4,519,517,18,5,0,1,888,1429
12279,9,306,7426,9,0,0,53,11895,19383
53072,7,100,29,6,0,0,0,49,84
150241,7,861,318,1,0,0,1,443,763
128138,5,479,166,0,0,0,0,248,414
127854,6,124,1205,44,18,0,9,1778,3054
71790,4,453,1540,36,12,0,8,2461,4057
6139,7,660,41,1,0,0,0,60,102
76119,6,135,654,13,7,0,6,1031,1711
17130,7,144,8,0,0,0,0,8,16
54366,5,489,672,18,5,1,6,1133,1835
92353,5,293,317,7,5,3,2,466,800
21570,5,489,43,0,0,0,0,64,107
55892,4,800,173,3,2,0,2,258,438
165387,9,630,2478,55,31,5,19,3194,5782
130449,10,820,52,0,0,0,0,82,134
163809,9,640,2182,89,33,7,14,3126,5451
52571,4,200,378,7,4,0,2,587,978
81135,4,800,804,13,12,0,2,1200,2031
1049,7,861,257,6,5,0,2,407,677
160774,7,861,44,0,0,0,2,66,112
105996,8,800,308,12,4,0,1,747,1072
17666,8,306,575,17,16,0,2,791,1401
131914,8,812,291,13,4,0,0,483,791
91510,8,489,51,0,0,0,1,69,121
158384,6,269,922,15,11,0,6,1334,2288
36322,4,519,1660,25,6,0,11,2190,3892
37377,7,861,24,0,0,0,0,43,67
125496,6,269,370,13,10,0,2,544,939
90337,10,200,797,13,1,1,2,977,1791
99965,6,159,448,7,2,0,1,737,1195
65025,9,487,105,3,1,0,0,159,268
165428,9,487,25,0,1,0,0,42,68
12037,4,752,96,0,0,0,0,129,225
128993,5,655,272,3,2,0,3,398,678
70365,4,800,655,12,6,0,1,947,1621
164013,7,587,726,18,13,3,5,1317,2082
92060,7,861,78,5,4,0,2,131,220
166229,5,355,1030,21,14,2,4,1444,2515
116344,5,78,334,4,0,0,1,476,815
17745,7,484,7,0,0,3,0,6,16
99891,7,484,14,0,0,0,0,13,27
147045,9,306,99,0,0,0,0,251,350
16561,7,587,1424,21,12,2,9,2225,3693
155014,5,78,436,12,5,1,1,639,1094
158598,6,561,154,13,6,3,1,308,485
35630,5,570,131,4,0,0,0,174,309
34724,8,658,2330,95,41,6,12,3572,6056
78537,8,885,245,6,4,0,0,361,616
49193,8,562,217,2,0,0,1,356,576
131995,9,302,31,2,0,0,0,32,65
15404,7,535,1242,19,12,2,5,1716,2996
152856,4,885,529,0,1,0,0,860,1390
96061,9,640,175,1,0,0,0,232,408
101897,4,306,19,0,0,0,0,27,46
89862,8,214,164,6,2,0,2,210,384
159402,8,214,581,13,3,0,2,994,1593
85239,7,484,178,0,1,0,1,290,470
41899,6,269,241,0,0,0,0,428,669
70795,4,725,76,1,0,0,0,111,188
677,8,214,837,31,13,1,4,1382,2268
39589,8,214,250,0,0,0,1,339,590
23800,8,489,57,0,0,0,0,160,217
61627,4,725,32,0,0,0,0,64,96
111493,7,56,15,0,0,0,0,19,34
133873,5,78,5126,143,90,5,35,7742,13141
108267,5,78,853,4,10,0,8,1368,2243
131385,4,885,1050,37,29,0,6,1752,2874
56625,9,607,3421,97,35,21,27,5306,8907
70889,4,375,24,0,1,0,0,30,55
111153,8,124,1035,24,27,0,5,1553,2644
11876,6,159,2067,47,20,3,13,2763,4913
101239,9,842,606,0,0,0,5,1419,2030
83834,9,538,1185,29,18,7,6,1912,3157
112656,8,214,123,0,0,0,0,204,327
61479,9,314,593,12,5,0,2,945,1557
119831,5,124,4807,132,52,2,42,8537,13572
159820,4,675,47,0,0,0,0,88,135
159369,7,587,830,21,19,3,4,1387,2264
131493,8,214,160,4,1,0,2,273,440
150496,8,214,815,21,11,0,6,1500,2353
86965,4,658,111,0,0,0,1,351,463
166179,4,346,360,12,4,1,0,543,920
52516,6,800,979,44,23,3,6,1969,3024
157582,6,269,361,10,5,0,0,569,945
73382,5,479,41,0,0,0,0,49,90
140012,8,214,514,0,0,0,5,965,1484
51712,5,371,99,0,0,0,0,160,259
105166,8,214,3013,24,7,1,9,4589,7643
165842,7,79,69,2,1,0,0,96,168
136218,6,296,3586,110,47,9,12,5670,9434
65624,5,371,142,5,6,1,0,248,402
121033,8,214,5661,111,37,9,41,9552,15411
101779,8,124,931,20,12,0,9,1627,2599
11188,4,923,307,10,7,0,2,600,926
13349,8,214,730,22,11,1,4,1456,2224
58420,9,538,16,0,0,0,0,27,43
24169,5,479,1598,28,20,1,4,2419,4070
106843,7,216,2882,69,29,7,13,5581,8581
130278,8,124,3174,69,35,2,13,5747,9040
124180,8,885,1653,38,17,3,14,2386,4111
153970,4,375,160,3,1,0,0,278,442
16367,8,800,23,0,0,0,0,34,57
24007,4,658,190,7,4,0,0,359,560
154746,4,200,157,2,2,0,0,306,467
56923,9,640,577,0,0,0,1,766,1344
125089,7,587,1237,42,18,4,4,1791,3096
41346,7,713,41,0,0,0,0,72,113
165249,8,214,1723,39,14,1,17,2971,4765
5875,4,200,121,5,2,0,0,173,301
21397,7,216,945,19,12,0,5,2131,3112
120140,7,587,1777,24,17,3,10,3190,5021
148197,8,214,641,21,4,0,6,1187,1859
131655,8,214,1891,38,15,1,13,3278,5236
83320,9,640,1642,62,32,8,7,2369,4120
64185,8,124,607,17,6,0,8,982,1620
16322,10,66,86,0,0,0,0,149,235
19661,11,677,55,0,0,0,0,42,97
94499,5,893,919,30,19,3,1,1561,2533
52560,4,519,318,5,4,0,1,409,737
133678,10,66,32,0,0,0,0,113,145
87034,9,489,720,17,11,1,2,1036,1787
28302,9,842,894,0,0,0,5,2250,3149
51999,7,535,64,1,1,0,0,97,163
75520,9,842,824,0,0,0,3,1771,2598
154012,8,403,1382,51,18,2,7,2081,3541
50935,5,800,1064,61,24,3,11,2026,3189
139565,8,214,1377,20,16,0,10,2762,4185
21389,7,157,423,6,2,0,1,686,1118
102328,8,403,98,1,1,0,0,145,245
96948,7,535,21,0,0,0,0,39,60
79298,8,403,12,0,0,0,0,14,26
142422,4,453,358,7,2,0,1,489,857
102232,9,640,500,21,8,1,3,881,1414
96844,8,124,698,21,7,0,4,1083,1813
74503,8,214,12,0,0,0,0,14,26
46911,8,214,623,8,3,0,1,996,1631
4919,8,214,3202,29,14,0,12,4936,8193
93384,7,216,296,8,5,2,0,479,790
89252,4,200,825,13,8,0,8,1390,2244
2538,5,800,781,42,20,2,4,1445,2294
123425,8,214,74,1,3,0,0,134,212
114279,7,535,31,0,0,0,0,37,68
25218,9,489,2464,90,38,6,13,3708,6319
156431,8,800,72,1,2,0,0,106,181
138106,8,800,170,5,2,1,1,283,462
60084,5,489,175,3,4,0,1,283,466
164169,7,460,6,0,0,0,0,12,18
82799,9,117,113,7,3,1,0,176,300
108058,7,587,1083,24,15,2,12,1839,2975
105555,4,885,1230,25,13,1,3,1974,3246
23530,6,124,134,0,0,0,2,213,349
19001,9,489,6,0,0,0,0,5,11
70123,9,538,595,25,19,3,2,897,1541
112191,9,607,222,3,4,0,2,398,629
170993,9,741,563,38,19,7,4,833,1464
6777,9,607,422,13,7,0,4,572,1018
14964,9,538,305,8,5,0,2,445,765
60216,9,379,61,1,1,0,0,86,149
95964,9,489,51,1,0,0,0,87,139
121493,9,379,73,1,2,0,0,87,163
164235,9,640,912,27,17,0,8,1293,2257
126221,9,489,334,6,4,0,3,525,872
53804,11,403,102,3,0,0,0,110,215
160752,8,427,1839,55,22,2,11,2761,4690
151335,4,800,633,13,5,1,4,895,1551
20570,4,36,843,29,13,1,4,1338,2228
162350,4,36,125,4,2,0,0,177,308
16048,8,375,248,10,6,0,1,374,639
55562,8,214,1669,31,12,4,6,2619,4341
24681,4,453,478,12,9,0,1,758,1258
129420,7,587,1026,25,19,1,5,1710,2786
65187,6,261,869,15,9,1,5,1539,2438
170263,4,453,1168,8,3,0,1,1839,3019
171001,4,800,560,14,9,1,4,866,1454
56040,4,453,14,0,0,0,0,10,24
29891,8,885,154,7,3,1,0,249,414
38019,7,427,3430,103,38,27,7,5600,9205
69816,4,200,61,1,0,0,1,95,158
14409,10,653,96,3,1,0,1,123,224
66331,8,427,1723,49,26,1,22,2714,4535
124068,5,693,1210,54,37,0,8,1973,3282
138403,10,653,66,0,0,0,0,93,159
24209,6,489,1795,69,15,3,19,3057,4958
51829,11,214,6,0,0,0,0,6,12
26550,4,453,62,0,0,0,0,95,157
95870,7,521,1147,42,14,9,8,1655,2875
101857,4,174,114,5,3,0,0,173,295
153234,8,885,948,26,11,2,4,1539,2530
10960,9,306,1324,0,0,0,14,2988,4326
138954,8,623,1,0,0,0,0,1,2
167453,6,306,364,2,3,0,4,562,935
105761,8,306,1072,25,10,1,6,1810,2924
144444,4,200,31,1,0,0,0,43,75
60122,5,821,102,0,0,0,0,137,239
52196,4,923,69,2,2,0,0,118,191
112752,4,658,355,3,1,1,4,800,1164
134452,6,117,702,25,14,5,6,1084,1836
150332,8,214,1331,56,24,0,14,2295,3720
121741,8,214,330,0,0,0,1,511,842
102639,9,100,320,5,2,2,3,556,888
58014,4,923,67,5,3,0,0,99,174
49409,4,519,332,0,0,0,2,447,781
14491,8,812,128,3,2,1,0,288,422
7397,8,427,417,15,7,0,4,809,1252
131704,10,550,194,3,2,0,0,298,497
140610,8,214,93,2,2,0,1,131,229
68440,5,800,522,23,12,1,8,1225,1791
154748,5,58,1433,64,34,13,8,2185,3737
29748,6,78,609,6,1,1,4,858,1479
5007,6,375,6373,157,70,8,33,9876,16517
111001,7,587,46,3,0,0,0,62,111
32657,7,587,393,8,2,0,2,537,942
153430,9,538,2324,54,26,2,10,3479,5895
128090,4,159,149,0,0,0,1,255,405
117481,8,214,237,0,0,0,0,329,566
109236,9,538,14,0,0,0,0,24,38
1456,6,306,441,3,3,0,1,757,1205
16712,7,521,53,4,0,0,0,75,132
1676,8,623,548,24,9,0,4,867,1452
163487,9,538,137,5,0,0,0,231,373
40042,9,538,31,1,0,0,0,49,81
87186,4,200,782,21,6,1,1,1176,1987
26955,6,306,295,1,1,0,1,454,752
169073,4,658,585,17,8,1,4,1027,1642
46532,4,36,50,0,0,0,0,95,145
150596,7,157,1236,29,19,3,10,2273,3570
168576,4,159,362,7,3,0,1,614,987
61710,7,460,1,0,0,0,0,4,5
162037,4,800,1173,25,16,1,7,1758,2980
47929,10,474,908,22,9,1,8,1534,2482
135569,4,200,214,4,3,0,1,399,621
78607,4,306,869,24,11,1,4,1385,2294
127202,10,474,309,8,4,0,1,625,947
147335,8,489,148,0,0,0,0,187,335
95751,7,741,8,0,0,0,0,6,14
122740,10,722,97,1,1,0,1,150,250
105439,4,174,127,0,0,0,0,170,297
16199,4,174,88,0,0,0,0,161,249
131528,7,741,106,0,1,0,2,185,294
90727,4,200,45,0,0,0,0,67,112
21320,5,200,17,0,0,0,0,25,42
168152,10,831,1132,17,6,1,4,1887,3047
114741,9,100,2970,178,74,26,8,4597,7853
38681,10,917,509,13,6,0,1,828,1357
79146,5,200,521,8,7,0,4,840,1380
152366,5,78,400,7,6,0,2,576,991
68335,6,165,539,12,9,1,1,931,1493
106675,5,821,28,0,0,0,0,46,74
77018,7,492,38,0,1,0,0,62,101
79888,5,306,1799,28,34,2,13,2723,4599
50142,6,489,1891,56,32,8,6,2622,4615
31730,9,374,668,22,13,2,6,1053,1764
81279,9,630,60,2,0,0,0,63,125
78752,7,521,89,0,0,0,0,107,196
32205,5,783,190,7,3,0,1,316,517
41064,10,653,23,1,0,0,1,31,56
122499,5,371,134,2,0,1,0,171,308
141824,7,489,765,16,13,3,5,1331,2133
28025,11,658,67,1,0,0,0,70,138
142117,8,214,18,0,0,0,0,31,49
132102,7,306,20,0,0,0,0,25,45
26540,4,800,356,13,8,0,2,558,937
140541,9,462,259,10,3,2,1,442,717
41345,9,325,280,8,2,1,0,391,682
134150,7,693,379,12,7,1,1,933,1333
79940,10,653,433,3,1,0,1,657,1095
22360,5,371,2116,76,40,6,11,3296,5545
1248,4,800,237,9,3,0,2,380,631
90637,7,194,14,0,0,0,0,23,37
27311,8,214,386,4,1,0,1,583,975
77447,8,244,547,14,8,0,3,1063,1635
137929,4,159,2119,38,13,1,9,3477,5657
166551,5,427,326,10,4,2,1,537,880
108459,9,842,86,2,2,0,0,118,208
71525,5,355,1418,23,10,2,3,2003,3459
9745,8,214,547,5,1,0,6,845,1404
59281,7,194,24,1,0,0,0,56,81
165076,4,159,1340,25,12,1,8,2271,3657
6565,7,516,202,3,1,0,0,293,499
92131,8,214,499,1,1,0,0,762,1263
19936,4,174,145,0,0,0,1,215,361
91593,9,538,42,0,0,1,0,58,101
65040,9,741,2261,105,67,9,19,3488,5949
22318,4,36,869,28,28,1,1,1592,2519
57904,4,159,13,0,0,0,0,30,43
108034,8,623,459,7,1,1,1,575,1044
95496,8,214,216,1,1,0,1,322,541
93251,4,658,57,0,0,0,0,93,150
53047,9,489,302,9,3,2,4,550,870
93884,7,144,136,3,3,0,1,372,515
32323,5,371,139,6,5,0,0,223,373
44417,5,404,19,0,0,0,0,47,66
71657,8,214,574,10,6,0,4,911,1505
79589,4,375,10,0,0,0,0,11,21
33619,4,519,169,7,4,0,1,416,597
96067,5,371,20,0,0,0,0,19,39
129433,8,489,3509,59,21,3,12,4700,8304
122817,5,371,186,7,4,2,1,339,539
60980,9,630,3159,94,47,4,19,4528,7851
13339,7,521,59,1,1,0,1,76,138
92343,6,489,562,6,5,0,3,976,1552
135147,6,235,1409,82,52,9,7,2368,3927
140782,10,111,2,0,0,0,0,3,5
66870,7,489,91,4,2,0,0,137,234
107079,5,371,154,3,0,1,1,225,384
132625,10,66,1079,22,10,0,4,1689,2804
95927,8,214,386,0,0,0,0,600,986
138913,7,489,101,3,2,0,0,142,248
62064,9,30,190,4,4,0,0,248,446
92235,7,489,682,15,8,1,2,1109,1817
77375,5,118,90,2,1,1,0,145,239
122606,4,453,509,4,0,0,0,618,1131
132826,6,827,745,41,11,5,6,1219,2027
20847,8,489,477,3,2,0,4,1072,1558
107611,5,893,10,0,1,0,0,11,22
37235,11,30,44,2,0,0,0,49,95
154554,4,890,753,4,2,0,1,938,1698
90435,8,623,248,6,2,0,0,373,629
2143,5,570,2233,83,39,10,13,3396,5774
130158,6,235,331,12,5,0,1,565,914
42842,7,484,16,0,0,0,0,7,23
129287,8,623,297,3,1,0,2,370,673
4612,9,78,299,6,3,0,1,471,780
90042,7,484,554,8,6,0,4,890,1462
51817,4,200,153,2,2,0,1,199,357
160380,5,174,228,7,4,0,0,385,624
106874,7,741,337,1,0,0,0,455,793
124458,8,623,133,2,1,0,1,185,322
167208,4,519,321,5,3,0,1,462,792
158706,5,408,343,8,4,1,2,527,885
121274,5,800,738,49,22,3,10,1509,2331
47076,6,489,664,10,4,0,5,1281,1964
144812,7,645,66,1,3,0,0,76,146
91846,5,355,592,16,7,1,1,864,1481
121980,9,813,274,2,1,0,0,675,952
141589,4,658,782,24,13,0,10,1608,2437
147542,4,800,211,1,1,0,0,323,536
88608,7,648,244,11,13,1,1,303,573
8691,5,218,356,4,2,0,1,543,906
26580,8,214,808,3,1,0,1,1218,2031
52012,9,302,203,1,0,1,0,309,514
157426,8,812,1437,44,22,0,7,2153,3663
15806,8,214,989,2,8,0,6,1651,2656
124804,7,527,470,24,16,1,0,629,1140
61070,8,885,565,19,14,0,4,882,1484
76180,5,218,171,2,1,0,0,230,404
9364,8,214,339,1,1,0,0,498,839
127897,8,174,711,9,1,1,2,1004,1728
1360,8,214,158,0,0,0,0,247,405
91763,5,447,399,5,2,0,0,574,980
80130,7,741,2336,74,25,26,6,3850,6317
43421,8,800,191,6,2,0,1,263,463
43622,8,214,83,3,3,0,0,139,228
53232,8,214,94,1,1,0,1,163,260
97767,8,214,84,0,0,0,0,125,209
132573,8,489,463,6,1,1,3,798,1272
47028,10,36,73,0,0,0,4,1604,1681
152215,4,159,230,1,1,0,0,369,601
159540,5,66,119,2,2,0,0,187,310
120587,7,157,4,0,0,0,0,5,9
137411,8,214,2479,0,0,0,13,3454,5946
60150,6,235,43,0,0,0,0,70,113
92394,8,306,4891,53,24,3,24,9257,14252
98078,6,78,171,3,4,0,1,228,407
75891,4,519,378,10,7,0,0,626,1021
136792,5,570,709,18,14,0,5,1055,1801
71786,4,159,116,4,1,0,0,213,334
163677,8,214,53,0,0,0,0,100,153
29641,4,159,882,7,3,0,9,1378,2279
46423,7,842,540,26,18,1,5,1057,1647
141257,8,812,748,20,4,0,4,1155,1931
11157,6,200,94,2,1,0,0,147,244
156072,9,741,1535,118,59,13,6,2440,4171
69504,9,640,976,31,15,2,2,1504,2530
152028,6,427,883,24,19,3,5,1359,2293
128404,9,741,464,33,17,0,4,719,1237
125522,8,812,688,16,14,1,4,1158,1881
149116,9,306,991,78,41,4,3,1638,2755
169302,4,800,328,3,2,0,3,573,909
34018,8,812,484,10,6,0,6,792,1298
108382,7,570,1507,42,22,6,13,2440,4030
14311,7,521,102,2,2,0,1,164,271
93088,7,521,97,1,1,0,0,148,247
2010,6,404,644,0,0,0,4,985,1633
135486,6,200,34,0,0,0,0,59,93
15135,10,36,74,1,0,0,1,126,202
84075,4,800,1088,31,10,1,10,1732,2872
132921,4,519,644,14,12,1,3,952,1626
126509,8,489,557,21,4,2,3,876,1463
8792,4,800,192,4,4,0,1,359,560
37454,4,890,688,7,6,0,5,1048,1754
34304,8,489,89,1,0,0,0,151,241
147848,7,535,581,15,4,0,1,996,1597
66638,6,693,2798,90,53,17,12,4244,7214
67755,8,623,1801,47,13,4,14,2842,4721
63315,9,842,1434,46,24,0,8,3236,4748
44781,4,658,415,6,2,3,1,770,1197
10942,7,24,146,3,1,0,2,201,353
170782,7,535,115,1,2,0,3,254,375
56513,6,489,813,9,8,0,4,1240,2074
99930,10,36,73,2,0,0,2,105,182
132562,8,545,867,14,5,0,6,1453,2345
13538,8,214,243,0,0,0,0,361,604
77488,8,214,1493,10,10,0,8,2432,3953
54454,8,214,177,0,0,0,1,270,448
167719,8,214,709,2,2,0,0,850,1563
110494,10,63,87,1,0,0,3,170,261
106989,6,585,658,19,10,1,3,1157,1848
62903,8,214,503,5,5,0,1,719,1233
161866,8,214,299,0,0,0,0,415,714
106214,8,214,448,1,0,0,5,683,1137
33037,8,214,63,0,0,0,0,76,139
90231,7,527,23,0,0,0,0,21,44
51357,4,200,400,3,1,0,2,538,944
153653,8,214,417,0,0,0,1,589,1007
92660,8,214,96,0,0,0,0,116,212
48968,7,489,29,0,0,0,0,36,65
1426,8,214,313,4,2,0,2,436,757
141808,8,214,347,3,1,0,1,541,893
78545,7,489,242,2,0,1,0,362,607
29067,9,469,214,4,2,0,4,367,591
61619,9,489,626,29,11,1,3,1028,1698
91744,7,306,19,0,0,0,0,21,40
49916,4,174,44,8,3,0,1,60,116
81790,7,489,65,0,0,0,0,102,167
66222,10,917,22,0,0,0,1,59,82
112277,7,535,39,2,1,0,0,85,127
44283,5,489,365,0,0,0,0,491,856
107479,4,678,126,2,2,0,1,181,312
116502,5,58,926,31,24,3,2,1503,2489
2171,4,519,218,3,2,0,1,408,632
106414,5,118,280,11,7,3,1,449,751
61592,8,214,1244,15,7,0,11,2072,3349
150228,7,194,4,0,0,0,0,10,14
28448,7,542,18,0,0,0,0,21,39
132290,8,812,1432,42,17,4,10,2243,3748
40326,8,812,957,27,13,1,4,1435,2437
92850,11,545,416,13,0,0,0,457,886
114743,8,214,85,1,0,0,0,86,172
110467,4,174,375,20,8,0,4,732,1139
85601,7,527,452,17,13,3,0,513,998
138397,10,653,99,1,2,0,0,151,253
44198,7,489,295,8,3,0,2,506,814
54505,4,174,20,0,0,0,0,34,54
105244,8,214,826,20,13,0,8,1424,2291
148659,4,519,162,1,1,0,0,270,434
103067,9,640,608,24,14,0,9,916,1571
107921,4,36,474,14,9,0,3,890,1390
92844,7,836,140,9,1,2,1,202,355
139174,9,640,585,17,9,3,10,854,1478
50633,6,117,235,2,3,0,3,393,636
81558,4,800,1685,42,17,2,11,2386,4143
12504,8,677,1725,65,32,4,11,2678,4515
112513,8,812,1184,33,12,3,13,1633,2878
138354,4,885,95,2,0,0,1,139,237
132818,8,800,92,2,0,0,0,149,243
100691,6,269,42,0,0,0,0,63,105
69798,4,427,19,1,2,0,0,45,67
61767,6,269,36,0,0,0,0,66,102
147733,4,36,145,2,1,0,1,254,403
147615,7,648,83,1,0,6,0,125,215
96207,7,648,68,1,0,6,0,91,166
152192,4,800,75,1,2,0,0,129,207
138318,9,693,432,6,8,0,5,679,1130
133371,8,214,406,0,2,0,1,929,1338
148385,7,226,300,1,0,1,1,427,730
11017,4,36,1273,45,41,2,5,2348,3714
140116,4,453,786,7,4,1,3,1111,1912
140216,4,519,41,0,0,0,0,82,123
170450,9,800,70,1,1,0,2,78,152
53144,4,890,890,18,13,2,1,1265,2189
22341,8,214,697,15,6,0,3,920,1641
87462,4,159,209,4,2,0,1,362,578
933,8,885,1672,49,20,0,16,2725,4482
50393,4,890,82,1,1,0,2,163,249
110133,5,71,493,11,7,0,1,801,1313
73842,8,800,1276,73,19,4,6,2124,3502
100809,7,484,109,2,1,0,1,169,282
102359,7,429,60,5,1,0,0,157,223
52831,5,655,693,23,12,1,2,1061,1792
114113,8,885,1329,19,7,0,3,2151,3509
30314,4,174,19,0,0,0,0,33,52
50089,4,174,68,0,0,0,0,91,159
30195,8,596,1291,35,19,0,15,2346,3706
121559,10,618,417,3,3,0,5,1631,2059
68924,9,640,340,12,9,1,4,526,892
168092,4,174,8,1,0,0,0,23,32
165516,8,623,1777,35,12,3,9,2569,4405
112804,7,648,306,7,2,1,1,502,819
53896,6,306,1249,11,5,0,12,1971,3248
69357,6,165,1400,65,24,13,10,2308,3820
129620,7,800,132,2,2,0,1,148,285
26857,7,800,72,2,1,0,0,128,203
137830,7,800,15,0,0,0,0,29,44
169733,5,159,280,10,3,0,1,446,740
92011,6,124,38,3,1,0,1,50,93
112787,6,124,448,17,10,0,3,712,1190
81256,5,78,2937,85,39,5,15,4210,7291
15150,6,124,492,9,4,0,6,711,1222
168433,5,209,232,7,4,0,0,326,569
156561,4,159,165,4,2,0,0,298,469
32998,8,214,118,0,0,0,0,140,258
155692,6,306,2378,81,46,7,15,3822,6349
126768,9,427,435,0,0,0,5,751,1191
62905,4,923,40,1,1,0,0,98,140
86478,4,752,355,1,0,0,1,503,860
44066,6,827,76,1,1,0,0,93,171
94672,7,489,320,11,5,1,3,522,862
107539,11,489,207,11,0,0,0,237,455
107641,8,306,80,0,0,0,0,123,203
167282,6,200,108,0,0,0,0,115,223
126419,6,200,60,3,0,0,0,69,132
157376,8,489,5,0,0,0,0,10,15
91946,9,117,49,0,0,0,0,87,136
133323,4,800,7,0,0,0,0,10,17
28859,9,380,2,0,0,0,0,6,8
33380,4,678,65,0,1,0,0,87,153
31039,9,640,71,2,2,0,1,83,159
117303,10,18,6,0,0,0,0,9,15
26918,10,917,2,0,0,0,0,3,5
134099,7,56,558,11,6,2,1,786,1364
16443,9,800,141,8,6,0,2,220,377
170885,4,375,29,0,0,0,0,42,71
160523,6,901,552,24,3,3,2,835,1419
122227,4,375,16,3,0,0,0,24,43
164746,6,827,91,2,1,1,0,174,269
150984,9,117,3,0,0,0,0,4,7
121179,4,375,45,0,0,0,1,69,115
121974,10,898,26,1,0,1,0,48,76
97702,4,519,504,8,1,1,2,790,1306
23063,9,640,1711,44,18,1,10,2275,4059
111433,8,214,22,0,0,0,0,35,57
169967,4,800,9,0,0,0,0,12,21
66361,9,640,912,40,11,1,4,1821,2789
37612,9,538,8,0,0,0,0,15,23
84936,4,800,786,41,27,0,5,1197,2056
138676,9,640,1931,52,40,3,17,2622,4665
154918,7,302,20,0,0,0,0,30,50
51340,9,78,167,0,0,0,0,247,414
29639,4,375,127,0,0,0,1,177,305
29903,7,800,635,15,9,2,3,970,1634
32516,4,159,71,0,0,0,0,112,183
146780,5,885,100,0,0,0,1,169,270
62621,9,145,41,5,2,0,0,127,175
161388,9,78,316,0,0,0,4,614,934
121204,9,78,2666,98,46,14,11,4032,6867
108901,10,752,16,0,0,0,0,27,43
21686,10,752,4,0,0,0,0,12,16
77367,4,596,431,1,1,0,1,704,1138
106564,7,429,3733,96,49,17,21,6018,9934
137099,4,596,25,0,0,0,0,34,59
10818,4,375,37,0,0,0,0,51,88
5561,10,66,14,0,0,0,0,30,44
146837,4,200,440,7,6,0,0,707,1160
91111,4,174,73,1,0,0,0,92,166
17298,9,489,275,10,4,1,4,522,816
42637,4,453,8,0,0,0,0,9,17
161068,10,66,3,0,0,0,0,1,4
46242,10,66,70,0,0,0,0,93,163
4763,6,200,139,1,0,0,1,180,321
61581,8,214,3015,44,18,4,25,4900,8006
47137,6,58,74,4,3,0,0,93,174
142805,10,172,164,4,3,0,2,256,429
152545,9,741,1366,52,30,5,7,1971,3431
21791,7,589,556,17,12,5,5,1051,1646
65136,7,587,315,2,2,0,0,402,721
63979,7,587,127,3,3,1,1,195,330
95890,8,812,474,20,6,1,0,729,1230
146341,7,306,620,19,6,0,3,1231,1879
97135,8,489,73,1,1,0,1,99,175
95852,8,489,2,0,0,0,0,1,3
93652,8,812,2029,24,14,1,9,2936,5013
55446,7,587,54,1,0,0,0,51,106
95830,7,587,44,2,2,0,0,84,132
62566,9,640,1158,29,15,2,8,1579,2791
52921,7,601,529,13,3,4,2,850,1401
55052,9,800,69,1,1,0,0,87,158
155343,6,261,476,11,3,0,2,1026,1518
28096,8,489,147,0,0,0,0,414,561
69672,8,812,855,24,12,1,7,1489,2388
57286,7,207,17,0,0,0,0,40,57
801,7,30,898,20,7,2,2,1462,2391
108093,9,538,50,0,0,0,0,58,108
26996,7,587,385,4,3,0,3,557,952
18024,8,214,1289,37,11,4,13,2027,3381
69416,8,489,1277,14,8,1,7,1959,3266
110608,4,519,426,12,5,1,2,606,1052
149601,7,30,151,9,3,1,1,345,510
98179,9,741,196,0,0,0,0,361,557
126694,7,30,58,4,1,1,0,182,246
124460,7,30,114,2,0,1,0,316,433
166112,7,30,565,11,4,2,1,771,1354
49828,4,36,235,7,4,0,2,380,628
84206,8,812,551,3,3,0,4,835,1396
161561,7,207,553,13,11,1,1,908,1487
69292,7,587,26,0,0,0,0,34,60
20647,5,427,781,42,27,6,7,1610,2473
146731,5,561,466,0,0,0,0,711,1177
15327,5,200,2434,94,37,9,17,3662,6253
69885,8,766,153,4,4,0,1,265,427
94785,6,124,348,7,3,0,7,525,890
155233,8,717,395,13,2,1,1,574,986
143324,8,812,198,0,0,0,0,257,455
102098,8,214,2249,52,19,1,14,4113,6448
1867,4,800,151,0,1,0,1,238,391
72420,7,118,510,9,7,0,2,832,1360
57596,6,200,47,1,0,0,0,72,120
64822,9,741,94,0,0,0,0,165,259
145546,9,842,1516,48,23,4,6,2327,3924
96408,9,374,83,2,2,0,0,164,251
34782,8,677,839,12,5,1,5,1416,2278
65712,4,581,301,0,0,0,0,456,757
21284,9,741,428,2,1,0,4,835,1270
74278,9,741,210,0,0,0,2,433,645
50121,8,693,850,33,28,0,3,1369,2283
3630,9,374,51,3,2,0,1,98,155
132809,9,741,525,0,0,0,3,959,1487
111928,9,374,6,0,0,0,0,17,23
70008,9,374,1,0,0,0,0,7,8
44775,8,214,1146,37,20,0,6,2153,3362
163056,5,371,94,2,2,3,1,130,232
140121,8,214,1963,69,23,6,13,3475,5549
22692,6,453,100,1,2,0,0,175,278
148974,7,587,364,4,2,1,3,602,976
167527,7,175,67,4,3,0,0,253,327
170864,6,165,2120,74,49,13,12,3071,5339
32186,5,140,61,0,2,0,0,124,187
127528,9,489,1176,1,1,0,8,2563,3749
69870,6,269,74,1,1,1,0,128,205
30903,6,269,80,0,0,0,1,139,220
92093,10,797,567,17,10,1,4,869,1468
15419,7,741,116,1,4,0,0,189,310
65210,7,587,4051,122,59,20,29,7660,11941
39881,5,4,1864,99,36,10,5,2932,4946
106713,6,269,49,0,0,0,0,49,98
115730,4,638,213,5,3,0,0,388,609
89351,5,355,354,13,4,0,2,548,921
127142,5,232,79,3,2,0,0,124,208
92655,6,263,135,2,2,0,0,195,334
138630,10,653,59,0,0,0,1,163,223
39976,4,923,320,10,3,0,2,590,925
10179,8,812,1115,30,13,0,5,1701,2864
149,9,79,17,0,0,0,0,27,44
18427,8,214,114,0,0,0,2,170,286
168216,6,269,213,3,3,0,0,313,532
137752,4,752,1089,21,10,0,7,1809,2936
57754,4,375,78,0,1,0,1,125,205
25874,6,263,794,13,6,1,4,1276,2094
77811,9,657,16,0,0,0,0,39,55
170645,9,367,52,1,0,0,0,104,157
54470,6,800,476,12,6,0,2,1152,1648
15926,6,106,126,6,3,1,0,257,393
82962,4,658,418,7,6,1,4,696,1132
129001,8,214,3386,80,27,9,19,5798,9319
55359,6,263,1108,30,22,1,10,1667,2838
134785,9,100,26,0,0,0,0,39,65
171162,5,4,44,2,1,0,0,65,112
789,7,56,568,44,18,9,7,810,1456
14134,5,4,24,0,0,0,0,28,52
162313,5,159,209,17,6,0,2,399,633
166565,6,263,313,5,3,0,1,462,784
135893,4,752,65,1,1,0,1,242,310
44627,4,581,351,0,1,0,1,636,989
165072,9,489,2501,15,2,0,18,4495,7031
153289,5,885,1253,47,23,2,5,1882,3212
68,9,489,167,0,0,0,0,802,969
57861,7,489,464,8,6,0,2,698,1178
943,8,489,2636,33,15,0,13,4087,6784
82562,9,657,10,0,0,0,0,16,26
30886,8,427,340,12,9,1,2,573,937
46199,9,657,4,0,0,0,0,5,9
74527,6,789,371,8,4,0,2,704,1089
166473,6,693,477,8,12,0,4,714,1215
156470,8,812,126,3,2,0,0,191,322
37211,11,489,914,38,0,0,0,1079,2031
35079,8,812,441,15,6,1,2,770,1235
13164,4,581,152,3,4,0,0,226,385
87310,8,812,2615,71,30,1,17,3863,6597
72463,7,693,846,49,24,5,6,2103,3033
90617,4,752,48,0,0,0,0,77,125
142922,11,489,214,8,0,0,0,229,451
39636,9,158,11,0,0,0,0,58,69
102422,9,306,1924,0,0,0,13,3837,5774
30516,9,684,1,0,0,0,0,1,2
127704,5,655,196,12,5,0,1,347,561
25242,8,200,145,9,6,0,0,637,797
24801,9,158,1535,15,8,3,6,1624,3191
32015,8,200,850,6,1,0,1,1537,2395
58701,9,607,201,3,2,0,1,214,421
16523,5,800,539,23,17,1,2,1190,1772
99814,7,587,430,15,3,1,1,561,1011
135886,8,200,100,3,1,0,0,327,431
158999,10,104,60,0,0,0,0,87,147
17732,9,640,406,5,3,0,1,450,865
157188,9,842,42,0,0,0,0,90,132
44513,7,306,1597,13,10,1,2,2836,4459
49476,5,561,445,9,7,0,3,788,1252
51207,7,448,304,22,10,1,2,1327,1666
121366,8,812,861,19,8,0,5,1525,2418
36741,7,56,42,0,0,0,1,55,98
106109,4,375,423,1,3,0,0,645,1072
65906,4,658,5,0,0,0,0,10,15
133903,5,58,74,5,0,0,0,129,208
23111,7,163,60,1,1,1,1,142,206
78016,4,581,758,25,19,1,2,1325,2130
77296,8,214,1500,11,5,1,8,2664,4189
8556,9,175,283,13,7,2,0,396,701
132282,5,800,152,4,3,0,0,263,422
2947,10,104,6,0,0,0,1,127,134
113330,9,630,858,44,31,2,2,1429,2366
87431,4,174,23,0,0,0,1,29,53
36345,7,427,489,22,14,2,5,954,1486
124935,7,56,8,0,0,0,0,17,25
54480,4,923,94,1,2,0,0,192,289
100553,6,232,365,13,6,1,2,514,901
85049,8,655,908,13,9,0,2,1475,2407
62980,5,306,244,0,0,0,0,402,646
99333,7,56,63,0,0,1,0,86,150
92550,7,484,391,11,2,1,1,561,967
88523,4,270,1,0,0,0,0,1,2
92171,10,111,9,0,0,0,0,20,29
162031,7,713,492,4,3,0,2,753,1254
164609,8,214,2924,98,29,2,18,4372,7443
34255,7,56,102,3,1,0,0,135,241
30505,7,648,24,0,1,0,0,91,116
48467,5,200,947,21,15,0,7,1417,2407
41084,5,306,3186,92,52,4,23,4961,8318
113634,9,589,399,0,0,0,1,594,994
21446,9,589,96,0,0,0,0,210,306
71010,4,36,95,0,0,0,0,149,244
113565,4,800,242,0,1,0,2,319,564
142664,6,693,654,14,9,1,7,1075,1760
143682,9,640,625,13,8,0,3,911,1560
52966,10,200,1,0,0,0,0,0,1
143764,8,124,2394,80,30,2,18,4278,6802
53073,7,163,63,2,1,0,1,76,143
276,8,306,6043,111,54,6,20,10469,16703
141541,4,36,325,0,0,0,1,398,724
107096,7,74,243,9,3,1,1,367,624
19819,5,479,429,8,5,0,4,682,1128
161876,5,479,40,0,0,0,0,46,86
79557,8,562,498,9,3,0,3,740,1253
31838,7,578,63,1,1,0,0,86,151
149554,7,56,652,16,11,6,2,855,1542
156696,5,118,3003,92,50,17,22,3960,7144
119538,9,367,461,25,12,0,0,665,1163
74404,6,427,932,24,20,0,4,1700,2680
100695,4,658,524,12,5,0,4,810,1355
90124,5,699,107,11,2,2,1,178,301
135215,9,374,3,0,0,0,0,3,6
167008,7,527,107,13,11,0,0,214,345
50304,8,623,571,3,0,0,0,767,1341
84143,6,159,472,7,6,0,3,804,1292
92700,8,214,6,0,0,0,0,8,14
105922,8,623,341,1,2,0,1,532,877
153824,4,200,1526,8,4,0,12,2311,3861
161509,8,801,26,1,0,0,0,50,77
164550,7,163,19,1,0,0,0,28,48
100674,4,306,992,11,8,1,5,2489,3506
15024,4,36,139,5,4,0,0,211,359
61804,9,462,206,4,2,1,1,315,529
17799,4,885,1651,28,19,1,9,2844,4552
24170,9,462,16,0,0,0,0,47,63
94461,9,78,3269,92,48,4,15,4919,8347
160350,4,519,346,4,4,1,2,505,862
91187,4,306,2,0,0,0,0,6,8
40302,9,483,123,1,1,0,0,174,299
161643,7,157,1071,38,20,3,11,2167,3310
109767,11,545,181,24,0,0,0,202,407
59378,8,214,1330,0,0,0,4,1839,3173
5812,4,300,405,10,4,1,1,772,1193
11978,4,675,1471,45,22,6,10,2452,4006
18279,7,157,2472,93,48,16,15,4090,6734
84193,9,78,161,0,0,0,1,230,392
80236,4,200,380,5,5,0,1,622,1013
58467,9,157,529,33,19,1,1,989,1572
114270,7,496,50,2,1,0,1,75,129
96485,10,474,102,1,0,1,0,177,281
117559,7,496,224,9,0,3,0,515,751
60357,9,589,103,0,2,0,0,205,310
49037,9,640,384,11,7,1,0,586,989
153754,4,36,381,6,4,0,2,618,1011
7502,6,447,1600,17,16,0,2,2273,3908
157341,7,496,1346,17,14,0,3,2196,3576
17606,7,496,80,1,1,1,0,255,338
66789,8,489,731,16,6,0,4,1179,1936
14544,8,658,194,1,0,0,1,335,531
41777,7,367,620,30,18,2,3,1226,1899
162239,9,374,21,0,0,0,1,26,48
80560,7,367,366,6,4,2,1,763,1142
146920,4,800,225,3,2,0,0,342,572
160204,4,159,1115,18,12,1,9,1634,2789
44863,9,607,918,46,15,2,9,1284,2274
19433,6,269,1468,38,14,4,7,2385,3916
3439,7,496,371,7,10,1,2,615,1006
136613,4,36,273,10,5,0,2,576,866
3668,7,861,18,0,1,0,0,62,81
63171,9,42,226,2,3,0,2,296,529
39229,7,496,1224,13,14,1,3,2261,3516
95694,6,124,16,0,0,0,0,16,32
82913,8,489,1347,12,8,0,8,2068,3443
110398,9,42,11,0,0,0,0,15,26
164499,4,638,184,3,2,0,1,287,477
131195,6,453,40,0,0,0,2,68,110
109746,9,42,5,0,0,0,0,15,20
9918,8,214,82,0,0,0,1,133,216
99122,7,570,2238,80,28,9,15,3364,5734
55460,9,570,281,0,0,0,0,490,771
117052,4,638,470,6,4,0,3,682,1165
45417,5,655,893,26,15,1,7,1459,2401
126778,5,106,677,18,10,2,1,1004,1712
153809,10,200,136,2,1,0,1,323,463
118030,10,820,12,1,1,0,0,48,62
131060,5,489,674,10,8,1,3,1139,1835
45857,4,300,304,8,6,1,2,595,916
11692,6,124,235,5,5,0,2,381,628
163360,9,630,3289,97,47,10,22,4779,8244
73992,4,885,304,11,8,1,5,522,851
118673,7,861,68,0,0,0,0,72,140
62003,4,638,106,3,2,0,1,144,256
118895,5,479,2746,84,44,9,11,4357,7251
19422,7,484,345,4,4,0,0,533,886
59068,8,214,717,0,0,0,0,1086,1803
68776,5,306,481,9,3,0,2,799,1294
94467,5,489,387,18,2,0,2,731,1140
40737,4,36,493,4,3,0,1,866,1367
37681,4,174,181,5,1,0,1,323,511
126725,4,174,291,1,1,0,0,501,794
55379,7,861,248,5,4,0,3,456,716
30635,7,861,702,11,3,1,1,1222,1940
49225,7,175,42,3,3,0,0,115,163
161081,7,587,3112,45,26,9,14,4973,8179
139600,4,923,55,1,2,0,0,89,147
21428,9,489,585,0,0,0,0,1321,1906
96897,9,489,179,0,0,0,0,589,768
26379,4,923,41,0,0,0,1,62,104
72767,8,484,839,9,3,4,3,1451,2309
57972,8,214,1313,5,1,0,3,1852,3174
20600,8,214,388,18,5,0,4,716,1131
103496,10,111,12,0,0,0,0,37,49
51417,10,111,208,2,1,1,1,287,500
114296,9,489,617,10,10,1,3,965,1606
130239,9,489,121,2,3,0,2,190,318
53592,5,375,398,15,9,5,5,560,992
9306,9,158,173,1,0,0,0,241,415
152696,9,374,586,21,14,3,2,889,1515
85254,9,657,30,0,0,0,0,56,86
163415,5,375,263,13,11,1,2,376,666
60235,8,623,240,6,1,0,1,539,787
22253,6,117,199,2,3,0,0,307,511
134814,7,842,143,2,2,0,0,234,381
86027,5,58,127,4,2,0,2,221,356
109968,9,657,7,0,0,0,0,13,20
58430,10,790,107,0,0,0,0,142,249
126151,9,657,44,1,1,0,0,81,127
76012,7,741,1637,52,19,9,9,2602,4328
56828,6,402,143,4,4,0,0,264,415
113542,9,452,236,5,3,0,1,318,563
50146,8,214,371,3,3,0,0,471,848
30342,4,306,3,0,0,0,0,2,5
135577,8,306,2011,42,25,1,10,3727,5816
95577,9,452,14,0,0,0,0,25,39
12953,4,752,194,1,1,0,0,264,460
141911,9,452,41,1,0,1,0,59,102
69352,4,200,402,13,3,2,0,648,1068
122687,4,200,291,7,5,1,1,420,725
24764,9,315,16,0,0,0,0,25,41
128167,8,214,1659,6,2,0,5,2509,4181
77740,4,36,674,12,5,1,2,998,1692
50701,9,79,9,0,0,0,0,15,24
60664,9,741,11,0,0,0,0,13,24
152333,5,58,887,35,20,8,13,1426,2389
90521,8,658,4450,144,56,12,25,8073,12760
133285,5,375,144,1,0,0,0,177,322
11436,4,678,1923,61,30,7,4,3111,5136
117794,5,78,97,3,1,0,0,152,253
141381,4,200,408,4,5,0,1,637,1055
140253,4,200,207,8,5,0,0,292,512
113319,8,812,1280,23,8,2,5,1889,3207
149147,8,489,233,3,2,0,0,367,605
82146,5,800,460,13,5,0,4,847,1329
28375,8,885,571,10,6,0,3,873,1463
107134,9,607,223,2,2,0,2,290,519
21302,8,693,19,0,0,0,0,8,27
151099,10,917,61,1,1,0,0,77,140
122915,6,78,1555,29,14,0,9,2046,3653
83039,4,596,164,6,1,0,1,235,407
145321,4,752,95,1,1,0,0,125,222
38174,6,427,1364,47,30,0,8,2289,3738
137937,4,174,155,5,0,0,0,263,423
11766,4,159,2236,48,9,0,16,3364,5673
19960,8,885,3831,114,38,3,27,6174,10187
100589,8,214,2096,14,4,0,16,3241,5371
48855,4,159,106,3,0,0,0,163,272
50416,8,214,2015,37,24,0,11,3721,5808
16678,8,623,490,15,2,0,4,920,1431
33946,10,790,124,1,1,0,0,168,294
167412,5,479,665,13,14,0,6,1119,1817
122144,10,40,616,11,7,0,3,976,1613
160020,4,752,1403,18,10,0,9,2317,3757
21942,8,306,1825,22,13,1,4,2936,4801
23786,8,306,311,4,2,0,2,463,782
91542,6,416,326,4,1,0,0,451,782
115757,6,570,1947,84,25,9,6,2733,4804
67332,6,402,356,5,6,2,1,561,931
15648,6,306,204,1,1,0,0,297,503
123998,5,699,59,1,2,0,0,84,146
51673,6,51,429,14,9,2,1,697,1152
661,8,658,946,31,11,0,7,1719,2714
85718,10,36,231,8,7,0,1,365,612
132952,8,545,441,12,4,0,3,693,1153
100737,10,917,504,9,10,0,2,872,1397
80128,6,570,930,28,16,1,5,1442,2422
98678,4,174,103,0,0,0,0,212,315
24200,5,225,181,3,3,0,4,329,520
51019,6,821,152,1,1,0,0,271,425
149015,9,452,43,0,0,0,1,95,139
31960,4,200,1625,23,7,3,8,2404,4070
67343,7,578,76,0,0,0,0,99,175
64029,6,570,397,16,11,0,2,615,1041
147898,4,200,7379,178,63,14,32,10033,17699
118228,11,214,32,1,0,0,0,39,72
4826,9,452,3,0,0,0,0,5,8
51477,8,489,2018,35,14,1,17,3557,5642
49911,8,489,416,8,6,0,2,724,1156
162194,4,375,184,2,3,0,3,339,531
171225,7,601,845,25,15,6,3,1281,2175
120711,4,885,75,0,0,0,0,95,170
88941,5,200,268,10,4,0,2,349,633
141682,4,885,36,0,0,0,0,60,96
41732,9,452,93,1,1,0,0,121,216
136510,5,124,1088,20,12,4,1,1782,2907
124554,6,570,122,8,5,0,1,213,349
59739,7,61,116,4,3,0,0,157,280
118303,4,800,335,4,2,0,1,494,836
23535,9,452,1,0,0,0,0,1,2
61168,10,81,54,0,0,0,0,82,136
79673,6,174,1328,36,18,6,3,1920,3311
10728,8,214,99,1,0,0,0,180,280
141614,7,587,3996,111,63,16,22,7511,11719
63775,8,214,817,1,2,0,2,1437,2259
105400,9,489,1304,0,0,0,11,2926,4241
56976,7,587,1006,20,12,2,6,1481,2527
154993,6,78,329,5,2,0,2,499,837
27586,7,216,968,10,7,4,2,1410,2401
48388,8,214,527,24,4,1,3,901,1460
148580,10,81,84,1,1,0,0,133,219
56971,8,214,92,1,0,0,1,151,245
62708,8,214,1604,29,15,0,8,2322,3978
13128,8,214,12,0,0,0,0,13,25
163918,6,124,1755,46,23,1,9,2981,4815
16786,6,78,666,11,6,0,3,973,1659
39197,7,578,196,4,4,0,1,289,494
69587,5,200,568,18,11,0,2,789,1388
41478,8,214,84,3,0,0,0,168,255
156199,8,214,1350,29,8,3,16,2383,3789
67325,6,263,11,0,0,0,0,18,29
124800,5,693,373,1,3,0,0,540,917
152507,4,220,379,6,3,0,2,637,1027
117901,7,306,96,0,0,0,0,122,218
93752,5,124,2578,75,35,8,27,4075,6798
74868,4,885,35,0,0,0,0,58,93
103885,5,218,358,13,6,1,0,522,900
23860,6,290,726,18,3,0,2,1104,1853
168886,6,827,163,9,4,0,0,265,441
124832,10,81,32,3,0,0,0,51,86
48503,6,200,211,1,1,0,0,272,485
157888,7,587,228,6,4,1,3,343,585
63458,7,306,794,0,0,0,3,1085,1882
96123,7,306,166,0,0,0,1,228,395
83363,5,159,1894,76,32,8,21,3357,5388
32573,5,699,538,29,12,1,2,765,1347
117152,7,587,636,8,5,0,4,923,1576
152199,5,159,1141,45,23,5,7,1796,3017
71695,7,748,82,2,0,0,2,122,208
82520,8,693,49,0,0,0,0,75,124
62105,8,403,603,10,4,0,4,1035,1656
159070,7,38,1809,40,25,2,5,3203,5084
98347,7,484,14,0,0,0,0,17,31
3850,4,200,807,21,5,0,6,1137,1976
14896,4,36,253,4,4,0,1,415,677
148467,6,269,86,0,0,0,0,131,217
65269,4,200,1037,34,14,1,5,1216,2307
72218,9,640,678,22,10,2,6,922,1640
65817,5,200,196,6,3,0,3,328,536
84072,8,489,250,6,3,0,1,389,649
145406,8,214,1079,22,9,1,6,1819,2936
29055,9,489,1243,37,22,3,8,1882,3195
13029,7,306,691,4,3,1,7,1233,1939
48341,4,519,330,0,0,0,2,564,896
51570,8,214,2715,7,3,1,6,4068,6800
42638,8,489,813,21,5,0,5,1195,2039
36493,10,917,44,1,0,0,1,74,120
45078,5,306,552,3,3,0,5,784,1347
119052,7,587,4492,106,36,12,21,8336,13003
64943,10,841,15,0,1,0,0,24,40
141998,4,375,87,1,0,0,0,119,207
74042,4,200,158,7,4,0,3,265,437
63585,6,135,1569,59,28,4,4,2716,4380
159079,11,403,72,2,0,0,0,77,151
4632,4,519,891,1,1,0,4,1330,2227
10224,8,214,243,1,1,0,1,375,621
29721,8,214,291,1,0,0,1,466,759
156778,8,489,878,7,2,0,5,1535,2427
169413,7,38,1873,28,14,1,11,3530,5457
136840,6,514,137,10,0,1,0,127,275
70593,6,375,2141,91,39,12,9,3302,5594
1485,9,842,427,11,1,0,1,703,1143
11406,8,244,48,0,0,0,0,144,192
115920,8,214,486,6,6,0,7,928,1433
113133,10,653,568,8,6,0,6,864,1452
147199,10,653,721,37,17,0,6,1448,2229
49931,4,36,182,4,5,0,1,297,489
89745,5,124,772,19,11,0,6,1264,2072
66088,8,214,1865,49,26,4,12,3361,5317
154617,9,800,2,0,0,0,0,3,5
46288,4,581,119,0,0,0,0,189,308
118902,5,225,156,2,0,0,0,250,408
141421,4,519,346,9,5,0,0,438,798
26148,9,800,5,0,0,0,0,7,12
63523,8,596,355,6,3,0,3,551,918
66119,6,693,776,0,0,0,4,979,1759
102656,4,36,302,6,4,0,0,538,850
154140,11,214,92,6,0,1,0,99,198
134202,4,658,91,2,0,0,0,131,224
66405,8,306,1283,15,15,0,10,2168,3491
132705,6,306,1476,13,8,0,4,2245,3746
164164,6,78,434,3,3,0,6,594,1040
149862,5,78,484,10,4,0,1,680,1179
33393,8,214,81,0,0,0,3,129,213
155687,6,159,64,0,0,0,0,103,167
61856,4,890,1447,30,11,1,7,2225,3721
121556,4,725,49,0,0,0,0,84,133
159116,7,521,24,1,0,0,0,33,58
97536,8,655,1800,43,23,2,8,2996,4872
107962,6,124,1505,27,16,1,5,2597,4151
122111,10,208,92,0,1,0,0,178,271
164996,6,269,369,4,3,0,0,640,1016
157874,7,38,1047,22,16,0,3,2143,3231
96095,10,104,8,0,0,0,0,14,22
2115,9,489,121,6,2,0,2,196,327
19198,9,489,1073,84,51,8,4,1912,3132
38491,6,235,34,0,0,0,0,38,72
103776,9,489,183,0,0,0,3,710,896
16762,9,630,165,1,0,0,1,624,791
50290,8,214,2865,85,35,2,11,5416,8414
111846,8,214,365,2,4,0,3,628,1002
60735,9,597,247,11,2,2,1,557,820
32536,9,597,1004,18,12,0,3,1507,2544
34775,8,214,139,2,1,1,0,234,377
126578,4,658,63,0,0,0,0,77,140
26736,9,630,472,15,15,2,1,681,1186
117721,6,263,1047,33,25,0,10,1619,2734
75139,8,214,120,0,0,0,2,158,280
100662,6,261,965,30,15,2,6,1697,2715
148407,7,521,407,15,7,1,2,673,1105
58178,7,521,526,27,17,0,3,891,1464
60383,7,521,27,1,0,0,0,41,69
65751,7,521,181,2,0,1,1,268,453
96179,7,521,30,1,0,0,0,53,84
43126,4,427,488,13,18,1,1,865,1386
69557,8,812,61,0,0,0,0,79,140
98275,7,521,137,6,5,0,0,199,347
39138,7,521,16,2,1,0,0,38,57
93830,6,124,584,14,10,0,8,882,1498
167523,7,521,20,0,0,0,0,26,46
96169,5,78,166,13,5,0,0,263,447
14359,6,375,3112,119,66,19,22,4780,8118
69479,8,885,8,0,0,0,0,13,21
146038,8,214,324,0,0,0,0,453,777
89924,5,200,990,24,10,0,3,1643,2670
32370,8,214,1210,21,8,0,8,1807,3054
27061,8,214,802,39,15,2,10,1657,2525
81865,8,623,1842,46,18,5,11,3139,5061
22538,4,453,899,19,12,0,2,1330,2262
36800,5,78,28,0,0,0,0,45,73
52350,8,214,32,0,0,0,0,45,77
111395,4,752,44,0,0,0,0,53,97
25911,10,474,270,14,1,0,0,500,785
119855,5,251,127,0,0,0,1,189,317
77785,7,741,1182,47,12,10,8,2120,3379
105777,5,225,171,7,1,0,1,271,451
168593,5,118,223,14,7,0,1,409,654
86385,8,214,149,1,0,0,1,220,371
285,8,214,443,8,6,1,2,721,1181
86622,8,623,73,1,0,1,0,196,271
8820,6,269,603,12,7,0,1,863,1486
113529,6,693,230,3,2,0,0,346,581
16848,5,118,705,29,12,8,1,983,1738
76976,4,36,76,0,0,0,1,120,197
129828,8,800,479,6,3,1,4,718,1211
12681,4,581,373,7,6,0,1,609,996
103675,6,306,1258,24,11,4,3,2057,3357
134357,9,367,202,0,0,0,2,256,460
51457,5,78,417,6,1,0,6,644,1074
122246,7,861,15,0,0,0,0,30,45
137977,9,367,29,0,0,0,0,43,72
132387,11,214,14,0,0,0,0,14,28
13409,8,489,153,4,2,0,0,309,468
17277,5,78,224,6,4,0,1,349,584
82836,8,489,187,2,1,0,0,314,504
72897,7,587,516,4,1,0,1,763,1285
160662,8,489,843,29,12,2,8,1302,2196
30110,7,861,90,2,0,0,0,194,286
128562,8,812,673,14,11,3,3,1115,1819
96874,5,479,380,4,3,0,1,541,929
127444,8,812,205,3,1,0,3,279,491
113305,8,244,4232,69,20,3,15,8033,12372
22393,4,675,18,0,0,0,0,31,49
15306,6,200,191,10,5,1,1,293,501
9374,4,675,478,8,5,0,2,888,1381
39460,7,693,89,4,3,0,0,132,228
148928,4,658,1199,45,22,2,4,2099,3371
91630,6,165,278,2,3,2,3,382,670
138986,5,489,2185,15,5,0,16,3423,5644
65375,5,489,1016,8,7,0,8,1652,2691
14643,5,479,145,0,0,0,1,229,375
77256,6,885,346,3,0,0,1,603,953
158020,8,658,1740,68,40,4,14,2810,4676
135309,8,214,1139,23,7,0,10,2094,3273
3301,8,812,669,16,5,0,5,830,1525
158802,6,821,122,1,0,0,0,179,302
92192,6,375,2545,79,37,22,11,3750,6444
84840,7,587,237,4,0,0,0,290,531
22086,6,78,1118,27,18,0,6,1746,2915
13622,5,355,267,4,4,1,0,359,635
30740,5,800,2232,101,55,21,19,4361,6789
156119,6,269,40,0,0,0,0,49,89
113020,8,244,314,5,1,0,2,1088,1410
152863,4,800,2,0,0,0,0,0,2
59367,4,800,5,0,0,0,0,0,5
39410,4,800,1,0,0,0,0,0,1
145899,4,36,187,0,0,0,0,297,484
98413,4,800,252,7,5,0,1,471,736
21035,4,800,11,0,0,0,0,7,18
77654,9,800,552,15,9,1,6,910,1493
30281,5,118,2067,69,35,15,20,3039,5245
112279,8,545,21,1,0,0,0,43,65
73781,4,800,338,5,5,0,2,598,948
108396,9,77,57,0,0,0,1,75,133
68859,7,77,67,6,0,0,1,88,162
139017,4,36,32,0,0,0,0,54,86
162097,11,812,89,0,0,0,0,85,174
47693,8,306,2954,119,48,1,17,5327,8466
130679,4,36,65,0,0,0,0,107,172
55308,4,658,461,19,13,1,3,801,1298
166573,5,489,271,7,5,0,1,405,689
108894,4,800,328,8,5,0,3,497,841
118384,7,489,226,4,1,0,1,399,631
120469,6,124,104,7,2,0,0,137,250
23665,4,890,273,8,4,0,1,407,693
139287,5,200,1906,62,28,6,26,3091,5119
55983,6,570,681,12,4,2,4,957,1660
99543,5,58,1134,7,5,0,8,1871,3025
147567,8,545,226,0,0,0,0,424,650
67070,4,174,26,0,0,0,0,56,82
44609,8,623,200,8,4,0,1,344,557
158326,4,300,454,17,7,0,1,870,1349
94287,7,216,179,2,0,14,0,241,436
67392,9,489,66,0,2,0,0,120,188
149295,8,214,2766,83,39,6,8,4407,7309
85345,4,885,269,0,0,0,2,383,654
64737,4,885,444,1,2,0,2,698,1147
77685,11,214,1,0,0,0,0,2,3
46937,9,489,23,0,0,0,0,53,76
11473,9,78,391,8,7,0,2,634,1042
93759,11,693,268,20,0,0,0,271,559
96654,9,404,129,0,0,0,0,242,371
137436,8,489,2,0,0,0,0,2,4
53483,8,214,1026,22,10,0,2,1750,2810
72001,4,174,1444,12,11,0,5,2433,3905
132215,7,207,141,7,3,1,0,381,533
65006,6,263,3,0,0,0,0,3,6
54517,7,207,139,8,2,0,1,423,573
9076,7,521,245,9,6,0,1,422,683
11982,9,630,155,0,0,0,0,213,368
129131,6,78,1796,29,12,0,6,2678,4521
50589,7,489,429,5,2,0,0,649,1085
114683,7,77,284,7,3,1,2,442,739
83241,7,79,97,2,1,1,2,159,262
135801,7,489,219,2,1,0,0,345,567
5869,8,214,42,0,1,0,0,74,117
59234,7,842,157,2,1,0,0,274,434
25756,4,159,7,0,0,0,0,9,16
25279,7,630,106,1,1,0,0,174,282
121342,8,812,966,12,4,0,4,1639,2625
96500,9,630,215,6,1,0,2,327,551
134107,10,628,52,1,0,0,0,59,112
74156,7,630,64,0,0,0,0,102,166
95104,9,630,38,0,0,0,0,51,89
47988,7,741,122,2,1,0,1,165,291
153867,8,30,2562,1,0,0,10,4482,7055
48694,9,630,2982,87,33,4,12,4786,7904
155351,7,263,50,0,0,0,0,81,131
66246,9,630,283,0,0,0,1,634,918
68954,9,630,72,0,0,0,1,129,202
157520,7,762,670,13,6,2,4,1241,1936
76255,9,630,136,0,0,0,1,207,344
82905,10,66,71,1,1,0,0,169,242
98867,9,630,209,3,3,0,1,339,555
113402,8,403,296,8,3,0,0,522,829
59339,5,404,22,0,0,0,0,21,43
156088,8,717,444,7,4,0,0,677,1132
7888,8,489,441,2,1,2,2,637,1085
82894,7,367,10,0,0,0,0,21,31
129596,5,78,21,0,0,0,0,23,44
154286,7,669,4,0,0,0,0,7,11
145179,5,404,111,0,0,0,2,184,297
22128,7,429,47,0,0,0,0,73,120
51906,7,762,1418,70,23,5,5,2608,4129
20648,10,790,44,1,1,0,0,97,143
66228,7,762,215,10,5,0,0,425,655
30157,6,165,454,8,1,2,2,809,1276
65703,6,165,17,0,0,0,0,27,44
67780,8,623,294,6,5,0,3,481,789
9679,6,165,7,0,0,0,0,9,16
138689,5,118,791,30,19,5,1,1270,2116
95109,6,165,256,7,5,1,0,542,811
157893,7,46,15,0,0,0,0,28,43
14808,8,214,175,7,1,0,0,365,548
11708,7,447,497,13,11,0,3,726,1250
42063,7,589,115,6,1,0,1,193,316
32988,7,46,12,0,0,0,0,16,28
19631,6,601,527,24,10,2,4,822,1389
142080,8,214,8,0,0,0,0,7,15
133220,10,66,118,4,2,2,1,281,408
55674,8,489,872,18,6,1,7,1413,2317
152699,5,479,1701,46,22,7,7,3024,4807
1298,8,800,51,0,1,0,0,62,114
60993,7,157,45,0,0,0,0,78,123
23618,5,479,202,5,2,0,2,288,499
22359,5,58,2034,121,40,38,14,3116,5363
148598,9,800,45,4,1,0,1,221,272
132406,7,404,40,0,0,0,0,47,87
47593,9,6,4,0,1,0,1,9,15
88196,10,66,105,2,1,1,0,250,359
91406,6,124,184,0,0,0,0,249,433
9320,8,214,544,5,3,0,3,914,1469
60557,8,489,256,3,1,0,0,460,720
92475,7,741,11,0,0,0,0,12,23
150584,9,489,561,11,8,1,2,855,1438
153084,4,453,30,1,0,0,0,30,61
100174,8,812,249,5,2,0,2,350,608
144821,8,214,380,7,4,0,2,599,992
88191,7,762,14,0,0,0,0,21,35
104433,9,489,185,6,2,0,0,285,478
138289,8,306,3180,65,31,1,15,5881,9173
16435,10,752,409,9,4,0,3,641,1066
164296,9,597,10,1,1,0,0,18,30
54206,8,214,219,6,2,1,1,292,521
161096,6,159,42,0,0,0,0,61,103
49201,4,200,38,1,1,0,2,60,102
169641,8,812,453,20,11,0,3,659,1146
13699,8,812,139,0,0,0,1,165,305
136677,6,489,801,21,16,0,4,1164,2006
80927,8,885,678,39,14,1,4,1155,1891
21229,8,812,301,1,0,0,0,472,774
151546,6,232,642,51,13,1,6,1000,1713
35224,4,124,1,0,0,0,0,2,3
1501,9,762,23,0,0,0,0,40,63
9852,8,812,97,6,1,0,1,144,249
58024,8,489,479,2,0,0,2,711,1194
25438,8,812,249,13,4,0,1,313,580
139326,4,36,21,0,0,0,0,25,46
109637,6,368,395,8,4,0,1,497,905
99841,6,693,323,0,0,0,0,401,724
120401,4,174,933,32,13,0,7,1475,2460
88257,8,30,507,3,6,0,1,1287,1804
79491,5,800,683,33,15,3,6,1068,1808
123350,8,214,834,20,5,3,5,1311,2178
97645,9,630,365,15,10,0,3,527,920
75096,5,225,1206,37,18,5,9,2516,3791
112249,8,124,431,12,5,0,4,774,1226
28336,7,216,794,16,8,0,1,1668,2487
71379,7,216,179,1,1,0,1,313,495
133009,8,812,30,0,0,0,0,70,100
155877,11,658,110,2,0,0,0,101,213
66017,10,790,138,0,3,0,1,288,430
39065,8,800,544,14,7,0,1,870,1436
105158,10,790,66,2,3,0,0,148,219
4260,4,174,771,13,7,0,1,1242,2034
163027,9,78,2196,66,26,5,14,3335,5642
82063,10,81,42,0,0,0,0,59,101
102915,9,78,1279,42,24,1,6,1833,3185
31827,7,157,62,3,2,0,0,116,183
65265,4,174,32,0,0,0,0,60,92
151210,10,66,60,0,1,0,1,152,214
157243,8,403,416,0,0,0,0,669,1085
146253,5,225,1,0,0,0,0,1,2
4179,6,165,448,15,10,2,2,774,1251
107763,10,790,275,4,3,0,0,515,797
48652,9,78,544,15,11,0,4,785,1359
61880,9,842,2202,85,36,3,10,3407,5743
56750,4,200,3,0,0,0,0,6,9
20233,5,209,50,0,0,0,0,79,129
5688,10,111,96,0,0,0,0,146,242
116342,10,743,4,0,0,0,0,4,8
85385,6,783,143,0,0,0,0,200,343
68293,8,658,2033,72,24,3,9,3220,5361
164354,8,812,968,35,6,1,8,1470,2488
117806,9,630,670,20,9,1,4,830,1534
113701,10,743,12,0,0,0,0,30,42
12346,8,403,605,23,8,1,1,848,1486
133166,4,890,676,24,15,1,3,1020,1739
156363,10,743,2,0,0,0,0,14,16
53930,4,923,150,2,1,1,0,233,387
36232,10,63,32,0,0,0,0,51,83
21562,10,63,143,4,0,0,0,234,381
82764,5,375,451,12,6,0,1,697,1167
121554,5,375,403,7,7,0,2,658,1077
160349,8,214,2445,22,8,1,19,3929,6424
3906,4,885,15,0,0,0,0,11,26
33465,5,59,91,1,0,0,0,146,238
125297,7,489,402,8,5,0,1,579,995
130900,11,489,402,23,0,0,0,399,824
40711,4,800,2655,50,18,3,17,3845,6588
56055,6,570,1629,47,23,3,4,2436,4142
150393,8,214,258,0,0,0,0,342,600
42868,8,693,501,9,4,0,4,688,1206
115382,8,658,147,0,0,0,0,238,385
119700,8,214,121,0,0,0,0,173,294
29980,9,640,188,8,6,0,1,324,527
120743,9,842,208,4,3,0,0,454,669
124521,9,570,356,3,0,0,0,455,814
71314,11,214,490,26,0,0,0,557,1073
64419,7,741,1918,58,28,7,13,3057,5081
32124,5,124,391,8,5,0,2,623,1029
111562,5,447,356,10,10,0,2,625,1003
53908,8,214,1938,4,3,0,6,2761,4712
28277,4,159,683,15,3,0,5,1022,1728
69539,8,655,655,10,3,0,4,1036,1708
80872,8,214,287,3,2,0,2,454,748
66975,8,885,87,2,1,0,0,109,199
124536,8,812,401,4,4,0,2,572,983
43787,9,570,364,3,3,1,2,535,908
64178,8,124,279,10,3,0,2,465,759
5651,8,214,230,0,0,0,0,395,625
2156,9,640,385,15,7,1,2,553,963
97439,8,812,57,2,1,0,1,90,151
52210,5,800,662,35,8,3,6,1321,2035
58354,8,214,113,0,0,0,0,385,498
85260,5,263,1110,20,11,2,8,1821,2972
33511,5,118,1252,48,19,4,6,1888,3217
133061,4,174,53,0,0,0,0,73,126
49462,8,812,132,2,2,0,1,221,358
90724,5,263,1090,30,18,3,11,1800,2952
80781,5,176,144,5,2,0,0,217,368
94792,4,658,112,2,2,0,0,289,405
64508,8,489,750,46,12,3,9,1287,2107
101891,7,306,3609,94,49,3,8,5447,9210
71684,4,36,364,27,8,3,2,650,1054
118193,8,30,17,0,0,0,0,21,38
128207,7,157,23,0,0,0,0,15,38
44163,5,693,1170,42,32,8,5,1686,2943
169921,8,214,926,32,13,1,8,1850,2830
26560,4,885,298,1,1,0,0,477,777
141070,4,885,102,0,0,0,0,138,240
53599,5,851,25,0,0,0,0,38,63
116721,5,375,300,8,5,0,1,439,753
143803,5,124,106,0,0,0,0,155,261
110391,5,124,219,7,5,0,1,312,544
113828,4,800,32,0,0,0,0,44,76
5586,7,527,142,4,4,2,0,216,368
112754,6,800,380,6,7,0,2,927,1322
67295,9,630,1991,111,41,6,13,3463,5625
32774,8,489,2974,36,17,1,8,5030,8066
4503,5,263,1438,42,18,5,12,2399,3914
112727,8,489,1848,29,9,2,16,3325,5229
170907,4,658,132,1,3,0,0,198,334
114313,8,214,571,6,2,0,3,863,1445
97798,10,743,2,0,0,0,0,2,4
104832,4,800,153,7,1,0,1,254,416
51969,8,214,871,12,9,1,3,1539,2435
59213,4,124,1,0,0,0,0,2,3
164554,8,885,148,0,1,0,2,307,458
14003,8,885,199,6,2,0,1,306,514
130743,6,235,72,2,3,0,1,165,243
89704,9,483,9,0,0,0,0,16,25
71080,7,589,192,7,4,0,0,328,531
11360,7,61,281,8,3,1,0,406,699
39896,7,489,421,12,5,0,0,1337,1775
130291,8,214,2824,38,13,1,20,4735,7631
93735,7,126,642,17,7,2,2,1008,1678
151179,4,174,15,0,0,0,0,18,33
157239,7,563,30,2,0,1,0,72,105
160358,5,118,372,5,1,2,3,554,937
124736,8,214,794,24,11,0,3,1656,2488
9947,9,483,3,0,0,0,0,4,7
122031,7,79,36,5,2,1,0,67,111
139615,7,79,18,0,0,0,0,36,54
108226,4,885,5,0,0,0,0,7,12
37299,5,232,129,0,0,0,1,187,317
123667,7,587,224,2,1,0,0,388,615
67127,4,453,429,19,4,0,2,717,1171
57297,8,214,933,38,7,2,8,1813,2801
115827,4,453,285,12,2,1,2,526,828
104748,8,545,1287,53,18,3,6,2023,3390
170760,9,489,65,3,1,0,3,104,176
169646,7,79,30,0,0,0,0,73,103
24283,7,79,68,2,2,0,0,123,195
137205,4,840,223,3,2,0,1,338,567
23117,6,306,2329,54,34,4,20,3871,6312
141399,7,648,33,5,3,1,0,114,156
48319,9,630,181,4,3,0,0,274,462
127929,4,36,186,1,0,1,1,266,455
75321,4,36,22,0,0,0,0,29,51
131436,8,214,350,0,1,0,1,538,890
99800,9,630,30,0,1,0,0,59,90
66299,9,100,261,5,6,0,1,455,728
28460,7,630,126,6,8,0,0,212,352
142136,9,367,71,2,2,0,0,99,174
160923,7,630,33,1,1,0,0,59,94
42483,7,630,601,32,15,2,1,1010,1661
158062,4,36,140,1,0,0,0,224,365
35531,7,587,130,0,0,0,0,152,282
102976,5,479,721,25,14,0,3,952,1715
65806,4,453,110,0,0,0,1,178,289
83182,8,214,1465,21,13,2,11,2276,3788
99508,4,306,18,0,0,0,0,26,44
131957,7,589,86,4,1,0,2,151,244
12617,8,403,201,4,1,0,1,301,508
29928,4,453,952,23,11,0,2,1393,2381
72907,9,813,54,0,0,0,0,179,233
9454,4,36,21,0,0,0,0,24,45
113286,5,381,322,0,0,0,0,452,774
98482,6,827,368,11,6,3,0,510,898
134772,8,545,216,7,5,0,2,349,579
165265,7,587,984,23,15,1,1,1291,2315
149805,8,622,1080,12,3,0,3,1581,2679
154282,4,638,81,0,0,0,0,101,182
132865,8,214,860,13,7,2,3,1469,2354
114031,7,521,47,0,0,0,0,61,108
137883,8,214,619,2,0,0,3,1202,1826
61155,9,462,9,0,0,0,0,9,18
163536,9,462,2,0,0,0,0,3,5
97740,9,374,26,1,1,0,0,41,69
39710,4,375,20,0,0,0,0,36,56
64082,5,479,114,0,0,0,0,152,266
169735,8,214,958,22,9,0,4,1748,2741
26131,4,885,438,3,0,0,0,758,1199
108305,9,842,2446,68,40,5,15,3985,6559
53451,9,842,322,0,0,0,4,721,1047
4589,8,489,366,1,0,0,1,540,908
83111,6,78,138,2,1,0,0,157,298
126299,7,228,18,1,0,0,0,30,49
165467,8,244,1386,21,6,1,7,2284,3705
75975,6,489,176,2,2,0,0,289,469
67489,4,800,1620,53,28,2,5,2819,4527
110983,6,174,42,6,4,0,0,107,159
136289,9,489,2,0,0,0,0,2,4
31703,6,269,887,17,11,5,5,1432,2357
106285,9,42,29,0,0,0,0,49,78
31877,8,306,254,6,3,0,1,396,660
105811,6,209,199,8,7,1,1,274,490
89953,8,766,327,10,8,1,2,559,907
26757,8,545,212,1,0,0,0,214,427
8221,9,813,180,1,1,0,0,710,892
117139,4,885,1265,4,2,0,4,1943,3218
87838,7,194,357,11,3,0,0,572,943
124312,7,741,94,0,0,0,1,165,260
110720,6,658,57,4,4,0,0,88,153
162759,6,232,1633,70,40,18,10,2695,4466
71691,8,812,674,20,7,0,6,1033,1740
9448,8,489,1541,38,9,2,11,2425,4026
126571,9,497,149,4,2,1,0,211,367
48441,4,885,223,1,0,0,0,351,575
137206,4,174,560,11,4,1,4,897,1477
7838,7,570,1988,73,33,10,10,3043,5157
33710,4,885,104,0,0,0,0,151,255
39812,9,452,227,4,1,1,0,389,622
148005,5,118,657,30,17,8,1,1074,1787
139848,9,374,11,0,0,0,1,19,31
91495,4,200,70,0,0,0,0,109,179
120498,6,570,1578,47,27,5,3,2197,3857
103193,5,489,2777,103,41,18,12,4477,7428
125964,5,66,387,23,9,4,3,622,1048
168042,9,452,187,7,2,0,2,280,478
143057,4,885,247,0,0,0,0,442,689
28356,6,103,66,0,0,0,2,99,167
62176,5,58,233,10,2,3,0,390,638
8156,8,214,1561,16,11,0,7,2512,4107
95452,7,660,67,2,1,0,0,115,185
57579,9,301,266,9,5,2,0,445,727
62802,9,658,18,0,0,0,0,23,41
168441,11,403,185,8,0,0,0,183,376
85005,10,172,75,5,2,1,0,145,228
115063,11,800,71,11,0,0,0,75,157
154431,9,301,54,1,0,0,0,73,128
76380,7,484,63,7,0,2,0,125,197
124914,9,741,350,0,0,0,3,568,921
127863,4,581,865,27,14,4,5,1545,2460
15369,5,225,170,0,0,0,0,253,423
126751,8,214,699,0,0,0,2,979,1680
150869,7,492,7,0,0,0,0,11,18
143887,6,570,149,2,2,0,0,198,351
165257,6,165,54,0,0,0,0,74,128
106024,11,214,295,9,0,1,0,342,647
30256,8,124,209,2,1,0,0,279,491
87553,8,812,485,15,9,0,4,689,1202
2086,8,658,391,4,1,0,1,658,1055
42010,4,519,113,1,1,0,0,259,374
167874,9,741,127,0,0,0,2,234,363
161797,9,741,251,0,0,0,1,495,747
84945,7,535,54,0,0,0,1,137,192
5710,4,174,106,0,0,0,0,177,283
101038,4,174,197,0,0,0,0,251,448
8344,8,623,372,4,4,1,2,491,874
87421,5,124,2521,53,29,1,15,3982,6601
132343,10,104,220,8,2,1,2,430,663
49324,10,841,690,13,6,0,5,924,1638
170522,8,306,76,2,0,0,0,111,189
96536,7,79,311,13,9,2,0,529,864
73075,9,741,73,0,0,0,2,162,237
109639,9,741,139,0,0,0,0,314,453
163288,4,592,52,0,0,0,0,79,131
131930,8,655,871,25,18,0,2,1349,2265
90846,9,842,462,3,1,0,1,731,1198
146505,5,235,392,15,6,1,3,633,1050
100197,9,597,368,16,8,1,4,413,810
103322,6,556,531,9,4,2,3,693,1242
167139,6,165,648,15,8,4,6,1492,2173
67188,6,103,119,0,0,0,2,176,297
24933,7,748,33,0,0,0,0,46,79
85656,10,617,114,10,1,0,1,180,306
47758,4,200,697,11,5,0,3,1030,1746
20500,10,413,1,0,0,0,0,0,1
166772,5,118,775,29,17,4,2,1219,2046
100945,6,103,34,0,0,0,0,33,67
112033,8,812,1483,44,26,4,7,2466,4030
21106,5,800,1349,79,31,6,9,2091,3565
42391,9,589,690,37,19,4,6,1083,1839
79600,5,78,177,4,2,0,0,261,444
67202,5,479,1206,24,11,0,5,1733,2979
130194,7,521,436,11,9,0,3,572,1031
56796,7,484,52,1,0,0,0,108,161
52650,7,484,19,1,1,0,0,19,40
125478,5,306,460,8,1,0,0,691,1160
162069,7,587,1038,29,11,2,4,1813,2897
21485,7,56,20,2,1,0,0,27,50
163114,5,118,184,6,7,1,1,340,539
121750,7,126,182,5,3,0,3,259,452
105763,4,519,253,4,2,0,0,453,712
30646,9,630,151,5,1,0,0,245,402
136428,8,306,1,0,0,0,0,3,4
135827,7,100,138,5,1,1,0,310,455
96780,7,100,32,0,0,0,1,45,78
46300,7,100,20,2,1,0,0,35,58
4954,8,489,113,0,0,0,2,155,270
48559,9,489,417,3,0,0,3,1046,1469
111847,8,214,1229,50,18,2,11,2212,3522
29512,8,403,513,22,8,0,2,844,1389
22626,4,36,108,1,0,0,0,108,217
28318,7,861,29,0,0,0,0,19,48
17513,4,375,417,15,10,0,0,816,1258
58386,4,200,421,8,2,0,1,678,1110
74791,5,479,465,8,3,0,4,798,1278
86686,8,489,501,9,3,0,3,799,1315
73991,5,728,164,8,1,0,0,296,469
12360,8,214,322,6,5,0,2,662,997
64323,6,601,285,8,7,0,1,427,728
121850,8,800,3828,78,23,3,17,6569,10518
34146,9,589,864,35,19,1,3,1411,2333
17708,11,693,43,3,0,0,1,59,106
78467,5,479,320,6,3,0,2,480,811
144907,7,535,263,7,1,1,1,678,951
110409,4,890,568,29,10,0,2,897,1506
42731,5,200,323,5,7,0,2,498,835
89947,7,527,246,29,15,4,0,388,682
31682,7,527,158,17,10,4,1,296,486
113714,10,474,596,13,4,0,3,1173,1789
8222,5,200,277,8,8,0,2,538,833
114062,9,640,448,7,6,1,2,645,1109
87414,5,200,138,5,1,0,1,196,341
20898,8,800,343,9,5,0,1,543,901
39346,4,519,184,5,3,0,0,253,445
34488,6,78,181,0,0,0,0,254,435
138272,5,124,206,6,3,0,1,320,536
121551,4,36,225,5,2,0,1,325,558
145378,7,56,511,31,10,4,1,761,1318
17733,5,655,112,3,2,0,0,161,278
56601,4,658,76,2,1,0,0,88,167
4566,8,658,81,2,3,0,1,123,210
116548,8,812,262,10,4,0,2,522,800
119061,6,200,621,10,7,1,6,820,1465
55755,8,214,1018,34,14,2,2,1738,2808
170139,9,341,161,1,1,0,0,260,423
19454,9,842,661,23,11,0,1,2172,2868
43409,10,474,6,0,0,0,0,7,13
148118,7,842,471,2,0,12,0,582,1067
32454,9,630,3187,95,48,5,22,4945,8302
58984,8,658,498,14,6,1,0,848,1367
140114,6,404,502,0,0,0,6,807,1315
15510,6,200,519,9,4,1,4,687,1224
109174,8,489,540,3,1,0,5,733,1282
133610,9,489,926,40,22,3,5,1473,2469
91257,9,489,194,12,2,0,1,329,538
89063,6,200,169,4,0,1,0,263,437
111003,6,124,118,3,2,0,1,186,310
163167,6,117,644,26,15,5,6,994,1690
6229,9,341,476,4,3,0,4,709,1196
135764,6,200,343,5,2,0,3,555,908
142149,9,489,570,0,0,0,4,1983,2557
45340,7,527,39,0,0,0,0,50,89
1710,4,800,111,0,0,0,1,402,514
64559,8,623,0,0,0,0,0,1,1
41535,7,46,630,14,8,2,3,974,1631
161452,11,812,280,4,0,0,0,276,560
156454,9,399,22,0,0,0,0,31,53
26487,7,521,8,0,0,0,0,14,22
102936,7,521,21,0,1,0,0,34,56
40668,7,741,33,0,0,0,0,62,95
96708,11,885,28,0,0,0,0,40,68
124611,7,100,17,0,0,0,0,49,66
116555,7,100,346,6,4,1,0,626,983
53363,8,623,343,9,5,0,3,529,889
68987,6,404,475,0,0,0,0,712,1187
19706,4,885,286,0,1,0,3,426,716
36595,7,563,558,11,5,2,3,937,1516
168556,9,302,51,4,1,0,0,121,177
1469,4,658,131,0,0,0,1,174,306
49018,4,519,184,4,0,0,0,263,451
244,5,106,77,0,0,0,0,88,165
157336,9,302,75,1,2,0,1,114,193
52005,7,126,28,1,2,0,0,52,83
121988,8,214,401,6,3,0,3,612,1025
65311,7,587,69,0,0,0,0,107,176
30155,8,623,450,6,2,1,5,700,1164
55429,7,24,847,19,9,5,5,1291,2176
62830,8,214,248,4,2,0,1,424,679
136524,7,587,105,4,5,0,1,144,259
21410,11,214,3,0,0,0,0,2,5
64859,9,640,2041,60,30,3,23,2752,4909
169675,7,157,39,0,0,0,0,78,117
101645,11,800,177,10,0,1,0,213,401
105487,5,821,79,2,2,0,1,94,178
3321,4,200,1554,29,15,1,5,2546,4150
11061,8,214,1060,38,11,1,7,1957,3074
33955,5,375,1167,77,33,26,4,1776,3083
55590,4,199,102,0,1,0,0,186,289
129313,4,306,3026,118,59,11,11,5027,8252
137899,7,126,39,1,1,0,0,67,108
163131,8,812,324,0,0,0,0,444,768
14480,7,126,9,0,0,0,0,19,28
45676,9,741,187,0,0,0,1,298,486
3581,7,126,18,0,0,0,0,22,40
74230,8,812,149,3,1,0,1,234,388
119669,11,800,126,4,0,0,0,155,285
19793,7,126,1,0,0,0,0,4,5
21923,4,519,432,13,2,0,0,655,1102
74662,4,174,460,15,4,0,3,743,1225
59035,4,230,112,0,0,0,0,211,323
9247,4,800,450,5,1,0,1,668,1125
109254,9,489,1043,0,0,0,9,2656,3708
149231,8,30,316,4,1,0,0,677,998
127490,7,157,2960,63,31,8,18,5161,8241
47523,10,66,77,2,0,1,0,181,261
67106,4,174,270,14,5,0,3,407,699
119450,8,812,387,15,8,0,1,562,973
163652,7,611,4,0,0,0,0,6,10
114375,10,653,48,0,0,0,0,118,166
139659,5,78,226,4,3,0,0,351,584
129664,5,78,1200,33,22,1,8,1805,3069
80578,10,820,26,4,0,0,0,51,81
38858,10,653,2,0,0,0,0,19,21
42188,10,752,492,25,5,0,2,846,1370
58499,4,174,238,9,6,0,0,358,611
42925,10,653,79,3,1,0,1,170,254
25959,7,216,377,15,2,1,2,677,1074
125708,7,611,20,0,0,0,0,24,44
100262,7,78,126,2,2,0,0,158,288
70439,6,885,91,2,3,0,2,174,272
3023,4,174,303,2,1,0,1,424,731
136933,10,797,268,1,0,0,0,408,677
125895,6,261,1296,20,17,0,6,2274,3613
90536,7,741,184,2,1,0,1,277,465
63724,8,623,79,0,0,0,0,112,191
79064,9,800,239,11,7,1,1,436,695
40860,7,285,48,0,0,0,0,68,116
40420,7,367,67,4,3,0,1,220,295
85480,10,701,58,0,0,0,0,134,192
125832,5,174,467,21,7,3,1,769,1268
113534,4,885,676,2,0,0,0,1128,1806
81955,10,63,457,7,4,1,4,724,1197
78162,4,200,332,3,5,0,0,517,857
82706,6,306,85,0,0,0,1,147,233
112241,7,587,20,0,0,0,0,41,61
153558,5,404,8,0,0,0,0,22,30
166813,6,885,3290,200,81,23,21,4830,8445
74382,10,474,81,2,1,0,0,107,191
108121,8,658,151,4,5,0,0,236,396
153812,4,890,7,0,0,0,0,25,32
122437,11,545,819,52,0,0,0,948,1819
145741,8,214,109,1,0,0,1,132,243
161179,8,375,168,8,4,0,1,313,494
59021,7,741,493,23,10,3,1,910,1440
57322,8,623,108,0,0,0,0,173,281
121572,7,56,501,12,4,2,0,652,1171
109791,8,214,290,1,0,0,2,477,770
145048,10,617,95,0,1,0,1,129,226
65700,8,214,2029,26,6,2,7,3366,5436
159252,7,56,30,1,0,0,0,44,75
50500,7,118,296,16,9,2,0,694,1017
8062,8,403,1277,28,13,3,5,2075,3401
167847,7,587,117,4,4,0,0,179,304
29766,8,214,617,1,2,0,0,920,1540
101381,6,269,176,0,0,0,0,247,423
5235,6,269,1587,46,28,2,12,2309,3984
156796,4,658,48,1,0,0,0,55,104
54174,6,124,185,5,3,0,6,314,513
169207,9,589,294,5,3,0,2,551,855
136619,10,692,282,4,1,0,0,485,772
130521,8,214,221,0,0,0,0,404,625
67135,4,752,359,24,7,0,0,607,997
141012,6,269,389,6,4,0,1,556,956
149512,5,375,5,0,0,0,0,9,14
156938,5,124,1419,36,16,3,9,2152,3635
31325,6,518,19,2,1,0,0,23,45
151809,9,640,380,6,4,2,2,599,993
159938,6,427,666,14,16,0,5,1122,1823
92766,5,893,207,3,3,0,1,316,530
19448,8,489,420,9,4,0,4,643,1080
38750,6,375,9,0,0,0,0,13,22
127507,6,375,6,0,0,0,0,12,18
56575,10,797,151,2,0,0,0,245,398
161871,5,200,491,8,8,0,0,698,1205
22019,4,174,198,3,5,0,2,357,565
61543,7,216,165,0,1,0,0,288,454
150656,4,890,955,17,11,2,5,1518,2508
16533,5,200,148,1,1,0,0,220,370
163723,4,890,297,4,4,0,1,471,777
56507,5,78,464,24,6,0,6,727,1227
106685,4,890,166,5,5,0,2,214,392
75771,8,885,658,27,8,0,4,1136,1833
130765,4,453,147,1,1,0,0,281,430
26032,7,118,394,46,18,4,2,658,1122
2464,5,693,71,0,0,0,0,110,181
61549,7,118,70,2,1,0,1,105,179
85602,7,118,59,2,2,0,0,114,177
134021,10,841,6,0,0,0,0,12,18
111819,4,593,279,0,0,0,0,378,657
160122,10,917,48,1,1,0,0,105,155
80035,4,200,208,3,1,0,3,301,516
165914,4,519,95,2,0,0,1,132,230
98177,4,453,410,5,5,0,3,619,1042
49269,8,857,2308,36,11,1,7,3327,5690
150535,5,225,297,10,7,0,1,442,757
98225,10,701,168,4,5,0,1,308,486
132366,10,701,183,8,3,1,1,394,590
47124,10,621,14,0,0,0,0,25,39
437,5,78,677,20,11,1,4,984,1697
55651,5,306,203,0,0,0,2,325,530
14589,4,658,692,10,9,2,5,1246,1964
7794,4,923,236,2,2,0,1,430,671
80771,4,519,337,3,3,0,2,465,810
17065,4,174,780,32,13,0,4,1183,2012
145462,6,693,84,1,1,0,0,112,198
17966,5,306,298,0,0,0,0,441,739
52408,9,741,495,46,27,3,2,766,1339
132378,8,214,45,0,0,0,1,49,95
81091,9,100,335,17,9,0,3,831,1195
86725,5,306,85,0,0,0,2,126,213
168590,6,366,708,18,9,0,2,965,1702
107407,9,100,61,1,1,0,0,125,188
7177,9,100,27,0,0,0,0,37,64
151509,7,196,47,2,0,0,0,77,126
74893,4,124,9,0,0,0,0,16,25
164441,7,56,61,7,1,0,2,102,173
31897,10,617,139,2,0,1,2,246,390
86861,6,800,3,0,0,0,0,4,7
147361,7,842,450,26,14,1,2,702,1195
126846,8,214,938,31,9,1,1,1413,2393
30293,5,728,41,0,0,0,0,54,95
12315,9,483,24,1,1,0,0,64,90
5738,7,216,1324,32,16,1,5,1893,3271
62829,8,622,140,3,2,0,0,227,372
137245,4,658,25,0,0,0,0,41,66
50376,11,306,70,6,0,0,0,85,161
75210,9,489,4,0,0,0,0,4,8
26796,8,214,1253,24,11,2,8,2091,3389
136244,8,214,1317,40,10,1,11,2312,3691
38207,4,306,726,11,6,1,5,1189,1938
33398,7,194,118,2,2,0,0,267,389
40950,11,403,586,31,0,0,0,660,1277
14283,8,489,378,9,7,0,2,632,1028
90161,5,489,499,4,5,1,3,922,1434
53416,5,200,6,0,0,0,0,4,10
74734,7,74,8,0,0,0,0,43,51
109181,8,489,19,0,0,0,1,26,46
117574,9,78,753,16,11,3,2,1315,2100
18840,9,538,126,1,2,0,0,178,307
152564,11,545,140,6,0,0,0,164,310
84356,9,367,131,4,3,0,2,198,338
135662,4,159,621,15,7,0,1,1057,1701
3990,9,538,226,0,0,0,1,443,670
6307,4,36,616,18,6,2,3,1030,1675
1366,4,885,33,0,0,0,0,65,98
108274,7,741,428,6,7,0,2,674,1117
162617,4,885,623,13,7,0,3,1433,2079
31957,4,752,1,0,0,0,0,0,1
43480,6,375,394,0,0,0,1,529,924
119574,4,36,165,5,3,0,2,278,453
113603,7,211,9,0,0,0,0,15,24
87328,9,78,152,3,2,0,2,213,372
37199,7,114,93,4,1,0,1,190,289
10113,7,56,15,0,0,0,0,28,43
94830,6,174,36,0,0,0,0,61,97
109420,6,235,395,0,0,0,0,595,990
67722,6,235,152,0,0,0,1,272,425
28227,7,587,60,1,1,0,0,72,134
167396,5,885,40,0,1,0,1,71,113
64011,5,885,32,0,0,0,0,54,86
384,4,658,891,15,12,0,4,1302,2224
32001,6,235,153,10,7,0,0,342,512
35262,6,296,54,3,0,0,0,82,139
107090,8,489,255,1,1,0,2,368,627
80899,5,893,608,29,10,4,2,993,1646
150531,8,790,228,5,1,0,3,424,661
112081,4,200,47,0,0,0,0,72,119
23842,6,306,260,2,1,0,0,435,698
170446,9,658,238,9,4,2,4,357,614
14786,6,269,6,0,0,0,0,11,17
127804,8,214,1487,26,10,1,8,2791,4323
119437,9,640,873,29,13,1,4,1251,2171
41466,7,587,1001,25,16,6,12,1834,2894
152157,6,453,99,1,1,0,1,184,286
94981,5,218,858,31,18,1,3,1323,2234
140895,4,885,29,0,0,0,0,43,72
115522,6,200,2,0,0,0,0,3,5
134720,9,158,124,10,4,0,2,182,322
139986,9,657,1244,39,21,3,9,2143,3459
83691,5,78,333,10,10,1,2,539,895
56152,9,452,53,0,0,0,0,62,115
38769,5,371,391,11,7,2,2,570,983
34048,4,36,69,0,0,0,0,120,189
18093,6,537,37,1,1,0,0,49,88
69931,6,728,287,7,4,0,2,499,799
136329,6,402,69,0,0,0,0,75,144
106201,9,575,9,0,0,0,0,11,20
37233,7,521,100,1,1,0,0,202,304
51232,8,885,48,0,0,0,0,49,97
48820,10,474,320,0,2,0,3,664,989
168075,7,741,259,8,2,0,2,413,684
32583,4,519,412,18,10,0,3,632,1075
170600,7,489,171,8,5,0,1,283,468
45902,9,427,53,0,0,0,0,155,208
64113,9,427,40,0,0,0,0,71,111
136604,9,427,87,0,0,0,0,679,766
38754,9,489,1733,0,0,0,21,3093,4847
40,9,462,79,2,2,0,0,179,262
18772,9,158,116,0,1,0,0,118,235
126479,9,489,132,0,0,0,0,324,456
98967,8,693,14,0,0,0,0,16,30
135006,9,462,11,0,0,0,0,39,50
156969,4,658,323,9,9,0,1,481,823
48320,5,218,29,0,0,0,0,41,70
41428,8,562,706,7,5,0,3,1107,1828
81725,4,375,500,5,2,2,3,758,1270
13437,9,630,1017,2,1,0,2,2412,3434
11639,7,56,168,5,3,0,0,206,382
75309,6,140,61,0,0,0,0,100,161
141874,6,140,82,2,1,0,0,104,189
121809,5,699,608,15,4,2,3,856,1488
86575,8,214,827,0,1,0,2,1293,2123
139486,9,489,273,5,5,0,2,492,777
122886,9,100,261,3,1,0,1,456,722
165998,7,56,137,2,2,0,0,186,327
84647,7,563,198,1,3,0,2,310,514
126467,9,589,397,19,11,2,1,630,1060
25227,5,4,5358,159,80,6,15,8897,14515
147580,9,100,130,1,0,0,1,191,323
42767,9,302,178,7,2,0,0,271,458
144946,4,36,134,5,4,0,1,239,383
69038,9,306,1192,0,0,0,8,1965,3165
64481,9,462,3,0,0,0,0,6,9
135482,5,306,1249,18,12,1,9,1898,3187
43965,6,447,908,15,13,0,4,1437,2377
126130,9,302,40,3,2,0,0,95,140
65272,4,174,630,8,8,0,3,958,1607
158350,6,232,1,0,0,0,0,1,2
113062,9,100,2,0,0,0,0,3,5
77174,9,100,4,0,0,0,0,21,25
27304,8,83,584,18,6,0,3,1011,1622
109520,9,100,54,0,0,0,0,145,199
143275,4,638,21,0,1,0,0,29,51
77633,8,857,1232,29,5,1,11,2082,3360
66615,7,570,664,10,6,0,3,957,1640
146788,7,842,641,9,3,2,2,817,1474
82685,4,174,26,0,0,0,0,38,64
69052,4,800,1963,25,16,3,13,3104,5124
15233,7,80,52,0,1,0,0,100,153
46575,8,214,656,0,0,0,2,1184,1842
15034,4,890,80,2,1,0,0,124,207
74531,9,302,3,0,0,0,0,12,15
146820,6,165,612,12,9,3,4,1080,1720
3205,8,214,209,0,0,0,0,322,531
136380,4,885,51,0,0,0,0,57,108
89205,4,174,33,0,0,0,0,55,88
56161,9,306,298,0,0,0,1,955,1254
11536,9,306,673,0,0,0,12,1769,2454
70497,10,617,57,0,0,0,0,77,134
169593,9,306,99,0,0,0,0,255,354
139704,9,306,72,0,0,0,1,256,329
87425,9,306,197,0,0,0,2,412,611
125163,9,306,71,0,0,0,0,222,293
121163,10,66,261,7,4,1,0,526,799
144236,10,66,13,0,0,0,0,82,95
95001,10,66,165,2,0,0,1,299,467
89407,10,66,93,2,3,0,1,201,300
168299,10,66,41,0,0,0,0,119,160
16893,9,157,18,0,0,0,0,24,42
36225,6,785,53,1,1,0,0,85,140
164758,8,30,538,10,1,2,2,987,1540
21067,10,200,179,2,2,0,1,238,422
57179,4,159,33,0,0,0,1,54,88
91838,8,800,90,1,0,0,1,170,262
73027,9,630,3134,101,51,4,14,4560,7864
5204,8,623,101,2,2,0,1,153,259
102483,11,214,326,19,0,0,0,321,666
148124,4,638,208,3,3,0,0,338,552
132264,4,752,306,4,4,0,0,389,703
141168,4,581,335,6,3,1,3,541,889
71086,8,30,18,0,0,0,0,4,22
46749,8,306,111,0,0,0,1,158,270
45605,6,269,281,0,0,0,0,431,712
132580,8,214,482,0,0,0,1,701,1184
152221,7,207,228,18,5,1,1,582,835
76052,9,100,833,70,29,7,4,1462,2405
8155,8,800,267,4,2,0,1,424,698
131057,7,374,18,0,0,0,0,26,44
94396,10,790,330,8,3,2,0,582,925
121460,10,790,23,0,0,0,0,94,117
164075,10,790,8,0,0,0,0,100,108
66538,10,790,21,0,0,0,0,86,107
170778,10,790,15,0,0,0,0,95,110
37781,10,355,29,0,0,0,0,36,65
18581,7,489,234,19,5,1,1,361,621
34879,4,453,4,0,0,0,0,9,13
88219,4,453,143,3,1,0,1,283,431
135848,9,469,62,2,0,0,0,201,265
73465,6,165,317,9,7,1,1,431,766
973,5,821,3,0,0,0,0,3,6
109823,5,159,102,0,0,0,0,161,263
52160,5,159,220,3,1,0,0,281,505
121569,10,355,6,0,0,0,0,9,15
83722,9,842,474,1,1,0,1,1184,1661
128361,9,640,343,10,7,1,0,295,656
63217,5,655,1303,28,7,1,5,1894,3238
117270,4,36,186,4,3,0,1,271,465
113201,4,375,3,0,0,0,0,2,5
40160,7,118,406,25,8,4,2,678,1123
73978,7,157,459,16,10,2,1,1042,1530
132416,6,306,550,0,0,0,2,769,1321
99758,9,693,78,3,3,0,1,118,203
159810,6,209,384,17,7,1,3,540,952
157137,8,214,1842,57,28,2,7,2870,4806
89857,5,263,1692,65,25,4,14,2837,4637
83815,4,890,547,19,13,0,1,871,1451
144245,6,235,4699,137,65,9,28,7642,12580
77864,8,214,440,2,1,0,1,667,1111
143649,6,235,629,22,11,0,2,1047,1711
36625,8,489,624,9,3,0,2,1016,1654
134823,7,489,780,5,4,0,2,1332,2123
143059,7,489,283,3,5,0,0,409,700
26206,8,489,399,5,1,0,1,648,1054
131991,6,165,787,32,17,6,2,1114,1958
50690,6,140,65,1,0,1,0,98,165
131670,8,489,111,0,0,0,4,221,336
113737,7,535,695,19,6,3,1,867,1591
36274,8,489,341,2,0,1,2,553,899
52166,7,535,14,0,1,0,0,28,43
75045,7,535,47,1,1,0,0,84,133
15664,8,489,227,0,0,0,0,267,494
65492,7,535,32,0,0,0,2,70,104
98979,7,535,15,0,0,0,0,29,44
37483,8,489,17,0,0,0,0,27,44
127788,8,214,2,0,0,0,0,3,5
160121,7,535,487,7,3,1,1,812,1311
57315,7,535,79,4,1,0,0,236,320
16670,8,489,257,1,1,0,0,433,692
57671,7,535,23,1,1,0,0,39,64
101371,8,489,143,0,0,0,0,230,373
101859,4,36,202,7,2,1,1,221,434
48431,8,489,50,0,0,0,0,75,125
138638,7,535,170,6,3,1,0,426,606
79737,7,535,73,1,0,0,0,113,187
10518,4,519,602,1,1,0,1,849,1454
101574,7,535,738,20,8,0,0,1285,2051
7381,6,489,814,21,13,1,1,1170,2020
52106,7,535,22,0,0,0,0,32,54
1296,4,638,86,2,2,0,0,160,250
78938,4,36,369,9,7,0,1,647,1033
70424,4,890,248,9,3,0,1,412,673
128077,6,427,566,20,10,4,2,919,1521
143063,9,157,40,0,0,0,0,49,89
95108,4,678,103,8,4,0,0,306,421
110965,10,841,78,0,0,0,0,110,188
154132,6,140,518,16,4,0,0,821,1359
6098,7,74,137,4,2,1,1,189,334
33096,9,306,172,0,0,0,1,393,566
20079,9,306,288,0,0,0,4,520,812
62922,9,306,637,0,0,0,1,987,1625
119481,9,306,202,0,0,0,4,569,775
47499,9,489,78,0,3,0,0,126,207
159430,8,812,747,20,10,0,3,1100,1880
81557,10,104,249,13,5,1,1,860,1129
153946,10,104,956,27,10,1,4,1830,2828
65625,10,104,2,0,0,0,0,19,21
82160,8,812,534,8,3,1,2,871,1419
120712,9,489,4246,158,87,11,35,6509,11046
150438,7,157,417,17,8,1,2,927,1372
51249,4,890,1213,32,13,1,11,1922,3192
158887,10,701,67,1,0,0,1,110,179
22612,9,306,506,0,0,0,7,896,1409
36048,4,199,365,8,6,0,3,912,1294
165945,9,100,103,1,0,6,1,157,268
121400,5,427,1557,45,23,4,7,2258,3894
13241,4,923,16,0,0,0,0,23,39
153935,9,367,484,0,0,0,5,736,1225
106420,9,157,92,0,0,0,1,197,290
127658,9,157,58,0,0,0,1,232,291
159947,9,157,1064,19,10,0,1,1730,2824
153568,10,653,150,6,0,0,0,280,436
59125,9,489,254,0,0,0,1,421,676
151049,7,492,8,0,0,0,0,17,25
165004,7,748,130,4,1,1,0,183,319
123370,7,748,735,15,10,2,2,1053,1817
81509,9,741,60,0,0,0,0,83,143
69567,6,235,294,14,3,0,2,609,922
28569,9,78,448,12,6,0,3,662,1131
67800,8,693,293,0,0,0,1,374,668
78892,6,885,722,10,5,0,4,1068,1809
170311,4,306,827,27,10,3,6,1472,2345
160152,5,479,98,0,0,0,0,163,261
79757,9,630,274,4,4,0,3,331,616
142277,7,496,138,1,0,1,1,300,441
44885,7,496,42,0,0,0,0,156,198
98907,9,489,138,0,0,0,1,728,867
140477,8,801,524,6,2,0,2,679,1213
127326,5,200,596,5,3,1,4,732,1341
40696,9,538,415,0,0,0,7,808,1230
63662,8,801,70,1,1,0,1,97,170
116469,5,479,95,0,0,0,0,124,219
61084,6,263,1094,28,11,3,8,1540,2684
139609,9,427,190,0,0,0,2,366,558
32108,8,693,48,0,0,0,0,63,111
96625,6,124,79,1,0,0,0,108,188
50863,4,200,245,1,0,0,1,472,719
115618,4,36,28,0,0,0,0,50,78
63425,6,263,170,1,1,0,2,227,401
153480,8,658,77,0,0,0,0,80,157
114890,9,640,5863,117,60,10,34,10082,16166
167709,4,375,1290,54,24,9,4,2212,3593
60612,9,483,35,0,0,1,0,58,94
57844,6,427,80,1,0,0,0,107,188
109594,8,623,391,16,6,1,0,714,1128
79038,8,623,336,7,3,0,2,563,911
44866,4,800,355,12,7,1,0,466,841
9005,7,484,108,6,3,0,0,154,271
91159,7,367,113,4,1,1,1,264,384
153703,7,521,86,8,1,0,0,154,249
90090,4,174,50,0,0,0,0,75,125
111697,11,214,228,30,0,0,0,196,454
21331,9,640,1187,43,23,2,8,1759,3022
124291,8,623,121,1,0,0,2,224,348
52607,5,444,25,0,1,0,0,37,63
130829,8,812,924,17,10,2,5,1549,2507
31364,9,842,473,11,10,2,2,1250,1748
1558,9,842,408,2,1,0,1,885,1297
115146,9,842,721,0,0,0,11,2278,3010
97902,5,489,620,25,9,0,3,1049,1706
93978,7,844,47,2,1,0,0,52,102
80900,10,256,24,0,0,0,0,54,78
51146,7,587,244,4,2,1,0,376,627
124762,7,56,23,1,3,0,0,30,57
5941,7,56,0,2,3,0,0,16,21
164344,4,658,526,26,4,0,2,919,1477
151036,4,658,366,11,8,0,2,729,1116
40487,5,225,233,1,1,0,1,468,704
107952,10,208,119,3,0,0,1,186,309
44206,7,306,758,8,27,2,1,1045,1841
25754,9,367,1054,66,31,5,4,1642,2802
116318,7,587,7930,220,75,32,40,14937,23234
163258,5,800,65,0,0,0,0,108,173
51165,5,225,92,2,1,0,0,135,230
97901,5,225,107,0,0,0,0,142,249
13784,4,658,81,0,0,0,0,130,211
122242,4,658,320,2,1,0,1,480,804
137399,7,587,143,1,1,0,1,175,321
161824,7,587,108,0,0,0,0,146,254
149900,7,56,13,0,1,0,1,17,32
128963,6,306,224,2,0,0,2,454,682
82046,5,200,160,2,1,0,1,231,395
74798,6,427,1671,56,24,8,8,2803,4570
107198,10,66,8,0,1,0,0,12,21
60514,5,124,354,10,2,0,0,515,881
105090,8,885,263,1,2,0,0,429,695
159397,8,214,1323,47,19,0,5,2249,3643
114144,7,56,54,3,1,0,0,82,140
49243,8,885,143,0,1,0,0,203,347
43112,8,801,556,15,8,1,2,933,1515
80646,8,658,247,1,1,0,0,365,614
118483,7,912,34,0,1,0,0,51,86
15049,7,56,104,2,2,0,2,133,243
27170,9,78,806,32,16,1,0,1311,2166
84517,7,56,22,2,1,0,0,27,52
73094,7,306,465,7,3,0,2,655,1132
40459,7,508,74,2,2,0,0,157,235
86467,7,748,133,2,0,0,0,220,355
163231,4,800,508,14,5,1,2,712,1242
95534,9,379,283,11,6,2,2,441,745
169904,7,56,26,1,0,0,0,38,65
121714,7,56,63,1,0,1,0,89,154
14535,9,469,62,2,1,0,0,144,209
25880,4,800,136,4,3,0,1,178,322
9780,8,658,32,0,0,0,0,54,86
29437,5,78,548,3,2,0,0,797,1350
5787,9,379,58,1,2,0,0,117,178
104927,4,752,299,4,1,0,4,454,762
129733,4,678,148,5,4,0,2,216,375
132184,9,469,1070,15,5,3,6,1443,2542
29243,8,355,603,23,9,0,3,1211,1849
92677,8,562,287,7,4,0,0,429,727
149745,7,587,3203,83,25,10,13,6642,9976
127901,9,469,112,5,2,0,0,184,303
58385,11,306,144,8,0,0,0,153,305
4843,4,306,249,1,1,0,0,378,629
120433,7,693,91,2,1,0,0,100,194
7920,9,469,134,1,0,1,0,213,349
38128,8,427,171,11,1,0,0,248,431
154884,7,118,2,0,0,0,0,2,4
141744,4,675,28,0,0,0,0,49,77
583,7,374,96,2,1,0,1,153,253
102682,9,374,58,0,0,0,1,53,112
33060,4,199,711,14,7,1,4,1574,2311
98261,7,645,24,1,1,0,0,34,60
127931,6,489,3246,116,42,11,24,5016,8455
4933,6,489,53,0,0,0,0,58,111
170505,7,535,15,3,1,0,0,51,70
116732,10,200,116,1,0,0,1,157,275
78457,4,200,194,4,3,0,1,393,595
1678,5,200,224,4,2,0,2,351,583
79966,10,104,0,0,0,0,0,158,158
91675,5,159,791,19,4,1,8,1418,2241
10238,4,800,115,0,1,0,0,200,316
65235,7,563,198,0,0,0,1,342,541
145616,7,563,26,0,0,0,1,80,107
5966,4,519,33,1,1,0,0,116,151
88848,6,821,112,2,1,0,1,184,300
167095,7,527,27,0,1,0,0,47,75
119128,6,821,74,3,2,0,1,140,220
77815,6,821,86,0,0,0,0,122,208
125900,6,821,57,0,0,0,0,89,146
165423,9,100,833,62,25,7,0,1465,2392
112854,4,174,262,6,3,0,1,425,697
74646,5,821,10,0,0,0,1,11,22
42962,5,821,12,0,0,0,0,17,29
5239,8,214,1546,25,9,0,6,2387,3973
44043,7,216,368,10,2,0,1,564,945
162876,6,78,353,2,2,0,2,450,809
152952,9,157,80,0,0,0,0,264,344
86742,7,527,225,34,21,1,1,364,646
155472,9,157,952,31,19,6,4,1679,2691
105926,10,63,88,0,0,0,4,150,242
140661,5,200,108,2,1,0,0,165,276
61749,5,570,114,6,4,0,1,193,318
94734,4,174,114,2,0,1,1,223,341
98327,5,200,246,8,2,0,4,366,626
102794,9,341,489,4,1,0,5,708,1207
22989,4,174,167,0,1,0,1,227,396
127572,5,655,408,12,4,1,3,555,983
140281,7,521,457,16,17,6,1,720,1217
114535,5,885,57,0,0,0,0,77,134
30407,7,78,469,26,15,2,2,781,1295
155490,10,519,267,7,2,0,3,439,718
1671,5,124,53,3,2,0,0,67,125
64915,11,306,432,20,0,0,1,497,950
140163,6,71,103,0,0,0,2,184,289
90083,9,427,106,0,0,0,0,165,271
148977,5,306,112,1,0,0,2,170,285
160511,5,404,153,0,0,0,0,224,377
33559,9,640,95,1,4,0,0,146,246
89376,11,658,78,5,0,1,0,91,175
137129,9,489,2284,71,41,4,11,3395,5806
162649,9,86,26,0,0,0,0,53,79
134906,4,890,506,13,5,0,0,835,1359
120615,6,165,31,0,0,0,0,41,72
125415,7,157,226,1,0,0,3,368,598
58721,4,453,504,2,0,11,0,662,1179
3138,4,890,2144,40,23,0,25,3282,5514
161641,8,623,751,16,2,1,8,1126,1904
132868,9,710,11,0,0,0,0,22,33
70526,7,489,245,4,5,0,0,438,692
144612,7,489,10,0,0,0,0,17,27
79321,6,165,382,1,1,0,7,739,1130
66798,11,489,134,16,0,0,0,139,289
30863,4,174,120,1,0,0,0,238,359
70675,4,519,249,5,2,0,2,443,701
81199,6,269,653,19,21,1,4,1041,1739
25707,9,489,177,1,1,0,0,304,483
82079,9,489,87,2,1,0,1,100,191
157788,9,842,1373,50,29,3,7,2050,3512
45231,5,381,120,2,1,0,0,179,302
78949,8,214,661,23,7,1,4,1080,1776
153683,8,214,199,0,0,0,1,271,471
119108,4,36,315,5,3,0,1,543,867
147377,5,58,83,0,0,0,0,112,195
118605,5,381,97,2,0,0,0,129,228
92322,6,124,224,8,4,0,1,320,557
142010,9,800,291,14,12,1,4,447,769
53884,5,783,82,0,0,0,2,144,228
135752,5,821,210,3,3,0,2,412,630
40268,10,790,258,6,5,2,1,415,687
141230,4,752,364,4,3,0,1,539,911
148149,5,408,616,12,3,0,3,1014,1648
135444,5,4,42,2,2,0,1,51,98
162020,6,124,1991,46,23,2,15,3120,5197
24438,6,124,111,0,1,0,0,136,248
157125,4,800,578,12,2,0,3,925,1520
103652,8,658,35454,1050,302,101,295,57338,94540
81920,7,489,115,0,0,0,0,147,262
124407,10,653,325,4,2,0,1,448,780
164774,8,658,1323,49,19,2,7,2255,3655
8571,8,717,1509,23,12,1,9,2584,4138
132217,4,891,73,2,0,0,0,84,159
95262,4,519,139,9,2,1,0,279,430
52953,5,408,439,19,7,0,2,684,1151
32889,4,678,124,0,0,0,0,255,379
77938,8,885,70,0,0,0,0,76,146
107626,8,800,285,1,2,0,0,364,652
114094,5,489,333,5,4,1,3,510,856
23905,4,519,33,0,0,0,0,125,158
59705,6,232,371,9,7,0,6,631,1024
25727,10,81,25,0,0,0,0,42,67
152115,9,800,128,8,3,1,0,198,338
110646,10,29,19,0,0,0,0,19,38
121392,4,658,523,17,6,0,2,755,1303
7327,4,375,173,0,1,0,0,213,387
107565,10,81,14,0,0,0,0,21,35
19407,9,842,682,0,0,0,1,1978,2661
37481,5,4,28,0,0,0,0,76,104
101152,10,81,12,0,0,0,0,26,38
73191,4,800,75,2,1,0,0,108,186
69707,8,885,781,11,3,1,5,1274,2075
31327,10,81,18,0,0,0,0,29,47
30954,10,474,288,5,0,0,2,505,800
153150,6,232,292,13,7,1,4,497,814
35620,10,355,20,1,1,0,0,39,61
29764,4,800,112,0,1,0,0,171,284
15821,6,261,1536,46,27,9,7,3029,4654
163774,8,355,1495,26,14,1,1,2523,4060
72009,6,132,20,0,0,0,0,22,42
12528,10,63,110,2,2,0,1,156,271
146384,8,623,1354,19,4,2,7,2127,3513
123295,7,80,60,1,1,0,0,116,178
127282,7,489,459,12,8,0,0,793,1272
170570,9,78,327,14,7,0,1,469,818
125110,8,30,2519,109,39,9,10,3999,6685
111741,8,562,800,10,1,0,4,1319,2134
16573,10,817,44,1,1,0,0,69,115
148064,4,658,33,0,0,0,0,42,75
46339,10,105,0,0,0,0,0,45,45
47955,8,812,1097,16,8,0,5,1618,2744
138940,6,263,260,0,0,0,2,321,583
43713,4,519,24,1,0,0,0,22,47
130287,4,375,30,0,0,0,0,43,73
139312,8,214,209,0,0,0,0,307,516
86662,8,214,666,3,3,0,2,991,1665
136834,8,489,252,3,3,0,1,426,685
133632,5,218,186,4,4,1,1,272,468
82005,10,617,253,5,2,0,1,350,611
39294,8,562,832,12,7,0,3,1321,2175
107293,8,623,292,2,1,0,1,528,824
156042,8,623,79,2,0,0,0,180,261
157686,9,597,402,10,4,2,4,596,1018
111711,8,800,27,2,0,0,0,30,59
90844,9,842,1963,50,30,4,14,2857,4918
148259,4,800,60,2,2,0,0,92,156
140733,9,157,83,0,0,0,1,142,226
69757,8,812,561,9,2,0,2,823,1397
92921,9,741,151,2,2,0,2,272,429
15243,4,752,387,7,3,0,2,547,946
129362,6,200,371,6,4,0,0,524,905
35469,9,489,572,0,0,0,6,1435,2013
170547,6,306,2671,62,33,4,18,4133,6921
58177,9,842,1839,34,11,4,11,2472,4371
68761,8,562,320,7,2,0,2,485,816
71553,8,562,486,10,3,0,3,792,1294
133309,4,375,26,0,0,0,0,41,67
12881,8,214,206,0,0,0,0,349,555
124792,4,200,523,5,7,0,0,818,1353
5774,9,489,716,22,20,2,2,1113,1875
3930,6,232,2633,151,50,24,18,4359,7235
11018,8,812,95,0,0,0,1,119,215
112930,9,78,1279,65,31,2,5,1985,3367
33942,4,678,1785,62,31,2,6,3034,4920
113230,6,404,330,0,0,0,1,542,873
45166,8,211,44,1,0,0,0,59,104
101189,6,117,245,0,2,0,1,482,730
83447,8,812,1048,27,20,1,9,1898,3003
58434,8,214,170,0,0,0,1,281,452
109512,5,118,160,4,4,1,0,283,452
56067,9,78,1,0,0,0,0,0,1
38459,8,885,702,20,10,0,3,1176,1911
42108,8,596,1673,62,21,3,8,2627,4394
10089,8,596,2311,90,29,1,16,3805,6252
116333,10,355,39,2,1,1,0,73,116
115191,8,403,258,5,3,0,1,397,664
68966,8,124,161,13,0,0,3,266,443
55392,6,658,155,6,3,0,3,223,390
70895,4,885,1159,3,2,0,7,1848,3019
96704,10,617,263,11,3,0,2,389,668
54498,8,214,238,0,0,0,0,423,661
101973,4,200,62,1,1,0,1,106,171
45410,4,596,274,2,0,1,1,414,692
72864,7,194,23,2,0,0,0,71,96
86073,8,489,2,0,0,0,0,0,2
96022,11,489,1,0,0,0,0,0,1
57211,9,157,73,5,2,0,0,104,184
148334,8,885,252,0,1,0,1,402,656
138718,5,885,186,4,0,0,1,259,450
142214,10,617,91,2,2,0,0,124,219
60965,7,521,17,0,0,0,0,29,46
67656,7,741,719,23,7,3,6,1454,2212
63898,9,842,88,0,0,0,0,322,410
120909,8,545,145,3,0,0,0,191,339
157586,8,717,118,2,1,1,2,206,330
105064,8,214,1453,39,16,1,6,2563,4078
40309,9,489,291,9,5,1,2,476,784
72469,8,800,202,2,0,0,4,286,494
21921,9,640,2217,69,36,5,11,3375,5713
45986,7,575,35,1,0,0,0,33,69
39529,7,648,39,2,0,0,1,101,143
19585,7,648,176,11,4,2,0,410,603
43210,7,648,47,1,2,0,2,143,195
24327,7,648,23,4,1,0,0,82,110
28331,4,658,285,10,8,0,3,548,854
164395,9,640,817,0,0,0,5,1013,1835
71500,9,341,6,0,0,0,0,9,15
9145,5,4,20,0,0,0,0,17,37
98173,7,587,196,0,0,0,1,249,446
131651,5,570,76,2,2,0,0,119,199
76003,9,341,2135,26,11,0,11,2951,5134
5297,7,587,363,9,4,0,1,499,876
131818,9,78,2492,60,32,11,13,3398,6006
129801,8,214,228,1,1,1,1,493,725
80494,8,214,923,6,2,0,1,1533,2465
155659,5,570,31,2,1,0,0,64,98
117537,7,587,434,20,10,1,0,621,1086
3449,8,693,62,0,0,0,0,107,169
68495,10,40,75,2,1,0,0,129,207
163713,6,821,84,4,3,0,3,138,232
96660,5,225,167,6,2,0,2,246,423
154648,5,225,78,1,0,1,0,147,227
110431,7,587,294,10,5,1,4,415,729
16876,5,225,984,20,7,0,7,1382,2400
148174,4,923,246,9,1,2,1,435,694
50502,5,885,776,58,21,5,8,1235,2103
38701,6,165,297,2,3,0,2,608,912
15746,8,885,41,0,0,0,0,46,87
81472,7,587,45,1,1,0,1,66,114
150231,7,587,23,0,0,0,0,35,58
54378,4,174,22,0,0,0,0,40,62
11285,7,214,758,16,10,0,3,1075,1862
63336,4,658,187,4,2,0,1,291,485
45876,8,812,228,3,5,0,3,345,584
159166,8,545,3199,93,35,8,9,5016,8360
36640,7,429,2,0,0,0,0,3,5
32545,4,453,730,12,10,1,2,1152,1907
48272,8,306,45,0,0,0,0,63,108
107418,7,226,31,1,1,0,0,59,92
76889,4,885,182,8,3,0,2,375,570
93270,10,474,381,7,3,0,1,672,1064
101141,7,429,5309,74,34,5,27,5988,11437
10191,9,741,442,0,0,0,1,965,1408
135956,4,890,51,0,0,0,0,65,116
94001,9,367,555,0,0,0,2,936,1493
148692,9,367,51,0,0,0,0,90,141
19483,9,367,86,0,0,0,1,191,278
152433,9,489,1337,1,0,0,10,2850,4198
150162,5,78,299,0,1,0,1,539,840
28339,8,623,1,0,0,0,0,2,3
145974,8,214,537,0,0,0,2,724,1263
92010,4,36,278,6,4,0,1,448,737
170870,8,800,2547,91,41,5,16,3606,6306
378,10,752,522,24,8,0,8,1191,1753
113203,9,489,140,2,2,0,0,382,526
53320,9,842,51,1,0,0,0,78,130
154251,7,157,13,3,0,0,0,17,33
158280,9,489,208,1,0,0,0,452,661
96851,9,489,281,1,0,0,6,898,1186
157946,7,737,60,0,0,0,1,82,143
145087,10,752,206,8,2,0,1,787,1004
52032,7,429,272,13,2,4,1,455,747
16072,7,587,884,23,18,1,3,1485,2414
1347,11,545,31,1,0,0,0,31,63
95896,11,545,800,43,0,0,0,847,1690
97966,8,489,741,8,3,0,7,1313,2072
74327,9,452,7,0,0,0,0,9,16
98472,7,587,73,0,0,0,1,103,177
159739,5,699,20,1,1,0,1,40,63
46208,4,174,583,8,3,0,0,912,1506
65998,9,842,1722,42,28,4,10,2521,4327
67977,5,570,163,9,6,1,1,291,471
78274,9,302,193,11,7,1,3,364,579
119419,7,693,20,0,0,0,0,32,52
65572,9,302,589,14,8,1,5,973,1590
17573,9,842,3,0,0,0,0,2,5
108617,7,587,103,0,0,0,0,135,238
78965,7,587,101,4,1,0,1,186,293
17479,6,514,57,1,0,0,0,94,152
26858,7,587,410,16,7,1,3,549,986
135055,6,514,7,0,0,0,0,13,20
36382,10,777,84,1,0,0,0,123,208
39323,6,251,20,0,0,0,0,44,64
93337,7,314,62,0,0,0,0,120,182
101018,7,285,32,0,0,0,0,46,78
3813,8,489,50,0,0,0,0,63,113
15141,6,124,1401,38,29,0,13,2278,3759
170822,6,106,90,4,3,0,2,159,258
126312,9,630,772,32,15,2,3,1037,1861
152802,7,285,27,0,0,0,0,30,57
49047,7,570,138,0,0,0,0,201,339
100258,6,296,131,1,2,0,2,231,367
161995,7,527,108,4,4,0,1,166,283
22157,5,479,578,25,6,2,2,861,1474
46835,8,812,1052,32,13,0,8,1486,2591
31596,9,842,159,4,4,1,3,290,461
8241,6,124,462,10,4,0,4,701,1181
171060,4,200,83,1,2,0,0,111,197
107304,9,842,62,0,1,0,1,131,195
83606,4,800,514,10,7,0,2,744,1277
62371,8,306,397,0,0,0,3,566,966
11710,8,214,103,0,0,0,1,189,293
6183,5,489,202,4,3,0,2,352,563
168198,6,269,243,8,4,0,3,369,627
64929,9,489,404,0,0,0,2,1205,1611
113334,9,640,252,3,0,0,0,351,606
9198,6,296,128,6,1,0,0,291,426
151071,6,296,26,0,0,0,0,70,96
36549,6,296,36,0,0,0,0,80,116
3412,4,174,125,0,0,0,1,188,314
28898,5,693,890,23,13,2,3,1414,2345
99432,5,821,2662,28,16,1,17,3634,6358
101991,7,175,36,3,2,0,0,90,131
73818,8,403,343,8,5,0,7,569,932
53677,10,701,93,0,0,0,0,122,215
32738,5,570,44,0,0,0,0,64,108
139883,4,174,963,33,15,1,3,1540,2555
116120,4,800,70,0,0,0,0,107,177
152791,5,58,375,12,8,0,1,569,965
70561,8,214,162,0,0,0,0,245,407
76201,8,214,982,3,3,0,4,1283,2275
51461,11,214,32,1,0,0,0,45,78
68079,10,474,228,2,2,0,1,512,745
140397,6,728,130,5,8,1,1,221,366
63102,7,861,75,0,0,0,1,134,210
85689,8,214,2992,32,12,1,10,4524,7571
57070,6,165,99,4,2,1,1,208,315
80024,9,842,93,3,1,0,0,129,226
10748,7,496,673,10,5,1,0,1130,1819
41909,4,200,434,4,2,0,0,573,1013
100222,6,489,516,1,0,0,2,791,1310
96129,5,655,799,16,9,0,6,1222,2052
55190,4,658,243,0,1,0,0,370,614
60161,6,124,66,0,0,0,0,111,177
66144,6,235,322,5,5,0,0,497,829
32644,4,36,388,7,6,0,2,594,997
90004,4,36,804,19,9,1,3,1345,2181
134526,5,408,387,16,7,0,1,641,1052
4386,10,841,193,6,2,0,2,290,493
103639,9,302,19,0,0,0,0,96,115
26738,5,118,503,9,6,2,3,863,1386
57062,8,214,388,0,0,0,0,557,945
99189,10,36,854,14,2,0,4,1326,2200
20878,8,545,2170,94,38,3,12,3409,5726
141820,6,235,1567,35,24,2,3,2473,4104
115025,10,172,192,3,3,0,1,298,497
40178,7,587,57,2,1,0,0,76,136
166340,6,269,197,2,1,0,0,328,528
79097,10,617,89,1,0,0,0,140,230
119903,6,263,2557,108,43,0,9,3815,6532
46728,5,159,256,2,1,0,2,428,689
139716,11,677,48,1,0,0,0,67,116
18116,4,200,1042,28,17,1,5,1458,2551
21150,8,214,645,3,0,0,3,926,1577
61219,5,118,181,9,4,0,0,268,462
54672,5,479,433,0,0,0,0,661,1094
28021,6,124,80,1,1,0,0,135,217
166455,8,545,210,3,0,0,1,328,542
96463,10,355,0,0,0,0,0,207,207
11941,8,800,247,0,0,0,1,455,703
120756,9,483,30,0,0,0,0,64,94
147157,9,560,8,0,0,0,0,13,21
130270,9,483,24,5,1,0,0,82,112
94457,10,355,247,1,1,1,0,271,521
152896,9,175,206,15,5,1,1,394,622
127259,5,124,658,15,6,0,4,990,1673
13083,5,78,252,4,2,0,2,394,654
127773,6,124,689,17,7,0,8,1136,1857
163253,5,124,285,6,5,0,0,363,659
160601,6,124,323,14,7,0,3,500,847
20454,5,225,245,6,4,0,4,370,629
92546,8,214,302,0,0,0,0,480,782
67119,4,174,21,0,0,0,0,26,47
104914,5,124,261,9,4,0,3,404,681
35548,5,106,7,0,0,0,0,7,14
33806,10,355,20,1,0,0,0,39,60
29359,4,581,155,0,1,0,0,269,425
10469,10,111,44,1,1,0,2,68,116
119000,7,842,398,4,0,0,0,524,926
26701,9,42,25,0,0,0,0,72,97
140857,5,225,119,4,4,0,0,150,277
135189,10,355,4,0,0,0,0,6,10
51142,4,174,35,0,0,0,0,57,92
42487,10,797,198,2,4,0,1,351,556
76898,5,176,98,2,1,0,0,120,221
111640,4,200,140,0,0,0,1,205,346
10253,8,214,26,0,0,0,1,47,74
102546,5,355,131,1,1,0,0,208,341
91877,8,214,689,0,0,0,3,1042,1734
119592,5,225,29,0,0,0,0,39,68
57321,7,216,687,6,4,0,5,1224,1926
95428,6,124,14,0,0,0,0,37,51
77734,4,885,520,3,0,0,4,854,1381
34779,8,489,1,0,0,0,0,0,1
79825,9,640,106,3,3,0,1,166,279
104654,5,570,450,9,8,2,4,668,1141
11369,9,100,162,3,1,1,0,253,420
117600,4,482,69,0,0,0,0,118,187
54252,9,842,229,2,0,0,0,475,706
8880,8,800,146,4,1,1,0,185,337
127715,6,643,29,0,0,0,0,32,61
125185,8,812,218,2,1,0,1,377,599
2977,4,200,715,23,12,2,3,962,1717
113274,6,269,85,0,0,0,0,139,224
167597,5,176,15,0,0,1,0,26,42
48648,8,800,261,15,9,0,0,379,664
7950,9,78,472,0,0,0,6,694,1172
153662,6,124,1947,65,24,6,12,3382,5436
19113,8,403,161,2,2,0,1,247,413
101642,8,545,170,4,1,1,0,375,551
115790,6,269,46,0,0,0,0,81,127
100481,6,124,198,6,2,0,0,328,534
14066,8,812,548,4,2,0,2,857,1413
139950,8,812,89,2,1,0,0,122,214
31987,8,214,195,7,2,0,3,268,475
56135,8,214,65,0,0,0,0,82,147
29705,5,225,334,3,3,0,1,498,839
1528,5,225,279,4,2,0,0,439,724
9590,6,124,27,0,0,0,0,38,65
95527,5,124,160,7,3,0,0,269,439
68967,4,375,88,0,0,0,0,114,202
96832,5,699,9,0,0,0,0,11,20
51324,8,214,44,0,0,0,0,50,94
48645,8,489,253,4,1,0,0,389,647
78035,4,678,853,21,10,2,4,1565,2455
150107,8,800,132,2,1,0,0,215,350
152042,8,812,1043,39,9,2,6,1615,2714
147482,9,842,361,12,9,0,1,606,989
76278,4,453,476,12,6,0,5,767,1266
48753,5,655,669,20,8,0,2,1049,1748
113256,5,371,408,18,11,4,0,617,1058
55795,4,752,234,1,1,0,3,327,566
167055,7,194,167,2,2,0,0,255,426
5599,8,812,137,2,1,0,1,220,361
48483,8,800,59,1,1,0,0,75,136
159330,5,263,138,0,0,0,0,215,353
32168,9,693,41,0,0,0,1,56,98
95044,8,800,272,9,3,1,2,465,752
20297,7,79,443,13,4,2,0,656,1118
21356,6,200,235,2,1,0,2,307,547
84215,6,261,775,5,4,0,1,1265,2050
97964,7,56,142,9,2,2,0,216,371
55860,6,124,217,1,1,0,0,309,528
116090,8,214,688,12,7,1,7,1206,1921
131989,7,527,42,0,0,0,0,68,110
122302,4,36,353,9,4,0,3,545,914
59046,6,200,311,5,2,0,1,446,765
167977,10,781,2,0,0,0,0,0,2
149016,5,800,829,29,15,4,0,1123,2000
105194,4,678,138,2,2,0,1,298,441
86460,11,545,296,8,0,0,3,316,623
105958,4,222,380,11,5,1,2,612,1011
49445,7,570,73,0,0,0,0,119,192
115481,10,63,1250,58,22,5,5,1942,3282
156713,7,492,178,9,7,0,1,276,471
89419,9,842,26,0,0,0,0,25,51
58296,7,391,835,18,7,0,4,1278,2142
159543,4,375,51,0,0,0,0,64,115
107207,4,375,105,0,0,0,1,160,266
108673,5,570,192,7,4,1,0,315,519
55697,9,367,756,20,14,3,6,1278,2077
119522,4,453,294,9,6,0,2,542,853
88318,11,214,234,1,0,0,0,254,489
99566,7,373,258,1,0,0,1,404,664
154690,5,489,842,7,5,1,7,1175,2037
53538,7,527,27,0,0,0,0,29,56
74775,9,367,281,0,0,0,0,539,820
104091,7,484,69,0,0,0,0,109,178
54266,10,355,0,0,0,0,0,43,43
121004,7,527,29,0,0,0,0,38,67
25361,7,527,5,0,0,0,0,7,12
125352,9,842,4,0,0,0,0,5,9
48997,7,194,204,9,3,1,0,363,580
29643,9,78,102,4,5,0,1,153,265
4412,10,752,341,4,2,0,4,855,1206
15283,5,293,36,1,0,1,0,80,118
168119,5,821,718,10,3,1,6,1143,1881
63740,4,678,256,0,1,0,0,408,665
78108,5,124,436,9,4,0,4,747,1200
4877,5,479,356,17,1,7,1,551,933
103071,5,66,33,1,1,0,1,50,86
150646,9,302,217,4,6,0,0,320,547
117877,4,200,140,1,0,0,1,193,335
103434,7,118,402,12,6,3,6,625,1054
119954,6,200,1211,7,7,0,6,1674,2905
46516,7,741,280,6,3,0,1,405,695
119321,8,214,449,8,3,1,2,863,1326
68485,6,200,1116,18,7,0,4,1641,2786
46510,7,521,94,8,1,0,0,150,253
153941,7,508,5,0,0,0,0,9,14
104285,9,489,409,0,0,0,4,810,1223
56343,9,489,124,0,0,0,0,425,549
120841,10,200,288,8,5,0,1,425,727
107378,7,693,40,1,1,0,0,71,113
84254,8,658,371,12,0,0,2,557,942
129965,4,200,70,0,0,0,0,103,173
65767,4,453,14,0,0,0,0,28,42
114564,11,306,40,2,0,0,0,47,89
50844,11,489,179,7,0,0,0,193,379
164542,7,74,514,11,7,0,1,939,1472
8261,4,174,155,1,0,0,0,229,385
168982,8,623,204,4,2,0,3,413,626
128432,7,741,261,1,0,1,0,363,626
106274,4,658,103,3,2,0,0,142,250
160330,9,630,430,14,10,0,1,665,1120
94825,10,66,69,0,0,0,0,89,158
73383,6,78,665,10,7,0,2,1080,1764
96590,6,643,147,0,1,0,0,209,357
70804,4,885,252,4,2,0,1,272,531
138184,7,306,1307,0,0,0,10,1849,3166
170959,8,214,1460,43,15,1,6,2281,3806
150643,9,640,165,3,7,1,2,274,452
21657,11,214,18,1,0,0,0,27,46
16489,8,214,30,0,0,0,0,59,89
34881,9,374,832,26,10,4,2,1293,2167
80766,9,374,57,3,1,0,2,137,200
148523,9,374,186,11,2,2,0,405,606
77169,4,800,254,2,1,0,3,397,657
14810,9,462,417,12,8,3,0,583,1023
156054,6,922,102,2,2,0,1,173,280
7490,9,302,415,15,8,1,3,668,1110
93144,4,200,886,26,17,1,3,1371,2304
11863,9,374,403,12,5,4,0,704,1128
7095,4,200,697,14,4,1,2,1038,1756
112512,7,484,51,0,0,0,0,70,121
78471,6,885,347,13,6,0,2,574,942
119341,7,427,60,1,1,0,0,115,177
55339,8,623,116,0,0,0,0,118,234
149049,10,790,112,2,0,2,0,173,289
113072,4,36,137,5,3,0,1,236,382
16031,6,209,232,10,6,0,0,350,598
98420,9,640,469,31,12,0,0,703,1215
142997,7,861,217,2,3,0,1,364,587
125874,5,371,35,1,1,0,0,65,102
80461,5,371,360,8,8,0,3,566,945
70167,4,638,569,15,11,0,2,925,1522
48824,4,200,337,3,2,0,2,554,898
120930,10,709,774,4,3,1,4,1242,2028
5256,8,427,54,1,1,0,0,111,167
25933,10,701,61,4,1,0,0,129,195
169838,9,597,78,6,4,0,0,111,199
4263,4,36,354,7,4,0,1,689,1055
26006,4,36,575,4,3,0,1,972,1555
30642,4,453,650,13,9,0,3,1142,1817
141310,7,496,197,0,0,0,0,358,555
127356,7,521,511,13,4,3,1,654,1186
2133,7,74,312,5,3,0,1,479,800
41315,6,366,244,9,2,0,0,371,626
9339,10,653,32,1,1,0,0,85,119
119032,10,653,35,0,0,0,0,105,140
19231,4,36,265,0,0,0,1,923,1189
94995,9,302,352,19,8,2,0,774,1155
127460,6,124,98,1,1,0,0,127,227
62327,9,630,1217,0,0,0,11,2228,3456
158685,9,302,70,1,1,0,0,82,154
70353,8,885,1094,29,13,2,11,1898,3047
35536,8,403,49,0,0,0,0,59,108
76494,4,891,53,5,0,0,0,176,234
78376,6,124,44,1,1,0,0,55,101
82203,7,263,42,0,0,0,0,52,94
111628,9,640,1301,38,12,2,9,1913,3275
6494,8,885,56,0,0,0,0,72,128
97058,9,589,13,0,1,0,0,33,47
12909,7,263,13,0,0,0,0,18,31
148488,9,374,141,5,1,3,0,283,433
19981,9,374,157,2,1,0,0,247,407
11476,8,800,39,0,0,0,0,50,89
68686,4,375,503,13,8,2,1,762,1289
6225,9,630,361,19,10,0,1,499,890
47883,6,165,639,30,18,3,1,922,1613
18113,10,841,139,7,2,0,3,219,370
72144,5,58,280,6,4,1,1,475,767
7998,5,570,48,1,1,0,0,62,112
35557,5,238,277,9,3,1,2,519,811
62288,6,416,302,9,9,0,1,467,788
87190,10,841,168,5,3,0,0,315,491
64040,4,200,275,6,4,1,0,384,670
25126,4,270,179,6,5,0,0,253,443
7728,9,630,345,11,11,0,1,426,794
17873,10,653,74,8,5,0,0,155,242
165122,8,800,171,5,2,0,2,276,456
84293,10,653,72,0,0,0,1,174,247
146450,9,640,89,3,3,0,1,128,224
82988,9,80,33,1,0,0,0,43,77
96570,5,427,486,14,10,1,3,891,1405
9383,6,658,450,29,19,2,2,960,1462
154824,6,165,556,19,9,1,3,800,1388
61517,8,800,173,1,1,0,1,227,403
71936,4,427,159,8,5,0,1,235,408
31932,7,404,287,0,0,0,0,402,689
69586,8,489,1174,12,7,0,7,1947,3147
46509,10,841,95,1,1,0,0,134,231
10427,9,640,65,1,0,0,0,89,155
42196,5,489,496,16,13,2,2,758,1287
124507,8,214,456,6,4,0,3,887,1356
120686,6,585,707,35,20,4,7,1229,2002
27029,4,36,259,5,0,0,1,383,648
7390,8,812,87,0,0,0,1,114,202
143251,10,841,188,4,3,0,0,253,448
107721,10,841,85,5,4,0,3,201,298
100768,9,570,149,0,0,0,0,317,466
75836,8,545,3903,162,70,17,24,6719,10895
22741,4,375,45,0,1,0,0,61,107
81786,7,118,11,0,0,0,0,19,30
46344,4,375,29,1,1,0,1,36,68
95766,5,570,294,10,1,0,2,499,806
123297,5,570,31,2,2,0,0,70,105
148756,6,78,5,0,0,0,0,6,11
91263,11,885,456,34,0,1,0,469,960
72118,4,752,103,3,3,0,1,174,284
36768,6,263,788,0,0,0,7,1064,1859
138013,9,100,554,11,10,1,4,741,1321
110047,6,200,381,4,6,0,3,572,966
52917,7,587,406,0,0,0,2,558,966
14435,6,78,167,1,1,0,1,204,374
49150,4,200,55,0,0,0,1,84,140
16718,7,489,162,8,3,0,0,288,461
28332,6,78,518,8,4,0,4,710,1244
17956,9,556,4,0,0,0,0,9,13
16756,9,556,29,2,1,0,0,43,75
25090,5,655,136,3,2,0,1,207,349
97179,9,375,229,3,3,0,2,389,626
131859,4,388,110,0,0,0,0,164,274
153191,10,36,61,0,0,0,2,299,362
131915,5,159,29,0,0,0,0,41,70
37531,6,78,382,5,1,0,1,553,942
41607,7,24,344,10,4,1,5,498,862
108378,9,741,213,0,0,0,1,602,816
127152,5,106,2179,64,29,8,11,3130,5421
42284,10,709,972,10,11,0,5,1354,2352
18429,5,218,37,0,0,0,0,53,90
131278,6,263,1393,37,19,0,9,2266,3724
32377,5,159,1483,48,9,3,14,2276,3833
37728,5,159,162,3,2,1,1,258,427
140268,5,561,178,0,0,0,0,379,557
97246,8,812,741,26,10,0,6,1094,1877
160895,6,366,137,3,1,0,0,182,323
124518,4,174,34,1,0,0,0,50,85
142995,9,589,189,4,1,1,0,327,522
82031,9,640,3471,94,56,2,7,5176,8806
150314,8,812,319,15,6,2,7,405,754
123064,5,218,472,10,5,0,3,680,1170
170936,10,797,72,1,0,0,0,133,206
45057,8,622,159,1,1,0,0,258,419
68567,7,589,91,1,1,0,0,141,234
39362,4,890,420,10,6,0,0,667,1103
58868,8,622,106,0,0,0,1,137,244
160490,9,630,210,1,1,0,2,279,493
115376,9,630,400,0,0,0,1,1409,1810
112692,9,630,292,7,4,1,1,398,703
148322,5,200,360,16,1,1,3,429,810
97496,5,200,170,14,3,0,0,205,392
125667,10,797,55,4,1,0,1,78,139
61469,8,489,435,10,5,0,2,717,1169
83993,9,374,71,1,1,0,1,106,180
155147,4,519,153,4,1,0,0,294,452
133012,6,200,186,2,3,0,1,272,464
28422,4,270,11,0,0,0,0,34,45
79400,4,200,174,2,3,0,0,295,474
58712,8,489,21,0,0,0,0,31,52
27171,8,489,114,0,0,0,0,203,317
3528,8,812,47,2,1,0,0,76,126
168288,8,489,36,0,0,0,0,45,81
115753,8,489,391,6,0,0,1,625,1023
22435,5,655,90,0,0,0,2,111,203
147814,8,622,176,1,0,0,0,344,521
4317,8,885,54,2,0,0,0,84,140
131619,8,885,644,10,5,0,3,997,1659
96838,8,214,385,2,1,0,2,788,1178
109928,7,56,156,5,0,2,2,232,397
57728,7,648,123,6,5,0,0,201,335
76795,4,115,81,1,0,0,0,111,193
148633,8,800,322,7,5,0,3,500,837
125400,9,489,617,13,8,0,2,941,1581
90957,8,800,245,7,0,0,0,361,613
51230,7,645,19,1,0,0,0,31,51
114086,8,622,90,1,1,0,2,188,282
110931,10,841,30,1,0,0,0,38,69
22596,6,124,85,0,0,0,2,143,230
139464,10,474,43,1,0,0,0,353,397
63977,4,375,204,1,0,0,0,324,529
20461,4,569,24,3,0,0,0,32,59
36317,9,607,260,9,4,1,2,463,739
46145,5,118,1575,37,19,3,11,2550,4195
109087,8,800,312,8,5,1,2,379,707
129497,5,159,415,14,3,0,2,667,1101
34496,9,489,94,0,0,0,3,245,342
20496,9,489,397,0,0,0,3,719,1119
60388,6,124,892,32,10,1,11,1349,2295
24736,7,484,25,2,2,0,0,72,101
92111,10,799,19,0,0,0,0,21,40
40313,6,124,270,2,2,0,1,317,592
160044,11,214,232,17,0,0,0,263,512
133865,6,269,408,7,4,0,2,612,1033
136924,10,66,48,0,0,0,0,68,116
13845,8,214,911,7,5,0,4,1456,2383
141326,9,630,839,30,19,2,5,1295,2190
119444,7,741,1052,31,14,2,8,1789,2896
22315,4,885,44,0,0,0,1,51,96
130229,9,489,134,2,2,0,3,154,295
50150,4,890,198,2,1,0,0,254,455
164198,7,587,244,0,0,0,3,305,552
128737,6,269,125,1,1,0,0,219,346
120288,4,658,142,4,4,0,1,304,455
51672,4,581,169,0,0,0,1,315,485
64794,8,30,2787,89,41,7,24,4739,7687
132158,9,86,468,13,9,1,2,753,1246
16427,8,885,781,13,4,0,1,1044,1843
117013,8,885,838,8,6,0,2,1271,2125
167266,4,174,592,2,7,0,2,862,1465
5940,8,623,1298,17,6,1,6,1770,3098
24314,8,717,266,3,0,0,0,395,664
58391,8,885,340,3,2,0,1,482,828
165022,4,159,23,0,0,0,0,27,50
117895,9,741,14,2,1,0,0,26,43
100703,6,306,384,2,1,0,0,601,988
103440,8,214,11,0,0,0,0,16,27
7662,11,545,43,4,0,0,0,38,85
140558,8,214,737,3,0,0,1,1122,1863
17500,5,263,150,0,0,0,0,210,360
135522,4,800,77,0,0,0,0,104,181
113338,7,263,63,2,1,0,1,58,125
89254,4,200,858,10,6,0,2,1317,2193
97123,7,74,97,3,1,1,2,197,301
168628,6,165,110,5,1,0,0,185,301
101317,9,487,270,16,7,2,0,414,709
5980,9,741,194,7,8,0,2,315,526
33245,7,263,60,2,0,0,0,54,116
162859,7,484,93,1,3,0,1,146,244
143989,7,312,4,0,0,0,1,8,13
167414,7,157,701,26,12,2,2,1403,2146
105687,7,844,11,0,0,0,0,20,31
83708,9,630,274,0,0,0,4,574,852
56369,8,214,462,12,6,0,6,706,1192
106710,7,56,71,1,1,0,0,91,164
14294,8,214,1285,32,9,0,9,1633,2968
84695,7,144,84,1,0,0,0,107,192
150013,7,306,282,0,0,0,1,475,758
19961,7,516,464,10,4,0,2,792,1272
22703,4,427,188,6,6,0,0,355,555
63073,6,489,90,1,1,0,1,130,223
18301,9,489,197,2,0,0,2,311,512
29888,8,766,95,0,0,0,0,121,216
132917,10,200,77,0,0,0,0,114,191
28759,10,200,71,2,2,0,0,97,172
92512,7,741,112,0,0,0,0,193,305
132518,7,563,96,0,2,0,0,122,220
153042,7,563,18,0,1,0,0,31,50
126284,7,79,13,0,0,0,0,47,60
10774,9,469,286,4,4,0,3,552,849
150894,7,79,24,0,0,0,0,54,78
15368,7,527,8,0,0,0,0,15,23
44212,6,800,307,8,6,1,4,531,857
138124,11,658,129,2,0,0,0,144,275
62150,7,79,54,0,0,0,0,99,153
127478,4,519,54,0,0,0,0,150,204
12928,8,214,91,0,0,0,0,108,199
97819,4,519,7,0,0,0,0,49,56
19898,4,159,480,22,8,0,5,802,1317
6260,4,519,5,0,0,0,0,66,71
119824,8,800,128,4,3,0,1,214,350
139248,6,78,2,0,0,0,0,4,6
8391,6,431,188,7,5,0,0,369,569
26054,7,710,75,1,2,0,0,118,196
170699,6,570,1879,52,20,7,6,3304,5268
29164,8,484,2,0,0,0,0,3,5
46434,11,693,89,7,0,0,0,86,182
7877,6,570,1111,25,10,2,6,1598,2752
91362,6,59,381,12,8,1,1,589,992
67989,6,218,22,0,0,0,0,19,41
30218,6,301,1490,36,18,2,3,2309,3858
91136,6,263,47,0,0,0,0,78,125
65417,5,181,28,1,0,0,0,32,61
169203,4,453,254,4,1,0,1,374,634
20671,7,24,513,11,4,2,2,848,1380
108741,9,800,77,2,2,0,2,188,271
168786,9,469,163,5,1,2,0,281,452
166730,9,158,200,11,7,0,2,475,695
78187,4,200,73,2,2,0,0,92,169
66104,4,200,316,6,2,0,0,500,824
152383,5,209,17,0,0,0,0,19,36
158453,10,66,20,3,0,0,0,76,99
156594,10,66,5,0,0,0,0,39,44
72447,10,66,90,2,2,0,0,200,294
84170,4,200,444,9,2,0,3,630,1088
129114,4,200,184,4,3,0,1,241,433
79992,4,200,76,0,0,3,0,84,163
38572,4,200,1631,39,9,1,11,2438,4129
31215,9,158,323,8,6,0,2,633,972
13458,5,570,15,0,0,0,0,25,40
148251,7,310,63,0,0,0,0,80,143
29328,8,403,491,14,2,1,1,763,1272
98463,9,489,115,0,0,0,0,155,270
64773,5,124,1112,25,14,0,5,1674,2830
109518,8,403,1071,34,10,0,4,1638,2757
147371,4,300,418,6,5,0,3,862,1294
91760,9,640,72,1,1,0,3,140,217
13395,7,306,489,0,0,0,2,637,1128
27767,7,492,5,0,0,0,0,4,9
60560,4,36,189,5,1,0,3,268,466
153709,4,658,4,0,0,0,0,7,11
16636,4,885,86,0,1,0,0,131,218
60297,8,214,1662,45,14,2,18,2570,4311
36040,6,78,526,6,7,0,3,835,1377
35096,6,159,212,6,2,0,2,388,610
126598,7,429,58,1,1,0,0,72,132
169611,8,489,375,6,2,0,5,686,1074
1070,9,302,42,0,0,0,0,149,191
45588,6,375,62,1,1,0,0,86,150
7439,5,124,274,5,4,0,1,401,685
116916,6,78,100,1,0,0,0,158,259
159835,7,484,20,0,1,0,1,46,68
10552,5,821,130,8,2,0,1,219,360
117809,7,157,5,0,0,0,0,6,11
23420,8,214,118,0,0,0,0,247,365
20781,7,56,23,5,0,0,0,36,64
61309,6,643,152,3,1,0,0,205,361
124812,7,214,79,0,0,0,0,120,199
130219,8,800,1319,0,0,0,4,1975,3298
122462,9,374,25,2,2,0,0,71,100
73240,9,640,200,0,0,0,1,292,493
132411,4,200,1,0,0,0,0,2,3
53867,5,479,199,0,0,0,0,321,520
139680,7,214,200,1,1,0,2,343,547
61444,6,235,421,15,10,2,2,610,1060
109404,7,157,96,2,5,0,1,140,244
71864,6,885,207,4,4,0,4,310,529
104577,5,124,130,0,0,0,0,182,312
59722,4,658,306,3,3,0,3,694,1009
85353,7,587,23,0,0,0,0,45,68
112343,8,214,332,1,0,0,1,475,809
59574,5,200,127,5,1,0,2,193,328
2575,5,140,100,1,1,0,0,162,264
92520,7,755,29,0,0,0,0,71,100
154783,7,587,29,0,0,0,0,42,71
95083,4,885,197,0,0,0,0,277,474
126035,8,214,935,0,0,0,2,1448,2385
74861,6,78,1162,24,17,0,3,1715,2921
26934,7,570,2392,93,52,12,12,3603,6164
152133,5,176,49,4,3,0,1,112,169
155266,5,118,232,9,5,1,2,386,635
144634,4,159,167,3,0,0,0,228,398
99239,7,521,56,1,1,0,0,87,145
40793,9,489,3,0,0,0,0,1,4
103731,5,106,69,6,2,0,0,111,188
13713,4,200,1017,31,11,1,7,1394,2461
83595,9,489,6,0,0,0,0,10,16
144324,7,842,729,15,5,3,4,1005,1761
145624,7,38,640,8,5,0,0,977,1630
104067,7,38,717,14,9,1,4,1425,2170
70560,5,140,15,0,0,0,0,14,29
70285,9,489,56,5,1,0,2,124,188
98963,8,214,349,3,1,0,0,630,983
125739,5,489,536,9,5,0,3,864,1417
167754,7,587,350,4,3,0,0,563,920
121970,6,235,236,3,2,0,0,363,604
82867,7,587,1102,33,22,3,7,1660,2827
32830,9,489,73,2,2,0,0,127,204
11090,8,214,2956,33,14,1,11,4775,7790
24929,5,225,370,3,5,0,3,586,967
166827,6,124,48,0,0,0,0,68,116
108407,6,124,115,1,0,0,0,170,286
148258,5,225,342,5,4,0,2,497,850
136754,8,214,799,18,8,1,3,1403,2232
49118,6,209,592,30,17,3,3,1072,1717
45476,9,302,19,0,0,0,1,29,49
48877,9,306,1494,116,72,12,20,2458,4172
73535,7,748,318,4,2,0,2,490,816
136103,6,263,1244,26,14,2,16,1723,3025
8767,8,545,92,2,1,0,1,175,271
160343,4,638,145,3,4,0,0,230,382
24968,4,306,206,0,1,0,1,342,550
80813,5,263,68,1,0,0,0,110,179
16519,7,587,501,14,5,0,0,750,1270
46410,9,489,295,7,7,0,0,471,780
157846,7,741,113,6,5,0,2,208,334
32279,4,658,42,0,0,0,0,65,107
106231,9,341,11,0,0,0,0,14,25
39874,8,812,122,0,0,0,0,176,298
25326,5,66,1037,36,16,5,6,1539,2639
118824,5,263,65,0,0,0,0,100,165
142946,9,301,105,4,1,0,0,141,251
72112,5,585,57,2,0,0,0,80,139
10813,6,235,377,11,5,0,1,504,898
23088,7,872,274,10,7,1,2,333,627
27013,8,306,1083,21,14,0,6,2103,3227
159518,8,489,98,1,1,0,0,141,241
28918,10,200,134,2,1,0,1,194,332
118498,9,489,195,6,2,0,2,260,465
147537,10,917,49,2,2,0,2,128,183
151541,8,124,1781,32,21,0,11,2718,4563
141491,8,124,503,16,11,0,1,743,1274
169639,6,78,800,7,9,0,4,1208,2028
133350,7,693,364,9,4,2,2,564,945
166727,7,693,252,5,4,1,6,513,781
134810,9,800,112,3,1,0,2,318,436
158549,9,630,3,0,0,0,0,3,6
89131,7,527,6,0,0,0,0,10,16
113756,9,117,57,0,0,0,0,78,135
113917,9,842,183,9,4,0,1,304,501
169886,6,827,1409,42,21,3,5,2112,3592
135831,9,874,143,6,1,0,0,240,390
140423,9,630,170,0,0,0,0,307,477
37461,10,917,121,2,1,0,5,198,327
148098,9,86,102,1,1,0,1,160,265
137824,6,140,14,0,0,0,0,16,30
74176,9,489,20,0,0,0,0,38,58
170773,9,489,63,1,0,0,0,84,148
136398,9,489,336,11,5,0,1,554,907
150348,8,489,193,2,0,0,0,266,461
129603,5,655,272,6,4,2,4,406,694
2853,10,807,215,4,3,1,0,345,568
30031,5,124,105,1,2,0,2,167,277
147170,6,570,281,11,6,0,3,446,747
150163,7,861,7,0,0,0,0,19,26
64571,8,800,221,6,2,0,0,393,622
32018,9,367,595,12,4,3,6,1061,1681
35747,10,917,3,0,0,0,0,4,7
32350,5,124,191,8,0,0,1,265,465
130930,9,842,509,24,13,2,2,836,1386
7304,6,209,111,6,4,0,1,145,267
63447,5,479,957,33,9,1,8,1359,2367
4680,10,653,1470,34,14,1,9,2288,3816
125805,8,800,125,8,4,0,1,202,340
72395,7,641,87,2,2,0,0,167,258
168827,8,214,1049,3,3,0,3,1570,2628
167513,6,159,27,1,1,0,0,42,71
23598,5,375,7,0,0,0,0,13,20
25783,8,214,708,0,0,0,0,1011,1719
100462,8,214,860,21,5,0,5,1689,2580
10130,8,812,168,7,1,0,0,345,521
48767,10,136,62,0,0,0,0,104,166
73205,8,623,533,4,3,0,3,684,1227
52577,9,469,104,2,2,0,1,151,260
148396,6,159,230,2,2,0,0,364,598
104918,10,653,240,0,0,0,0,400,640
52979,10,63,36,0,0,0,0,234,270
29568,8,623,339,4,2,0,0,484,829
46558,5,447,619,11,3,0,3,978,1614
104563,8,623,363,15,2,0,1,609,990
71455,5,375,97,7,3,1,0,173,281
105478,4,890,123,1,2,0,1,234,361
147833,8,403,1029,34,11,1,3,1707,2785
11051,5,479,128,1,0,0,0,177,306
26179,9,741,462,19,11,2,3,737,1234
122313,10,289,72,4,2,0,1,104,183
62162,9,379,34,0,0,0,0,44,78
147046,10,104,43,2,0,0,1,72,118
55444,8,623,727,19,7,0,7,1086,1846
118532,6,453,185,3,2,0,1,258,449
84954,8,427,166,4,7,0,0,295,472
77773,10,355,91,3,2,1,0,120,217
56641,4,519,283,1,1,0,1,443,729
24435,4,923,85,0,0,0,0,114,199
49135,4,375,49,2,0,0,0,51,102
90656,6,453,171,4,2,1,0,214,392
86402,9,842,10,0,0,0,0,11,21
62758,8,214,950,25,14,1,2,1414,2406
44652,10,752,729,18,10,0,6,1408,2171
150472,4,658,147,1,1,0,2,249,400
36882,5,159,81,0,0,0,1,121,203
33778,4,658,97,2,2,0,0,180,281
92297,11,427,3,0,0,0,0,2,5
116838,4,200,738,4,1,0,2,1194,1939
19074,5,371,57,1,1,0,2,96,157
104844,4,375,9,0,0,0,0,8,17
137385,7,587,210,0,0,0,1,278,489
101506,10,525,158,2,0,0,1,250,411
45514,10,525,66,0,0,0,1,86,153
30240,5,124,196,6,4,0,1,268,475
98527,4,519,293,5,2,0,0,443,743
29233,10,159,64,1,1,0,1,117,184
65832,10,914,44,0,0,0,0,62,106
130496,8,693,1213,38,14,1,12,2180,3458
45186,10,217,47,6,2,0,1,78,134
161460,6,124,99,2,1,0,0,161,263
162305,6,232,204,2,3,0,2,279,490
158715,8,623,101,1,0,0,0,158,260
125759,10,914,0,0,0,0,0,115,115
27256,8,766,50,1,1,0,0,73,125
105587,8,623,47,0,0,0,0,66,113
59686,5,489,252,14,11,0,1,428,706
48783,4,159,581,13,4,0,3,805,1406
113754,10,914,0,0,0,0,0,54,54
83518,8,214,21,0,0,0,0,23,44
97325,4,200,9,0,0,0,0,21,30
90647,10,917,239,9,3,1,0,417,669
127536,4,159,202,5,3,0,1,379,590
87917,5,408,353,21,10,0,4,584,972
159123,6,59,322,7,7,0,1,644,981
8518,6,269,137,1,0,0,0,214,352
156475,10,111,8,0,0,0,0,36,44
10360,9,78,183,3,2,0,0,251,439
53381,4,306,415,24,12,0,4,576,1031
88427,9,117,87,2,1,0,0,119,209
81553,7,587,128,0,0,0,0,191,319
150059,5,124,38,3,1,0,0,58,100
137091,5,124,592,9,5,2,5,886,1499
128739,5,655,228,9,3,1,1,335,577
23193,5,124,238,6,1,2,2,372,621
14523,5,655,226,11,5,1,0,296,539
8387,5,124,74,2,1,0,0,116,193
156439,7,157,406,7,5,0,2,635,1055
132375,9,741,164,5,2,0,0,261,432
41248,9,813,58,0,0,0,1,114,173
98003,9,157,101,0,0,0,1,148,250
151200,9,6,5,0,0,0,0,5,10
157450,9,380,36,0,0,0,0,46,82
101202,9,813,13,0,0,0,0,30,43
122717,9,6,6,0,0,0,0,12,18
87072,9,630,653,5,3,0,6,1486,2153
111730,9,341,27,0,0,0,0,44,71
91299,5,655,196,7,1,1,2,288,495
59900,5,655,87,2,2,0,0,141,232
159103,5,124,90,2,2,0,0,172,266
15950,5,124,104,4,4,0,0,172,284
157797,5,124,25,0,0,0,0,32,57
17066,5,124,75,0,0,0,0,115,190
9980,5,655,97,3,2,0,1,130,233
22053,5,124,78,2,0,0,1,109,190
46622,5,655,55,1,1,0,1,91,149
166943,9,341,150,2,2,0,0,264,418
116909,4,159,55,0,0,0,0,83,138
136909,5,159,232,5,4,0,0,325,566
154230,4,658,129,4,2,0,0,219,354
165513,6,165,163,5,5,0,2,288,463
59162,10,205,81,3,3,1,1,129,218
162863,9,838,2,0,0,0,0,3,5
48133,9,341,8,0,0,0,0,9,17
104170,9,341,38,1,1,0,0,57,97
17335,9,341,3,0,0,0,0,4,7
99251,9,341,5,0,0,0,0,11,16
152033,9,341,13,0,0,0,0,26,39
92907,4,453,378,4,2,0,0,542,926
167032,8,623,202,1,0,0,2,308,513
123690,5,489,7,0,0,0,0,9,16
66309,9,341,5,0,0,0,0,11,16
99277,5,78,329,1,2,0,4,467,803
86890,7,367,160,1,1,0,0,243,405
41636,9,341,210,4,3,0,1,304,522
146787,9,302,31,0,0,0,0,44,75
52874,8,489,489,1,0,0,2,833,1325
114381,4,923,108,7,3,0,1,201,320
69422,11,214,2,0,0,0,0,2,4
49645,6,269,274,1,0,0,3,440,718
126472,8,885,1274,27,14,0,9,2081,3405
97913,7,489,263,7,3,1,0,427,701
50,9,469,1202,20,13,1,2,1550,2788
23633,8,403,151,0,0,0,0,342,493
109430,10,36,60,1,0,0,1,93,155
3647,8,124,408,4,1,1,3,662,1079
117378,11,885,70,3,0,0,0,89,162
83172,4,174,156,0,0,0,1,227,384
129008,7,527,871,214,112,14,9,1219,2439
86306,5,444,18,0,0,0,0,24,42
123050,9,489,503,16,4,1,2,753,1279
8052,9,570,904,0,0,0,4,1451,2359
126653,5,404,14,0,0,0,0,16,30
149357,7,100,71,0,0,0,0,90,161
148294,9,630,408,1,0,0,0,469,878
157509,9,630,779,4,0,0,0,1016,1799
107037,5,655,182,3,2,0,1,257,445
10838,8,812,82,0,0,0,0,163,245
109510,5,263,123,1,0,0,0,205,329
147857,8,306,223,1,1,0,0,361,586
136438,8,800,133,1,1,0,2,200,337
129243,10,798,8,0,0,0,0,6,14
92372,8,717,824,10,9,0,2,1363,2208
123684,8,214,1640,29,12,0,9,2801,4491
104192,8,484,360,1,2,0,0,574,937
15134,8,658,1451,58,12,0,11,2386,3918
131369,5,124,276,5,5,0,1,446,733
118712,10,653,151,0,0,0,0,253,404
153032,10,743,8,0,0,0,0,19,27
552,5,78,641,7,7,0,1,970,1626
53612,11,489,433,15,0,0,0,497,945
37978,4,675,99,1,0,0,0,211,311
3864,7,551,55,1,0,0,0,75,131
148360,7,551,18,1,0,0,0,26,45
145245,5,124,480,27,14,0,5,714,1240
115163,5,78,370,13,8,0,1,506,898
70519,7,741,17,0,0,0,0,30,47
53807,7,126,8,0,0,0,0,14,22
130455,4,36,937,22,6,2,2,1696,2665
89216,10,81,134,3,0,0,0,274,411
141388,6,235,52,0,2,0,1,110,165
64326,10,653,210,7,0,1,0,298,516
5995,4,752,597,12,2,0,6,825,1442
144500,7,578,33,1,2,0,0,48,84
100260,6,78,187,4,5,0,0,281,477
73624,11,489,67,0,0,0,1,63,131
156305,5,124,73,4,1,0,0,112,190
63792,6,165,848,17,10,1,1,1359,2236
167247,10,63,78,0,0,0,0,124,202
133214,9,341,24,0,0,0,0,33,57
109724,10,653,354,0,0,0,3,534,891
74169,7,589,94,2,0,2,0,128,226
47001,9,78,112,3,2,0,0,193,310
58846,8,545,2,0,0,0,0,3,5
61937,7,885,141,4,0,1,1,254,401
118151,6,200,61,0,0,0,0,70,131
65165,10,200,107,1,1,0,0,150,259
108104,10,200,144,0,0,0,1,210,355
39347,10,40,191,1,0,0,1,263,456
137905,9,489,223,3,2,0,0,288,516
60081,5,200,52,0,0,0,0,67,119
90496,10,200,163,6,5,0,2,254,430
53731,5,306,1684,31,15,0,6,2661,4397
61771,11,885,100,3,0,0,0,121,224
58502,10,200,58,0,0,0,0,92,150
135218,10,692,297,6,2,0,3,464,772
130293,4,36,132,2,0,0,0,424,558
134595,8,403,302,7,5,0,0,459,773
145458,5,655,294,6,3,0,2,427,732
136467,4,885,108,0,0,0,0,186,294
106054,8,124,188,2,1,0,0,344,535
148885,7,489,271,9,6,1,3,395,685
153135,11,124,76,3,0,0,0,81,160
22043,5,404,515,2,1,0,3,803,1324
169538,10,474,150,2,2,0,0,289,443
29313,10,66,198,2,1,0,0,326,527
123659,5,404,24,0,0,0,0,25,49
69957,4,159,212,12,5,0,0,376,605
8776,10,474,61,0,0,0,1,139,201
127842,8,214,214,0,1,0,1,307,523
42122,4,923,104,0,0,0,0,165,269
23257,10,474,49,3,0,1,0,105,158
88399,10,474,37,1,1,0,1,93,133
73309,8,214,457,0,0,0,1,620,1078
72014,4,200,421,6,5,0,1,642,1075
80597,9,157,102,2,2,0,1,166,273
78283,9,77,14,5,0,0,0,21,40
90471,5,489,999,35,14,4,7,1673,2732
167177,9,489,56,1,1,0,0,96,154
153971,11,545,224,12,0,0,0,266,502
160409,9,538,234,8,2,0,2,341,587
145008,5,355,648,23,14,2,7,934,1628
52110,9,538,50,2,1,0,0,152,205
97456,5,381,8,0,0,0,0,12,20
155213,4,923,222,5,2,1,2,396,628
3916,5,381,36,2,0,0,0,59,97
91759,9,538,23,0,0,0,0,35,58
66214,4,174,30,0,0,0,0,49,79
84831,7,46,176,9,8,0,1,192,386
139310,10,692,169,5,2,0,0,240,416
81733,8,857,372,10,0,1,0,621,1004
141708,7,157,301,5,3,0,2,468,779
16231,7,489,254,8,2,1,1,413,679
4174,9,842,1524,31,21,0,4,2143,3723
107980,7,263,34,0,0,0,0,59,93
140668,8,801,95,2,1,0,1,155,254
157621,7,100,42,0,0,0,0,48,90
30128,4,375,223,1,1,0,2,373,600
73415,8,489,32,0,0,0,0,52,84
111654,10,790,32,0,0,0,0,54,86
102313,5,124,2807,88,25,11,25,4776,7732
56686,7,100,193,8,5,0,1,361,568
62976,6,885,569,23,12,0,5,946,1555
23819,4,800,258,1,2,0,0,419,680
42960,4,159,13,0,0,0,0,18,31
63260,8,800,173,0,0,0,0,291,464
145502,4,658,10,0,0,0,0,13,23
24771,8,857,1796,48,13,2,5,3170,5034
62279,7,216,132,2,2,0,2,233,371
31687,8,800,847,45,12,5,3,1396,2308
160948,7,521,146,6,3,0,1,190,346
128427,7,521,79,2,0,0,0,118,199
144762,8,427,1593,59,28,2,11,2674,4367
131969,6,263,2121,61,28,4,10,3418,5642
65548,4,658,128,0,0,0,0,213,341
152746,6,165,1025,49,16,6,4,1679,2779
88457,8,800,869,27,10,0,8,1575,2489
62231,8,800,325,7,4,0,1,464,801
95185,7,587,45,0,0,0,0,46,91
104970,6,174,43,0,0,0,0,58,101
49867,10,618,66,0,0,0,0,99,165
91397,6,269,472,6,1,0,3,666,1148
56360,10,242,45,1,1,0,0,57,104
138636,6,269,38,0,0,0,0,54,92
7423,10,355,116,1,1,0,0,157,275
137088,6,269,156,1,1,0,3,237,398
18549,7,741,68,0,0,0,0,126,194
158338,7,521,116,0,0,0,1,181,298
105262,7,741,113,0,0,0,1,193,307
29063,10,917,94,2,1,0,1,159,257
25473,6,885,99,3,3,0,0,145,250
92778,8,812,401,18,7,0,5,511,942
166224,7,79,60,4,1,0,0,111,176
93155,7,79,15,0,0,0,0,33,48
120575,6,885,85,0,0,0,2,159,246
162939,7,79,185,3,3,0,1,279,471
140967,7,79,83,0,0,0,0,114,197
70452,6,885,21,0,0,0,0,25,46
147466,7,79,39,2,0,2,0,101,144
78528,10,653,460,9,7,0,3,659,1138
167904,5,58,309,3,2,0,1,463,778
38388,5,699,468,11,7,0,0,682,1168
74158,5,118,4,0,0,0,0,6,10
139171,5,218,143,2,2,0,1,206,354
65223,5,355,153,3,2,0,2,217,377
128646,5,218,212,3,1,0,0,314,530
63921,5,176,98,3,2,1,0,139,243
110776,5,355,47,1,1,0,0,96,145
58865,5,58,11,1,1,0,0,17,30
124445,5,371,136,2,2,0,1,194,335
63813,5,355,599,15,9,0,3,893,1519
49259,6,667,82,3,3,0,0,138,226
104300,6,165,373,22,12,1,4,627,1039
129181,7,56,4,0,0,0,0,6,10
33545,7,484,69,2,0,2,0,123,196
20872,7,484,456,13,8,1,3,611,1092
126929,8,800,115,1,1,0,0,145,262
31725,6,885,90,1,1,0,0,102,194
82973,6,165,781,32,13,2,7,1331,2166
19543,7,587,11,0,0,0,0,20,31
51512,7,587,8,0,0,0,0,11,19
104205,7,587,12,0,0,0,0,23,35
125567,9,306,102,0,0,0,0,112,214
38544,6,366,137,5,2,0,0,159,303
119379,5,821,1045,25,16,1,8,1602,2697
146207,8,484,55,0,0,0,0,73,128
67224,5,58,43,3,2,0,0,57,105
146001,5,118,139,7,4,0,0,377,527
85145,5,118,112,3,2,0,0,189,306
107494,7,552,229,3,1,0,0,350,583
145735,7,552,77,1,1,0,0,116,195
21451,4,638,68,0,0,0,0,117,185
167409,7,587,187,3,3,0,0,268,461
6279,5,489,180,0,0,0,1,400,581
33443,5,728,218,2,0,0,0,296,516
138613,8,623,110,0,0,0,1,148,259
99839,10,172,432,3,3,0,1,507,946
40988,5,118,67,0,0,0,0,193,260
31050,8,124,477,0,0,0,2,733,1212
169213,8,124,347,0,0,0,2,539,888
133927,8,812,9,0,0,0,0,12,21
105802,9,575,65,0,0,0,0,82,147
163314,10,790,17,0,0,0,0,58,75
9907,5,263,242,4,2,0,0,439,687
170980,5,263,97,1,0,0,1,169,268
58087,4,200,754,10,6,0,0,1179,1949
34295,8,209,34,0,0,0,0,48,82
117179,8,801,221,5,0,0,0,316,542
121076,6,263,128,3,16,0,1,198,346
113530,6,78,17,0,0,0,0,29,46
109781,4,200,92,3,0,1,3,143,242
92486,7,74,42,1,0,1,0,73,117
14832,4,890,362,2,1,0,2,475,842
166725,8,124,922,20,6,1,5,1392,2346
162260,5,408,324,6,3,2,3,562,900
43365,8,214,169,5,3,0,0,252,429
10545,7,80,75,0,0,0,0,111,186
30291,8,403,129,2,2,0,0,200,333
123949,4,200,77,0,0,0,1,127,205
162487,4,200,110,0,0,0,1,159,270
54571,8,800,30,1,0,0,0,54,85
32312,8,214,16,0,0,0,0,18,34
148663,6,489,228,2,2,1,3,307,543
162086,8,214,265,1,3,0,0,354,623
130452,4,581,211,0,0,0,0,351,562
134874,7,693,69,1,1,0,2,113,186
27592,8,623,283,3,0,0,1,432,719
127885,8,214,130,0,0,0,0,202,332
133781,8,214,86,0,0,0,0,120,206
36949,8,214,883,0,1,0,4,1172,2060
150084,9,78,134,2,2,0,1,167,306
137180,4,658,2,0,0,0,0,3,5
78512,4,885,275,5,0,0,1,462,743
7047,7,429,774,21,9,3,5,1285,2097
104759,6,296,13,0,0,0,0,18,31
37207,7,429,242,10,1,2,2,310,567
66654,6,117,283,8,3,0,2,363,659
53682,8,623,46,0,1,0,1,57,105
13994,6,124,28,0,0,0,0,44,72
118932,6,489,306,3,0,0,0,508,817
129709,7,741,279,4,3,0,0,452,738
156889,9,842,358,10,9,0,0,531,908
161378,9,710,26,2,0,1,1,49,79
158202,4,375,27,0,0,0,0,39,66
163215,8,800,152,0,1,0,0,183,336
98334,4,885,180,0,1,0,0,335,516
75336,4,885,397,4,1,0,1,627,1030
160060,4,885,41,0,0,0,0,50,91
43358,7,207,72,1,2,0,0,114,189
169995,7,563,307,9,5,0,2,603,926
111460,9,607,36,0,0,0,0,66,102
29240,9,306,278,0,0,0,1,469,748
28755,8,214,367,1,1,0,2,587,958
3252,8,214,640,3,1,0,0,1038,1682
91721,8,124,208,3,2,0,1,295,509
6140,8,655,310,3,3,0,0,408,724
147472,10,617,79,2,1,0,0,72,154
160507,7,693,353,12,4,2,5,643,1019
1189,7,748,320,11,4,1,2,490,828
50835,7,748,407,11,8,1,1,589,1017
40161,8,857,1145,19,7,3,6,1851,3031
168359,7,521,161,3,2,0,0,215,381
163989,4,581,152,0,0,0,1,241,394
112822,4,519,411,0,0,0,1,633,1045
151861,4,581,446,10,3,1,0,846,1306
103839,7,374,35,0,1,0,0,50,86
101504,7,484,15,0,0,0,0,33,48
138782,7,521,84,1,1,0,0,115,201
54187,7,521,36,0,0,0,1,53,90
37741,7,648,135,1,2,0,0,213,351
95383,8,214,224,5,6,0,0,319,554
10473,9,306,282,0,0,0,0,388,670
32715,8,489,403,6,3,1,3,519,935
13913,6,78,208,4,1,0,1,320,534
44299,7,484,7,0,0,0,0,3,10
165985,7,489,51,0,0,0,1,96,148
77527,7,587,4800,111,32,12,23,8447,13425
101443,8,214,77,0,0,0,0,86,163
27231,6,51,622,17,8,3,1,871,1522
90953,6,800,217,3,3,0,0,202,425
30135,8,403,386,8,2,0,1,576,973
14876,6,800,165,6,2,1,0,232,406
111936,7,589,278,10,4,2,0,436,730
129050,4,159,716,13,8,0,1,990,1728
164970,9,800,89,5,4,0,2,124,224
50889,8,214,647,5,2,0,1,1071,1726
170775,10,111,42,1,0,1,0,107,151
90034,9,302,45,0,1,0,0,67,113
135249,4,36,279,2,0,1,1,446,729
144413,9,589,6,1,0,0,0,10,17
149467,4,375,121,2,1,0,1,234,359
138447,6,561,269,7,4,0,2,412,694
89098,9,379,452,13,5,0,4,662,1136
124776,9,630,90,2,0,0,0,147,239
138416,8,214,119,1,2,0,0,183,305
54856,9,630,59,3,2,0,1,58,123
106211,9,489,257,1,0,0,1,326,585
80329,7,367,98,3,0,1,0,142,244
62760,7,367,10,0,0,0,0,20,30
80886,7,367,13,0,0,0,0,20,33
17416,7,587,2053,56,22,7,14,4167,6319
165075,7,587,1556,30,11,2,7,2758,4364
55384,7,587,901,24,10,1,4,1866,2806
61883,7,535,77,0,0,0,0,116,193
77552,7,864,72,3,1,0,0,83,159
29323,10,797,53,0,0,0,0,68,121
134517,9,489,177,0,0,0,0,502,679
149331,7,587,296,0,0,0,0,448,744
29718,7,611,14,0,0,0,0,16,30
37066,7,694,725,8,2,0,4,1213,1952
86947,8,403,40,1,0,0,0,47,88
30528,8,623,883,11,9,1,5,1493,2402
78358,4,36,76,1,2,0,0,113,192
119166,4,638,44,2,2,0,1,50,99
123602,7,861,617,11,9,1,3,1231,1872
83060,7,861,0,0,0,0,0,4,4
21603,7,861,225,8,6,0,2,712,953
66799,7,516,108,0,1,0,0,151,260
39216,8,403,970,32,5,0,4,1858,2869
3164,5,66,139,2,3,0,1,200,345
131359,11,800,15,1,0,0,0,16,32
118218,4,800,30,0,0,0,0,40,70
45379,4,174,54,0,0,0,0,86,140
73287,4,174,118,0,0,0,0,197,315
47725,9,489,11,0,0,0,0,15,26
124012,9,489,24,0,0,0,0,36,60
143407,6,827,589,19,8,4,2,895,1517
95423,8,214,97,0,0,0,0,162,259
1962,6,570,310,7,5,0,1,499,822
137842,4,36,294,4,2,0,3,501,804
87287,7,263,118,0,0,0,1,192,311
8895,7,263,9,0,0,0,0,11,20
14197,4,300,196,3,2,0,0,435,636
156370,7,306,665,0,0,0,5,905,1575
57084,5,375,208,6,5,0,1,383,603
80315,7,228,21,0,0,0,0,40,61
163351,7,228,29,0,0,0,0,44,73
163845,7,228,7,0,0,0,0,10,17
14022,8,790,167,3,2,0,1,286,459
123731,6,785,89,4,4,0,1,150,248
38001,6,209,41,1,0,0,0,52,94
155176,6,209,5,0,0,0,0,13,18
80159,4,36,387,18,9,1,2,732,1149
81649,8,790,168,2,1,0,1,267,439
63294,11,489,471,26,0,0,0,566,1063
37438,9,374,24,0,0,5,0,20,49
32230,9,374,29,0,0,5,0,22,56
115027,7,878,44,0,0,0,0,59,103
9616,8,812,205,7,3,0,0,318,533
153419,7,157,118,10,4,0,0,218,350
149995,9,630,427,0,0,0,2,999,1428
64232,7,157,93,2,1,0,1,176,273
7282,7,157,12,0,0,0,0,39,51
5413,10,111,108,1,1,0,0,180,290
85674,10,797,748,18,4,3,3,1269,2045
40723,7,306,237,0,1,0,0,368,606
86131,7,489,183,2,0,0,1,312,498
108433,4,159,186,3,3,0,0,295,487
98717,6,306,297,0,0,0,0,400,697
147474,5,570,172,4,3,0,0,291,470
10325,8,885,11329,233,101,14,73,19873,31623
163594,4,174,173,0,1,0,2,252,428
109980,4,885,87,0,0,0,0,104,191
53519,4,800,341,5,2,0,0,554,902
51121,7,232,135,3,1,0,0,199,338
42768,6,885,51,0,0,0,0,77,128
57004,5,489,178,1,2,0,1,313,495
94724,6,235,411,12,9,1,2,749,1184
81981,4,200,73,2,1,0,0,88,164
60464,4,200,68,2,2,0,0,81,153
163670,9,4,89,7,4,1,0,105,206
3512,9,4,26,0,0,0,0,29,55
154842,8,489,8,0,0,0,0,10,18
67251,9,4,132,3,1,0,0,170,306
11585,4,159,291,9,2,0,1,486,789
117458,4,159,126,0,0,0,0,145,271
131323,8,623,70,1,1,0,0,100,172
129232,9,630,155,8,8,0,0,248,419
98203,5,78,596,18,8,2,3,865,1492
96957,9,302,709,14,11,1,0,1180,1915
148524,5,251,96,0,0,0,1,125,222
74843,6,885,442,6,3,0,1,621,1073
23632,10,653,25,0,0,0,0,36,61
148858,9,741,79,3,2,0,0,149,233
128088,9,800,318,9,8,1,2,355,693
122548,7,570,231,1,1,0,3,450,686
149293,5,570,171,8,5,1,0,276,461
34123,4,725,101,1,0,0,1,164,267
14389,5,570,6,1,0,0,0,6,13
62562,7,367,747,24,11,1,3,1339,2125
76071,9,302,37,2,1,0,0,69,109
170296,9,302,46,2,2,0,0,43,93
93643,6,570,115,0,0,0,0,170,285
31130,8,214,553,22,11,2,0,1122,1710
169085,8,214,597,19,11,2,1,1045,1675
71880,8,214,445,8,4,1,3,757,1218
124845,5,355,391,5,1,1,0,557,955
153390,7,157,1509,33,22,2,7,2447,4020
47145,8,124,37,0,0,0,0,61,98
95974,9,302,1413,45,20,4,8,2336,3826
66390,9,306,500,0,0,0,5,1631,2136
32432,9,4,19,1,1,0,0,25,46
58383,9,302,20,0,0,0,0,25,45
154536,11,489,287,4,0,0,0,331,622
108259,7,263,21,0,0,0,0,15,36
81011,5,118,609,16,10,3,3,1057,1698
99926,8,812,47,1,1,0,0,90,139
84101,7,263,20,0,0,0,1,30,51
165638,7,216,88,1,1,0,0,131,221
136129,5,355,467,3,2,1,1,611,1085
8598,9,306,37,0,0,0,1,46,84
84630,8,489,87,4,1,0,0,136,228
11609,7,587,60,0,0,0,0,86,146
16761,5,78,793,13,6,0,4,1259,2075
153243,10,617,145,0,0,0,1,191,337
43938,4,300,821,16,7,0,5,1554,2403
55776,9,575,119,2,0,0,0,158,279
100483,9,575,73,1,0,4,0,117,195
10755,9,575,121,2,0,0,0,166,289
9365,5,118,168,4,4,0,1,338,515
79925,5,306,52,0,0,0,0,68,120
132119,5,355,301,15,7,2,1,427,753
145799,7,118,355,7,5,0,3,613,983
43034,6,221,109,4,3,0,1,159,276
155953,7,630,10,0,0,0,0,7,17
86162,10,474,150,1,0,0,0,260,411
16230,6,404,1826,2,0,0,14,2787,4629
169633,10,474,137,1,0,0,0,363,501
92331,8,489,116,1,0,0,0,210,327
91806,8,403,482,4,2,0,1,721,1210
92128,8,489,44,0,0,0,0,79,123
116177,7,521,26,0,0,0,0,38,64
147173,7,872,173,7,3,1,4,286,474
40246,7,693,2,0,0,0,0,3,5
129157,4,658,648,14,9,0,1,867,1539
120685,7,387,180,3,3,0,0,264,450
87308,9,341,34,0,0,0,0,54,88
30866,9,341,31,0,0,0,1,36,68
118848,11,545,46,0,0,0,0,51,97
22137,4,200,87,0,0,0,0,103,190
10470,8,214,816,2,1,0,2,1276,2097
72021,4,174,312,5,4,0,0,426,747
109715,8,214,633,2,2,1,6,922,1566
167574,4,159,443,6,4,1,1,768,1223
55548,6,124,181,0,0,0,1,250,432
138321,9,489,50,0,0,0,0,55,105
147890,6,78,155,0,0,0,0,185,340
108056,5,235,53,2,1,0,1,69,126
14020,8,489,637,7,3,0,2,1017,1666
126009,6,235,77,0,0,0,0,127,204
25409,8,489,781,24,7,1,6,1365,2184
3089,7,78,13,0,0,0,0,18,31
141267,8,489,253,4,1,0,1,428,687
169540,4,36,18,0,0,0,1,26,45
88422,8,489,877,7,5,0,7,1323,2219
142552,8,489,1004,16,6,1,7,1573,2607
154983,8,214,124,4,0,1,1,236,366
169157,7,842,222,2,2,0,2,353,581
168027,7,842,587,24,11,0,3,919,1544
37310,7,842,104,2,1,1,2,147,257
138493,8,214,372,1,1,0,3,579,956
60077,8,214,117,0,0,0,1,194,312
145630,8,214,60,0,0,0,0,111,171
122044,4,908,34,0,0,0,0,35,69
45732,7,660,4,0,0,0,0,7,11
33468,5,78,138,2,0,0,0,171,311
59529,10,841,45,4,2,0,0,61,112
147948,7,587,11,0,0,0,0,16,27
135968,7,484,56,2,1,2,0,90,151
48477,7,737,126,2,1,0,1,184,314
1630,7,484,21,0,1,0,0,58,80
165762,7,484,1,0,0,0,0,0,1
77277,7,737,24,1,1,0,0,31,57
168654,7,645,1,0,0,0,0,1,2
42749,9,341,23,0,0,1,0,24,48
157652,7,4,136,2,5,0,1,205,349
136596,9,302,199,13,5,3,0,561,781
168006,9,341,197,2,1,0,0,310,510
166198,4,800,145,0,0,0,0,268,413
108265,4,159,5,0,0,0,0,2,7
92919,4,159,1,0,0,0,0,0,1
10581,8,427,83,1,2,0,0,123,209
95804,5,159,169,3,3,0,0,271,446
60490,8,427,78,0,0,0,0,121,199
88053,8,545,727,16,10,0,5,1071,1829
53997,9,842,450,19,10,2,2,836,1319
49694,9,158,45,2,2,0,0,83,132
151498,4,200,241,3,1,0,2,313,560
30858,7,306,119,0,0,0,0,147,266
91644,8,800,227,0,0,0,1,423,651
79747,4,200,166,5,2,0,1,291,465
160712,5,306,234,8,6,0,0,365,613
117856,4,453,511,11,5,0,3,872,1402
57241,4,453,437,19,8,2,3,831,1300
83551,5,404,155,0,0,0,0,257,412
40286,5,232,83,1,3,0,0,165,252
26814,8,427,63,0,0,0,0,87,150
70908,7,748,25,0,0,0,0,49,74
53714,7,489,370,6,5,0,2,569,952
132262,8,214,221,4,0,0,1,263,489
22940,7,527,23,0,0,0,0,31,54
140323,4,658,34,1,0,0,0,44,79
98537,9,469,147,7,2,0,1,231,388
8684,4,923,80,0,0,0,0,163,243
34071,5,306,74,0,1,0,0,125,200
161651,9,469,722,47,15,10,4,1200,1998
119283,7,79,129,6,0,27,0,170,332
94604,4,200,1661,9,8,0,0,2271,3949
48180,11,214,57,4,0,0,0,61,122
41795,8,489,1250,15,6,0,5,1644,2920
39859,7,648,28,2,0,0,0,58,88
164983,6,404,243,0,0,0,2,425,670
11291,8,800,246,4,2,0,1,444,697
5485,5,124,513,14,6,0,3,811,1347
58227,9,469,373,13,6,3,1,580,976
125165,5,78,134,1,0,0,0,225,360
151621,9,469,578,20,13,3,2,912,1528
30794,6,800,20,2,0,0,0,25,47
146879,11,427,13,0,0,0,0,15,28
30749,7,648,82,3,2,0,0,163,250
35070,9,469,27,0,1,0,0,28,56
101593,10,200,525,10,6,0,3,776,1320
94890,10,200,56,1,1,0,0,67,125
127391,8,200,67,3,0,0,0,259,329
38159,5,159,772,15,5,0,2,1204,1998
61119,4,36,548,17,13,2,2,1302,1884
43284,6,296,233,12,6,0,2,374,627
48386,8,209,14,2,1,0,0,22,39
90729,7,587,257,4,1,0,1,297,560
24712,6,366,146,5,4,0,2,245,402
102843,4,800,30,0,0,0,0,42,72
116430,5,181,473,6,7,1,1,869,1357
95320,4,375,7,0,0,0,0,8,15
6042,4,300,291,6,5,0,1,609,912
70738,7,521,96,3,2,0,0,121,222
23853,6,667,339,20,19,0,1,521,900
27096,5,232,186,6,3,0,1,303,499
148220,4,222,2206,51,23,3,15,3773,6071
2261,4,174,11,0,0,0,0,15,26
115179,4,885,173,0,0,0,2,249,424
39662,9,469,32,0,0,0,0,45,77
148813,4,581,87,0,0,0,0,108,195
39618,6,667,115,0,0,0,0,185,300
117946,6,263,65,0,0,0,1,106,172
158817,6,404,561,1,2,0,4,925,1493
104736,6,221,13,0,0,0,0,27,40
31784,7,216,288,7,4,0,2,442,743
75573,7,216,85,0,0,0,0,130,215
102732,5,893,161,7,5,1,0,260,434
133809,5,570,33,1,1,0,0,47,82
110796,9,86,60,4,1,0,0,115,180
26028,8,885,603,11,4,0,2,1050,1670
37059,7,114,186,4,2,2,3,278,475
166640,6,800,833,28,16,2,4,1260,2143
4282,9,489,302,14,7,1,3,535,862
25942,9,367,115,4,3,2,2,77,203
47462,5,106,13,0,0,0,0,20,33
107793,6,124,128,0,1,0,0,191,320
103806,4,885,206,0,0,0,2,347,555
75589,6,420,250,5,1,2,0,343,601
37237,6,269,101,3,4,0,0,140,248
141306,9,483,203,6,1,1,3,504,718
70923,9,374,32,1,1,0,0,50,84
155181,4,375,43,0,0,0,0,63,106
29561,6,489,5,0,0,0,0,5,10
3416,4,908,7,0,0,0,0,6,13
159837,5,556,14,0,0,0,0,23,37
11117,8,545,9,0,0,0,0,21,30
107266,9,86,88,2,3,0,0,138,231
56936,7,587,262,3,3,1,0,397,666
68060,6,124,350,13,6,0,2,540,911
132043,6,124,113,2,1,0,2,203,321
123730,5,200,316,14,3,1,2,451,787
121298,8,403,66,3,0,0,0,83,152
66227,9,367,344,5,3,1,5,449,807
31814,5,106,19,3,0,0,1,23,46
70555,5,140,28,4,2,0,0,40,74
77546,9,570,129,9,6,0,1,193,338
141558,9,570,449,30,17,2,2,674,1174
8699,9,630,117,4,1,2,1,132,257
170824,9,570,511,43,20,4,3,804,1385
11675,4,159,3,0,0,0,0,4,7
86837,9,842,3,0,0,0,0,2,5
3363,10,917,412,10,8,0,2,620,1052
101570,7,713,114,2,0,0,1,206,323
4444,4,36,20,0,0,0,0,57,77
83587,9,492,77,0,0,0,0,98,175
4253,6,489,952,23,12,1,7,1535,2530
2167,4,174,24,0,0,0,0,42,66
56992,9,607,26,0,0,0,0,22,48
99366,6,269,197,1,2,0,1,389,590
83155,6,269,71,0,0,0,0,109,180
168404,6,71,410,8,4,1,2,568,993
57496,6,269,173,0,0,0,1,298,472
89682,8,214,214,5,7,0,0,351,577
134303,6,800,142,6,5,0,0,272,425
16362,6,658,12,0,0,0,0,13,25
55668,9,741,274,0,0,0,0,495,769
144042,9,306,917,0,0,0,6,2259,3182
60754,4,36,310,20,6,0,1,506,843
105023,8,214,613,0,0,0,3,836,1452
14687,9,427,23,0,0,0,0,92,115
50831,9,427,100,0,0,0,0,245,345
148302,6,269,87,0,0,0,1,156,244
128147,4,453,28,0,0,0,0,25,53
19756,4,200,79,1,0,1,0,94,175
68201,9,842,299,1,1,0,8,792,1101
57776,4,453,82,1,1,0,0,143,227
9315,8,244,696,21,12,0,11,1592,2332
9845,11,306,247,4,0,0,0,282,533
46746,4,923,171,3,5,0,0,242,421
27021,10,550,141,5,2,0,0,234,382
22319,8,800,28,0,0,0,0,42,70
155914,5,489,736,24,15,0,3,1137,1915
105024,6,124,144,1,1,0,1,225,372
92202,4,200,216,9,1,1,0,363,590
152015,9,325,39,0,0,0,0,57,96
118789,8,885,42,0,0,0,0,67,109
21841,4,800,19,1,0,0,0,17,37
157315,8,489,278,1,1,0,2,474,756
53317,8,214,988,8,1,0,10,1718,2725
47238,8,489,336,3,1,0,0,550,890
92466,8,489,426,4,0,0,3,499,932
71768,9,489,111,8,3,1,0,249,372
144356,9,693,4,0,0,0,0,4,8
53669,8,214,404,7,13,0,1,675,1100
121541,8,489,346,3,0,1,2,509,861
57163,8,403,44,0,0,0,0,57,101
5552,9,545,28,0,0,1,0,38,67
120496,8,214,203,0,0,0,2,277,482
105890,9,693,19,0,0,0,0,20,39
114876,9,842,969,30,15,1,3,1545,2563
135195,9,693,5,0,0,0,0,5,10
73446,9,693,6,0,0,0,0,5,11
87675,9,741,94,0,0,0,0,140,234
21887,9,427,120,0,0,0,1,257,378
59869,9,842,369,8,6,1,1,518,903
149134,6,165,9,0,0,0,0,13,22
39317,6,235,410,13,9,2,3,594,1031
114082,9,306,281,1,1,0,3,489,775
16054,10,820,97,0,0,0,0,139,236
135894,6,290,394,10,7,0,0,585,996
123153,6,263,366,4,2,0,0,471,843
78447,9,367,342,16,4,0,1,466,829
107008,11,403,103,2,0,0,0,103,208
27749,6,821,15,0,0,0,0,24,39
151458,9,86,427,13,6,2,4,632,1084
104607,9,842,126,1,0,0,1,185,313
159565,9,842,877,26,6,3,3,1277,2192
150784,9,86,63,0,0,0,0,97,160
83343,11,693,136,4,0,0,0,165,305
157037,4,36,252,11,4,0,1,423,691
156075,5,655,216,5,1,0,3,352,577
33917,4,427,96,2,1,1,0,148,248
86257,9,86,29,1,0,0,0,53,83
86888,5,124,86,3,2,0,0,151,242
44197,5,124,101,0,0,0,1,124,226
150924,8,214,11,0,0,0,0,19,30
99870,7,800,70,4,3,0,0,157,234
106662,5,124,17,0,0,0,0,21,38
59414,5,655,619,12,7,0,1,971,1610
51168,7,472,17,0,0,0,0,30,47
164460,4,375,122,0,0,0,1,193,316
138604,8,812,133,3,0,0,2,177,315
14425,8,812,318,4,2,1,2,497,824
56233,9,484,90,1,1,0,0,117,209
96105,9,607,337,7,6,1,3,488,842
153190,9,828,6,0,1,0,0,19,26
86244,9,86,11,1,1,0,0,19,32
132039,7,861,40,0,0,2,0,59,101
40985,8,489,189,1,0,0,0,253,443
128832,4,174,19,0,0,0,0,27,46
160990,8,214,540,2,0,0,2,758,1302
128531,7,748,225,5,3,0,1,328,562
92666,5,200,586,11,8,0,4,803,1412
33747,7,404,80,0,0,0,0,126,206
103361,11,214,7,0,0,0,0,9,16
104416,8,812,210,7,4,2,0,383,606
113226,7,575,26,0,0,0,0,46,72
160671,7,575,8,0,0,0,0,21,29
131828,9,341,60,3,1,0,0,84,148
19874,9,640,86,0,0,0,1,126,213
54695,6,789,554,4,1,0,2,958,1519
89463,4,174,16,1,1,0,0,30,48
10661,5,693,67,2,2,0,1,102,174
161063,9,175,93,0,0,11,0,129,233
41984,9,640,74,1,2,0,0,111,188
158573,9,589,57,2,0,0,0,76,135
153685,5,655,59,5,2,0,0,89,155
22926,9,483,7,1,0,0,0,17,25
61020,6,789,70,0,0,0,0,155,225
34839,11,800,74,9,0,1,0,87,171
1539,9,367,991,25,18,3,4,1540,2581
13413,4,159,45,0,1,0,0,64,110
154434,9,367,123,1,1,0,0,166,291
16714,9,375,116,3,1,0,0,263,383
107292,9,375,27,0,0,0,0,76,103
86539,4,800,180,5,3,1,1,255,445
18960,5,251,22,0,0,0,0,33,55
145408,8,801,263,5,2,0,0,416,686
58072,9,640,63,1,1,0,0,89,154
89007,6,51,1295,22,10,4,7,2055,3393
123213,6,106,15,0,0,0,0,30,45
62828,8,658,77,0,0,0,1,119,197
21549,6,885,314,9,3,0,2,537,865
25593,9,100,58,0,0,0,0,144,202
121991,9,100,292,0,0,0,1,472,765
55355,9,100,94,0,0,0,0,182,276
4851,8,658,8,0,0,0,0,10,18
27339,9,640,932,35,12,3,4,1530,2516
20932,8,623,420,11,4,0,5,743,1183
18132,6,232,587,21,10,2,3,951,1574
118927,4,159,657,12,6,0,1,964,1640
148215,6,402,419,3,2,1,2,618,1045
30962,10,917,56,1,1,0,1,127,186
42234,10,917,13,1,0,0,0,37,51
44748,8,214,5,0,0,0,0,7,12
126464,8,214,24,0,0,0,0,31,55
48889,8,812,131,1,1,0,1,209,343
17073,6,78,399,3,2,0,5,606,1015
4633,8,214,54,0,0,0,1,92,147
6815,4,885,28,0,0,0,0,43,71
96715,4,375,6,0,0,0,0,10,16
13324,8,489,950,7,3,0,5,1560,2525
107137,8,623,203,5,4,0,3,400,615
144348,10,66,4,0,0,0,0,47,51
104936,4,270,70,5,3,0,0,104,182
127712,10,66,6,0,0,0,0,45,51
156554,10,66,92,0,0,0,0,146,238
71625,10,66,8,0,0,0,0,52,60
74689,10,66,49,1,1,0,0,105,156
90544,4,306,50,0,0,0,0,85,135
101873,10,66,9,0,0,0,0,49,58
104816,7,587,101,2,3,0,0,162,268
56371,8,174,74,4,2,0,0,105,185
136817,8,174,92,0,0,0,0,118,210
136632,6,885,1334,42,23,5,1,1937,3342
1224,8,623,297,5,3,0,1,471,777
15530,6,251,32,0,0,0,0,34,66
71247,9,630,90,2,2,0,1,111,206
165224,5,159,99,1,2,0,2,178,282
165183,10,111,58,0,1,0,0,132,191
71050,8,800,377,15,9,0,2,591,994
168970,5,225,54,1,0,0,0,88,143
7925,5,225,78,2,1,1,1,124,207
23566,4,36,53,2,2,0,0,100,157
169931,6,263,189,2,0,0,0,207,398
75369,4,159,226,1,0,0,0,406,633
138642,9,630,164,2,0,0,0,219,385
158156,8,800,6,0,0,0,0,6,12
149484,4,885,53,1,0,0,0,77,131
117983,4,752,65,0,1,0,1,94,161
93545,6,165,74,2,1,0,0,107,184
58622,6,301,89,0,1,0,0,167,257
16338,6,901,143,5,4,0,1,193,346
142497,8,489,1281,10,4,0,8,2003,3306
22361,4,658,336,7,6,0,1,553,903
162481,4,306,1,0,0,0,0,3,4
63041,4,159,65,0,0,0,0,105,170
134509,9,78,157,1,1,0,1,256,416
102468,6,570,500,12,8,1,1,856,1378
121877,5,479,115,0,0,0,0,158,273
34212,8,623,415,9,1,0,3,616,1044
164365,6,290,1072,25,21,2,3,1571,2694
12929,4,159,1,0,0,0,0,1,2
72402,6,789,17,0,0,0,0,22,39
148013,4,200,246,2,1,0,3,394,646
33640,10,820,5,1,2,0,0,52,60
78556,10,807,9,0,0,0,0,14,23
153986,8,489,282,7,4,0,1,511,805
139094,8,693,493,4,2,0,2,735,1236
13320,10,355,28,2,0,0,0,44,74
17301,8,489,553,0,0,0,5,845,1403
70552,7,496,130,3,3,0,0,171,307
52728,7,489,194,2,2,0,0,338,536
67820,7,118,61,3,3,0,0,116,183
489,5,225,468,14,7,1,2,780,1272
62707,8,306,671,16,8,0,0,1056,1751
21040,4,306,15392,521,191,53,62,29618,45837
93378,9,100,253,7,1,1,0,438,700
154827,10,205,10,0,0,0,0,31,41
51912,4,453,257,1,0,0,1,634,893
13172,10,172,124,1,1,0,1,259,386
139752,4,174,88,1,1,0,0,126,216
79426,6,306,57,0,0,0,0,68,125
127526,7,535,55,0,0,0,0,84,139
156373,10,790,183,5,2,1,1,402,594
164524,5,821,57,5,4,0,1,80,147
45348,10,790,116,3,3,0,0,254,376
120576,6,58,66,0,0,0,0,95,161
131210,6,570,1775,30,11,2,7,2674,4499
150859,5,78,676,27,12,0,4,943,1662
100050,5,885,54,0,1,0,1,103,159
1770,6,263,109,2,1,0,0,170,282
94455,8,214,365,2,2,0,1,522,892
19196,4,800,47,0,0,0,0,82,129
160686,6,827,304,15,7,3,1,497,827
40093,4,174,43,0,0,0,0,62,105
108073,7,669,18,2,1,0,0,34,55
30037,4,174,53,0,0,0,0,89,142
160656,8,545,79,4,1,1,1,114,200
54091,4,36,112,0,0,0,0,178,290
120831,9,489,283,6,4,0,2,446,741
20507,8,812,39,0,1,0,0,58,98
143273,4,453,427,8,4,0,4,670,1113
167821,8,623,219,1,0,0,0,314,534
73524,5,479,91,1,1,0,0,135,228
55241,4,923,29,2,1,0,0,58,90
98795,6,885,100,3,1,0,0,178,282
129472,7,56,19,1,1,0,0,24,45
14559,7,56,83,0,1,0,1,116,201
143729,9,405,2,0,0,0,0,3,5
91084,4,885,18,0,0,0,0,89,107
75557,4,200,915,16,3,0,1,1484,2419
12079,4,752,166,2,1,0,1,230,400
97455,9,570,299,12,5,2,0,532,850
3489,8,812,95,0,0,0,0,142,237
135924,4,174,22,0,0,0,0,38,60
2331,6,124,136,3,0,0,0,203,342
49058,4,375,142,3,1,0,0,240,386
5880,4,174,18,0,0,0,0,26,44
116710,9,842,358,7,6,0,1,663,1035
94161,9,842,160,2,1,0,1,256,420
112953,8,800,879,41,15,0,2,1644,2581
25775,9,607,78,3,1,0,0,136,218
116543,5,200,34,2,0,0,0,56,92
61772,8,545,47,0,0,0,0,73,120
91437,8,545,665,0,0,0,3,1156,1824
151422,7,118,202,2,1,1,0,264,470
92654,4,453,38,0,0,0,0,85,123
158017,8,812,16,0,0,0,0,12,28
17954,4,375,98,0,0,0,0,144,242
118349,7,698,218,6,3,0,0,310,537
158524,7,587,443,1,1,0,1,660,1106
105629,8,214,520,2,1,0,2,1039,1564
133262,4,519,28,0,0,0,0,41,69
125616,8,623,16,0,0,0,0,8,24
47226,8,124,12,0,0,0,0,8,20
169000,7,61,69,1,0,0,0,116,186
114369,4,800,243,5,6,0,2,409,665
96862,5,58,145,0,0,0,0,234,379
18827,6,235,8,0,0,0,0,10,18
41948,9,545,250,8,4,0,2,363,627
46706,10,781,2,0,1,0,0,4,7
155862,5,174,131,0,1,0,2,163,297
151074,7,489,84,0,0,0,0,120,204
40380,7,563,76,4,2,0,0,115,197
66371,6,453,69,5,0,0,0,99,173
10230,6,263,112,3,3,0,1,163,282
99153,6,366,128,9,7,0,0,164,308
142823,4,591,3,0,0,0,0,8,11
30767,9,375,67,1,1,0,0,132,201
108560,4,923,151,2,1,0,0,269,423
150467,8,214,66,1,1,0,0,102,170
52074,8,800,1,0,0,0,0,0,1
77308,11,306,27,2,0,0,0,39,68
63463,9,100,438,1,0,0,4,812,1255
152286,4,752,1,0,0,0,0,0,1
118783,4,200,355,7,3,1,1,551,918
129329,9,374,181,3,3,0,0,272,459
137166,10,752,266,5,3,0,1,386,661
22100,7,713,93,4,1,0,0,204,302
59935,6,489,807,25,10,1,7,1313,2163
9784,4,519,182,1,1,0,1,430,615
128016,9,157,511,34,16,3,5,762,1331
153310,6,489,40,0,0,0,0,56,96
109598,9,800,770,18,14,2,4,993,1801
136359,5,4,16,1,1,0,0,39,57
128484,9,842,235,10,5,0,0,425,675
59902,9,374,24,0,0,0,0,39,63
144508,9,483,17,0,0,0,0,28,45
6812,7,489,209,2,0,0,2,275,488
29070,9,374,42,0,1,0,1,84,128
115782,8,885,1145,49,19,2,7,2227,3449
43571,9,484,25,1,1,0,0,44,71
118069,9,427,124,0,0,0,1,193,318
80713,9,489,279,0,0,0,6,950,1235
70134,6,427,536,14,5,2,4,983,1544
1051,8,214,1468,40,17,0,9,2931,4465
112906,4,581,73,0,0,0,0,130,203
150851,9,484,14,0,0,0,0,36,50
86723,9,484,48,0,0,0,0,76,124
142441,5,355,454,6,5,0,2,620,1087
16281,9,158,262,5,3,0,1,374,645
17600,5,78,122,4,1,0,0,172,299
85456,8,885,289,8,2,0,0,437,736
24407,9,589,154,5,4,0,1,254,418
129583,6,235,92,0,0,0,0,133,225
39989,10,40,221,1,1,0,1,277,501
141471,9,157,10,0,0,0,0,8,18
129064,7,489,63,1,0,0,0,64,128
69801,10,200,94,2,1,0,1,182,280
124032,6,570,340,4,2,0,1,444,791
5697,4,752,8,0,0,0,0,6,14
130921,8,800,183,10,2,0,0,246,441
44933,10,377,2,0,0,0,0,3,5
1905,9,800,37,2,4,0,0,49,92
136901,9,842,53,1,1,0,0,111,166
156831,5,200,115,0,0,0,0,158,273
87902,9,800,61,1,1,0,1,110,174
8452,4,220,1630,57,17,4,7,2785,4500
131508,5,140,46,0,0,0,1,64,111
15031,5,78,266,5,3,0,1,402,677
26288,5,263,1,0,0,0,0,2,3
111620,5,479,624,15,12,2,3,1037,1693
124614,7,472,180,6,4,2,0,299,491
94722,5,78,107,2,1,0,1,167,278
148995,9,589,72,0,0,0,1,189,262
85750,5,821,48,1,0,0,0,85,134
157157,4,658,10,1,0,0,0,8,19
110116,6,306,247,1,1,0,2,397,648
4383,4,581,253,0,0,0,2,411,666
152598,5,479,248,0,0,0,1,387,636
68990,7,748,91,0,0,0,2,116,209
95932,7,748,60,3,1,0,0,118,182
126614,7,748,223,4,2,0,0,351,580
145746,4,658,29,0,0,0,0,42,71
64346,9,158,487,17,5,2,0,619,1130
55171,9,607,135,8,4,0,1,229,377
103585,5,218,6,0,0,0,0,7,13
86546,9,374,47,0,0,0,0,82,129
114856,8,214,409,3,1,1,1,797,1212
126602,8,214,319,7,3,0,0,724,1053
114109,4,800,173,5,2,0,1,287,468
137606,6,59,364,15,8,1,4,756,1148
754,4,800,155,2,1,0,2,218,378
18658,5,176,269,9,2,3,1,377,661
135680,9,374,115,2,1,0,0,168,286
79374,8,489,334,1,1,0,1,513,850
84023,6,416,349,6,6,0,0,562,923
156426,7,496,115,2,1,0,0,234,352
56032,6,404,149,0,0,0,0,233,382
93586,6,159,144,0,0,0,0,197,341
54080,4,159,40,1,0,0,0,66,107
25043,5,893,210,12,5,3,1,390,621
6675,9,427,51,0,0,0,1,156,208
99631,5,355,247,2,0,0,1,331,581
165040,9,630,111,0,0,0,1,209,321
90360,5,235,25,0,0,0,0,28,53
396,7,657,49,2,1,0,0,62,114
87272,7,457,19,0,0,0,0,7,26
81992,7,457,1,0,0,0,0,1,2
134497,9,630,713,0,0,0,4,1141,1858
18921,7,587,50,0,1,0,0,71,122
31255,6,235,15,0,0,0,0,29,44
75835,7,157,160,2,0,0,0,311,473
18726,6,159,46,0,0,0,0,49,95
81600,8,885,840,22,9,0,4,1398,2273
165017,7,429,41,0,0,0,1,78,120
148397,4,658,117,1,1,0,0,229,348
55215,9,842,256,11,6,0,0,426,699
96138,8,766,124,2,1,0,0,189,316
136797,7,226,49,4,1,0,1,95,150
44626,10,36,34,0,0,0,0,56,90
85264,9,302,50,1,1,0,0,111,163
28921,7,496,126,7,2,1,0,339,475
151051,7,496,96,4,2,0,2,164,268
106388,9,78,237,0,0,0,0,314,551
71675,7,824,81,0,0,0,0,112,193
82310,7,824,20,0,0,0,0,29,49
24975,9,630,269,16,16,0,3,405,709
19625,7,126,7,0,0,0,0,4,11
170841,5,218,98,3,2,0,2,181,286
132899,7,118,241,9,4,2,2,389,647
11526,7,144,30,0,0,0,0,54,84
10761,4,885,91,0,0,0,0,142,233
116965,4,658,67,0,0,0,0,118,185
8543,7,872,75,2,1,0,0,110,188
139654,6,124,344,14,9,0,4,423,794
89141,4,752,240,2,0,0,0,348,590
89124,5,699,182,2,1,0,0,286,471
88331,5,218,25,1,0,1,0,41,68
100221,4,658,98,2,2,0,0,172,274
11092,4,658,167,5,4,0,2,264,442
121886,10,40,569,16,5,0,3,800,1393
90924,7,126,70,1,0,1,3,10,85
76659,6,59,127,0,1,0,0,251,379
68891,5,570,51,0,0,0,0,58,109
35698,10,40,106,3,1,0,0,161,271
169521,7,126,8,0,0,0,0,6,14
19711,5,355,143,6,3,3,0,190,345
51561,8,214,55,0,1,0,0,84,140
48954,9,302,194,8,3,0,1,281,487
158418,6,269,68,0,0,0,0,116,184
80068,9,302,51,0,0,0,2,118,171
37201,7,631,5,0,0,0,0,5,10
38792,6,890,27,1,1,0,0,47,76
46685,9,302,48,0,0,0,0,160,208
150146,9,78,512,0,0,0,5,740,1257
141902,4,427,561,20,6,1,0,1006,1594
55399,8,623,367,9,3,0,1,562,942
12372,8,812,264,5,2,1,3,378,653
118598,4,200,90,1,1,0,0,118,210
112400,5,821,256,4,0,1,3,590,854
88012,5,238,122,2,1,0,1,229,355
96506,8,545,345,3,2,0,2,603,955
167755,7,748,51,0,0,0,0,102,153
12509,7,535,70,0,0,0,2,123,195
86998,10,797,58,2,1,0,0,88,149
166958,5,176,8,0,0,0,1,11,20
96126,4,174,23,0,0,0,0,39,62
103628,6,821,13,0,0,0,1,30,44
88791,8,214,550,3,1,0,0,932,1486
133328,9,575,420,8,9,0,5,667,1109
47719,7,521,148,3,2,1,0,239,393
51655,6,124,76,1,1,0,0,95,173
143133,7,587,58,0,0,0,0,72,130
126932,6,124,58,3,3,0,0,94,158
75410,8,214,115,3,1,0,1,213,333
145110,9,107,8,0,0,0,0,11,19
140588,7,657,139,9,4,2,0,231,385
116331,7,100,51,0,0,0,1,127,179
97054,7,489,37,0,0,0,0,49,86
133251,5,78,198,5,0,0,0,331,534
13557,6,366,306,5,3,0,0,405,719
16228,4,200,30,1,1,0,0,38,70
42383,7,660,14,0,0,0,0,21,35
40230,4,658,26,0,0,0,0,47,73
43666,6,103,24,0,0,0,0,40,64
88691,7,570,64,0,0,0,0,115,179
71089,5,176,40,1,1,0,0,101,143
17401,7,61,29,0,0,0,0,22,51
99074,4,174,59,0,0,0,1,89,149
110251,5,140,185,5,2,0,0,228,420
67467,6,693,27,1,1,0,0,30,59
8751,7,669,3,0,0,0,0,5,8
136213,7,669,8,0,0,0,0,30,38
39438,8,658,8,0,0,0,0,9,17
96735,8,800,211,12,2,1,1,265,492
4508,6,124,3,0,0,0,0,4,7
25511,9,842,517,11,6,1,1,920,1456
149081,9,842,279,0,0,0,1,634,914
4979,4,36,447,9,4,0,0,738,1198
66924,8,30,629,5,4,0,2,970,1610
1802,9,741,295,0,0,0,4,448,747
102213,6,209,168,6,2,3,3,298,480
118167,8,596,1062,26,14,2,5,2068,3177
125412,8,885,377,20,4,0,4,713,1118
46667,8,885,171,2,1,0,0,248,422
168597,5,404,49,0,0,0,0,69,118
70153,5,225,4407,149,67,24,23,8074,12744
53874,8,812,222,2,0,0,1,260,485
153813,10,63,116,6,6,0,1,229,358
137626,8,812,243,6,2,0,2,305,558
142894,9,107,165,11,4,2,0,225,407
169231,4,890,891,17,11,1,7,1318,2245
152536,9,630,854,3,1,0,4,2120,2982
157513,7,196,20,0,0,0,0,43,63
148560,8,214,107,1,0,0,1,194,303
59227,7,489,333,2,1,0,0,585,921
100818,5,381,140,5,2,0,0,209,356
144213,9,65,18,0,0,0,0,38,56
55242,7,196,10,0,0,0,0,20,30
142543,8,489,111,3,0,0,0,184,298
104495,7,78,536,22,10,2,2,935,1507
77941,7,196,34,0,1,0,0,68,103
123430,6,489,1777,85,41,4,10,2891,4808
63785,9,631,104,2,1,1,0,152,260
86623,9,589,12,0,0,0,0,14,26
93320,8,214,71,1,1,0,1,82,156
170390,7,157,79,9,3,0,2,138,231
77061,7,157,550,13,5,1,1,768,1338
77484,4,885,225,2,0,0,0,308,535
69391,7,587,2951,67,29,1,17,5199,8264
158558,9,640,308,4,3,0,2,412,729
70690,7,175,104,5,5,0,1,347,462
69371,4,923,44,2,2,0,0,83,131
122056,4,220,28,1,0,0,0,35,64
163739,7,78,1,0,0,0,0,1,2
168976,5,200,435,2,2,0,2,614,1055
51200,7,404,90,0,0,0,0,148,238
10915,9,630,4,0,0,0,0,5,9
62147,4,270,19,0,0,0,0,31,50
75134,8,214,193,0,0,0,0,288,481
113779,5,306,93,0,1,0,0,165,259
155825,9,302,29,1,0,0,0,51,81
96908,9,78,631,0,0,0,7,845,1483
50164,6,124,199,8,1,0,1,263,472
55849,8,214,849,19,9,2,3,1367,2249
84561,6,124,168,3,4,0,2,299,476
121071,7,587,241,11,2,0,0,404,658
107392,9,78,13,0,0,0,0,16,29
35064,9,78,353,8,6,0,5,466,838
83256,5,371,79,7,2,0,0,170,258
33672,9,107,60,6,2,2,0,189,259
147483,4,453,189,9,1,0,1,308,508
69045,7,909,272,3,3,0,2,367,647
116559,7,118,131,3,2,0,1,185,322
46493,4,36,132,0,0,0,3,203,338
138690,9,842,195,4,3,0,0,457,659
136861,9,741,426,0,0,0,3,705,1134
121404,4,885,178,2,0,0,0,318,498
40879,4,658,50,0,0,0,0,73,123
13299,4,923,38,0,2,0,0,67,107
84649,10,519,162,1,1,0,2,236,402
150133,6,366,202,1,4,0,1,267,475
93512,6,570,49,2,1,0,0,120,172
7857,4,658,142,0,0,0,1,289,432
54124,8,214,32,0,0,0,0,16,48
64813,11,800,152,14,0,0,0,188,354
93841,6,221,21,0,0,0,0,32,53
143947,4,200,25,0,0,0,1,51,77
118088,7,216,107,0,0,0,0,187,294
167474,7,587,60,0,0,0,0,83,143
162503,8,214,438,5,1,0,1,651,1096
9624,4,800,163,0,0,0,1,249,413
22673,4,885,4,0,0,0,0,3,7
84384,4,800,28,0,0,0,0,52,80
167531,6,489,5,0,0,0,0,6,11
49267,4,923,99,2,1,0,0,141,243
19382,9,145,661,14,7,0,1,1026,1709
118090,9,589,118,2,2,1,1,221,345
131609,7,157,31,0,0,0,0,53,84
21217,4,375,69,0,0,0,0,104,173
145077,6,200,293,8,6,0,1,424,732
90705,4,752,11,0,0,0,0,21,32
23496,8,214,622,1,0,0,4,1206,1833
94667,6,200,102,0,0,0,0,151,253
32343,6,200,44,0,0,0,1,58,103
100333,5,489,768,30,14,1,4,1120,1937
44509,8,214,882,11,4,2,1,1249,2149
155872,4,453,160,0,0,0,0,219,379
10587,8,489,476,16,4,2,2,753,1253
63348,5,59,192,12,3,1,1,355,564
131810,6,165,49,0,0,0,0,114,163
63147,6,368,64,1,1,0,1,82,149
19826,4,800,397,10,4,1,3,661,1076
73679,7,144,6,0,0,0,0,9,15
101363,11,214,11,0,0,0,0,13,24
65045,7,521,98,1,0,1,0,173,273
134531,8,812,134,6,2,0,2,195,339
83218,6,368,17,1,1,0,1,21,41
158542,4,375,335,9,7,1,1,609,962
84716,4,658,81,2,0,0,1,158,242
45108,6,103,33,0,0,0,0,85,118
64386,7,489,368,7,4,1,3,580,963
58161,5,200,35,1,0,0,0,51,87
83238,7,30,88,2,2,0,1,176,269
96922,5,200,13,1,1,0,0,21,36
149807,4,885,124,0,1,0,1,186,312
39851,8,214,329,7,2,0,1,500,839
69181,11,693,240,10,0,0,0,254,504
46540,8,800,177,2,1,0,3,239,422
117837,8,812,440,5,3,1,3,618,1070
120075,9,575,1,0,0,0,0,1,2
54867,8,124,1,0,0,0,0,1,2
40929,9,489,187,1,1,0,3,262,454
160496,6,885,511,13,7,0,3,761,1295
79475,6,821,1,0,0,0,0,1,2
141849,9,630,408,8,4,0,2,527,949
112013,4,174,13,0,0,0,0,19,32
50367,6,159,25,0,0,0,0,32,57
5874,6,296,1213,37,14,3,3,1814,3084
120812,6,290,86,3,1,1,0,134,225
49712,4,752,134,1,0,0,1,194,330
88829,8,800,72,1,0,0,0,108,181
90690,9,842,3,0,0,0,0,1,4
108859,8,427,424,16,4,1,3,809,1257
63070,4,200,19,0,0,0,0,20,39
48518,6,140,64,0,0,0,0,93,157
66609,8,545,18,0,0,0,0,27,45
69935,6,209,15,0,0,0,0,24,39
25357,6,209,39,0,0,0,0,59,98
86856,10,820,136,1,2,0,0,198,337
122024,10,820,65,0,0,0,0,118,183
150710,10,653,245,4,4,0,2,354,609
61989,10,200,50,0,0,0,0,106,156
11154,6,235,1287,19,12,0,5,2635,3958
49275,6,570,192,4,1,1,4,297,499
93239,10,820,4,0,0,0,0,5,9
11379,6,200,94,1,1,0,3,166,265
11543,9,630,100,0,0,0,1,133,234
94283,8,214,1258,29,7,1,9,2057,3361
74386,4,300,7,0,0,0,0,3,10
61015,10,820,14,0,0,0,0,19,33
76292,4,658,84,0,0,0,0,177,261
62741,7,660,9,0,0,0,0,12,21
53834,5,118,142,5,3,0,1,196,347
87935,6,106,170,2,0,0,2,291,465
85818,7,196,32,2,1,0,0,56,91
117739,6,693,919,18,15,1,7,1280,2240
91281,10,807,72,1,0,0,0,88,161
29114,9,741,189,0,0,0,0,450,639
146241,7,885,29,1,0,0,0,38,68
44202,4,519,120,4,1,1,2,233,361
158634,5,306,67,1,0,0,0,84,152
119037,4,658,67,1,0,0,1,220,289
131782,9,842,127,0,0,0,1,188,316
113638,9,842,84,0,0,0,0,130,214
64473,11,427,12,0,0,0,0,13,25
155251,10,474,376,2,2,0,0,542,922
77048,6,135,765,37,21,0,1,1312,2136
107688,6,263,252,8,6,0,0,321,587
53030,6,209,156,8,5,1,1,197,368
123190,7,157,2,0,0,0,0,2,4
136382,8,214,375,8,1,0,1,563,948
90152,7,157,2,0,0,0,0,5,7
22731,9,800,149,6,2,0,4,166,327
62926,6,489,1782,48,37,1,12,2629,4509
47503,7,861,29,1,0,0,0,52,82
64892,9,575,71,2,2,0,1,90,166
133529,4,375,14,0,0,0,0,15,29
67672,4,885,210,0,0,0,1,293,504
136176,7,587,381,4,2,0,0,576,963
58805,4,658,64,0,0,0,1,161,226
110540,8,885,500,4,0,0,2,685,1191
11352,9,306,46,0,0,0,0,62,108
139181,7,484,9,0,0,0,0,11,20
118755,8,623,420,4,2,0,3,693,1122
75738,4,923,5,0,0,0,0,0,5
138885,4,159,799,14,8,0,6,1220,2047
132914,8,800,644,12,3,0,1,1006,1666
66858,5,479,90,0,0,0,0,136,226
151183,9,489,223,0,1,0,1,430,655
117848,9,640,838,15,10,3,9,1123,1998
121898,8,800,30,0,0,0,1,36,67
52558,11,693,6,0,0,0,0,5,11
37794,11,885,96,7,0,0,0,121,224
126882,4,800,71,3,2,0,0,139,215
101044,6,453,128,2,1,0,1,233,365
1886,8,214,629,11,4,0,3,849,1496
59040,8,885,491,5,2,0,2,822,1322
103110,6,78,45,0,0,0,0,61,106
91541,8,214,76,0,0,0,1,125,202
74139,7,842,1104,44,15,4,7,1875,3049
36200,4,174,106,0,0,0,0,162,268
8939,4,638,526,6,3,2,2,718,1257
92794,6,232,173,4,1,0,0,252,430
71687,7,521,224,4,4,0,0,327,559
78020,8,214,423,13,6,0,3,782,1227
127244,8,214,516,0,0,0,0,753,1269
129984,8,214,410,0,0,0,1,645,1056
111572,10,208,52,0,0,0,1,92,145
134725,8,214,155,0,0,0,1,191,347
162990,8,214,306,4,3,0,0,508,821
147598,10,29,51,1,1,0,0,80,133
37217,7,842,419,14,3,2,5,590,1033
41111,4,752,132,0,0,0,0,160,292
148893,7,384,125,6,2,0,1,191,325
10353,4,658,122,0,0,0,3,420,545
52956,7,489,432,7,7,0,5,712,1163
18290,8,306,352,2,1,0,4,547,906
56942,10,40,96,0,0,0,1,136,233
95734,7,384,401,6,2,1,1,488,899
49342,7,484,4,0,0,0,0,7,11
160649,6,843,101,0,0,0,0,184,285
140321,7,484,4,0,0,0,0,4,8
144531,7,74,665,12,4,1,1,1030,1713
18452,7,194,58,1,1,0,0,77,137
128096,7,508,79,1,1,0,0,212,293
93877,7,587,23,0,0,0,0,37,60
161698,7,587,20,0,0,0,0,20,40
65963,7,587,58,0,0,0,0,107,165
57462,6,785,170,1,1,0,1,238,411
22017,7,587,20,0,0,0,0,36,56
159085,4,36,125,6,0,0,0,203,334
146919,4,200,167,3,1,0,0,254,425
170073,7,484,8,0,0,0,0,9,17
77150,6,489,10,0,0,0,0,11,21
60766,7,587,16,0,0,0,0,53,69
150040,4,174,24,0,0,0,0,40,64
37742,4,375,29,0,0,0,0,46,75
124985,9,640,982,29,14,0,5,1517,2547
136460,4,453,16,0,0,0,0,15,31
108040,7,521,58,3,1,0,1,101,164
122306,9,632,2,0,0,0,0,0,2
55576,4,199,29,1,0,0,0,21,51
28910,11,677,10,0,0,0,0,8,18
77338,11,489,205,18,0,0,0,249,472
107751,7,484,23,0,0,0,0,42,65
104468,8,800,170,7,4,0,2,279,462
118560,7,216,1236,15,10,0,7,2823,4091
114591,9,640,170,2,1,0,0,236,409
40129,10,413,2,0,0,0,0,2,4
23890,9,158,12,0,1,0,0,33,46
150244,9,640,148,0,0,0,3,208,359
75583,9,640,137,2,0,0,1,190,330
87957,7,312,12,0,0,0,0,17,29
90494,10,208,19,1,1,0,0,31,52
112425,4,885,174,0,0,0,1,247,422
41531,9,910,9,0,0,0,0,7,16
113993,8,800,24,0,0,0,0,46,70
20717,8,623,66,0,0,0,0,110,176
91062,5,570,208,10,4,1,0,271,494
28779,8,545,233,4,1,0,2,360,600
113098,11,214,29,0,0,0,0,40,69
119720,7,489,3,0,0,0,0,6,9
72952,4,174,13,0,0,0,0,19,32
153194,9,560,6,0,0,0,0,9,15
9925,5,59,993,42,17,4,4,1586,2646
159098,11,489,3,0,0,0,0,2,5
57209,9,489,283,0,0,0,1,406,690
143671,8,214,1056,0,2,0,5,1568,2631
23758,9,427,84,0,0,0,1,349,434
166110,4,174,77,0,0,0,0,76,153
143331,9,306,469,0,0,0,9,1251,1729
159263,4,174,135,4,1,1,2,257,400
41288,4,174,85,0,0,0,1,126,212
28720,6,306,5,0,0,0,0,9,14
9533,4,453,64,0,0,0,0,100,164
163193,9,175,24,0,0,11,0,37,72
75809,7,175,37,0,0,10,0,57,104
166269,9,589,243,0,0,1,0,291,535
140166,8,214,2509,67,26,2,11,4139,6754
50081,11,403,406,46,0,0,0,448,900
29805,8,800,46,0,0,0,0,70,116
123974,7,157,753,13,10,1,2,1276,2055
108577,5,176,15,0,0,0,0,22,37
126659,5,306,73,0,0,0,0,94,167
117126,5,489,854,34,14,2,2,1297,2203
5823,7,226,14,0,0,1,0,37,52
62737,7,521,88,4,1,0,0,136,229
73192,4,36,178,4,4,0,2,247,435
118913,9,842,869,31,16,1,4,1543,2464
82995,9,640,304,2,1,0,1,540,848
77589,8,214,391,4,2,1,1,678,1077
115383,6,269,247,3,1,0,1,383,635
117893,7,24,210,6,1,2,0,351,570
154327,7,384,6,0,0,0,0,8,14
847,4,174,10,0,0,0,0,23,33
83274,10,523,8,0,0,0,0,13,21
37672,10,111,155,4,2,0,0,237,398
168737,8,124,4,0,0,0,0,4,8
119872,7,892,4,0,0,0,0,7,11
27912,5,893,3,0,0,0,0,1,4
151102,7,892,4,0,0,0,0,4,8
36185,10,63,34,0,0,0,0,94,128
51177,9,367,1189,37,21,8,4,2477,3736
156595,8,214,76,0,0,0,0,121,197
11247,8,306,17,0,0,0,0,14,31
75333,5,693,438,8,2,0,1,648,1097
150256,7,196,57,1,0,0,0,100,158
120692,8,214,79,0,0,0,0,111,190
144157,8,214,449,8,3,0,0,767,1227
150210,10,701,158,2,2,0,1,277,440
150953,8,658,31,1,0,0,0,34,66
88208,5,489,89,1,0,0,0,112,202
74708,6,209,18,0,0,0,0,32,50
23575,5,489,218,4,3,1,1,320,547
48746,7,196,171,3,3,0,0,257,434
149032,6,235,102,1,1,0,0,141,245
6238,8,214,1482,44,12,3,6,2733,4280
34012,7,196,31,1,1,0,0,79,112
104793,4,124,37,0,0,0,0,52,89
113614,7,391,15,0,0,0,0,24,39
82356,7,892,8,0,0,0,0,9,17
129179,9,374,76,2,0,0,0,113,191
19881,7,74,9,0,0,0,0,13,22
110572,9,640,2754,0,0,0,15,3969,6738
55828,9,427,151,0,0,0,0,291,442
130548,8,214,386,0,0,0,1,428,815
82968,5,404,646,0,0,0,1,1008,1655
59515,8,214,235,5,2,0,5,435,682
155500,7,228,22,1,1,0,0,31,55
46895,4,890,87,1,0,0,0,146,234
65477,8,214,110,0,0,0,0,135,245
148767,8,658,60,1,0,0,0,83,144
95311,7,892,8,0,0,0,0,15,23
13368,10,752,21,0,0,0,0,39,60
92547,7,196,28,0,0,0,0,31,59
165381,4,159,39,0,0,0,0,62,101
166619,7,79,1032,21,12,5,2,1512,2584
9566,8,214,709,7,2,0,3,1084,1805
111077,4,908,2,0,0,0,0,3,5
43168,9,374,24,2,1,0,0,24,51
143925,9,462,9,0,0,0,0,16,25
53879,4,890,317,2,1,0,2,483,805
100673,4,885,7,0,0,0,0,7,14
106947,8,214,148,3,0,0,1,437,589
149447,8,214,296,0,0,0,1,598,895
169655,4,453,115,0,0,0,1,178,294
85827,4,200,177,4,1,0,0,279,461
100250,7,157,674,8,5,1,2,1082,1772
102373,9,100,650,21,5,3,0,927,1606
23079,9,800,163,7,1,1,2,407,581
85688,5,225,11,0,0,0,0,24,35
65189,9,800,29,0,0,0,0,140,169
143771,7,484,18,1,1,0,0,26,46
132519,4,174,128,2,1,0,1,184,316
135517,4,890,233,3,0,0,0,333,569
170325,7,484,12,2,0,0,0,35,49
32812,9,427,203,0,0,0,3,494,700
8718,10,63,94,0,0,0,1,198,293
2905,7,587,1012,23,17,2,3,1391,2448
92980,9,800,21,0,0,0,0,47,68
91754,9,800,9,0,0,0,0,77,86
103394,7,587,556,12,8,0,1,725,1302
158603,4,300,263,5,2,0,5,424,699
59359,7,563,28,0,0,0,0,35,63
77721,4,174,12,0,0,0,0,20,32
17013,6,269,15,0,0,0,0,10,25
52596,8,214,1036,5,5,0,5,1433,2484
2662,4,174,69,0,0,0,1,113,183
159555,9,100,96,0,0,0,0,238,334
81051,8,214,423,0,0,0,0,520,943
56389,8,885,129,3,1,0,1,169,303
161565,8,658,685,23,11,0,4,1135,1858
30440,8,403,295,2,2,0,0,434,733
43430,6,489,141,8,7,0,2,281,439
155715,9,483,25,2,0,0,0,53,80
35279,4,885,31,0,0,0,0,47,78
102769,9,483,15,1,0,0,1,30,47
121659,8,885,357,0,0,0,2,481,840
29143,8,885,36,0,0,0,0,51,87
153300,9,483,8,0,0,0,0,38,46
142237,9,483,1,0,0,0,0,8,9
167258,9,375,56,1,1,0,0,110,168
150552,8,214,562,13,6,1,1,901,1484
118521,9,30,112,1,1,0,0,186,300
20385,9,30,71,1,1,0,0,140,213
16139,9,30,102,2,1,0,0,169,274
22874,9,30,27,1,1,0,0,55,84
36374,9,30,43,1,1,0,0,106,151
144579,9,30,2,0,0,0,0,13,15
38123,8,623,171,0,0,0,0,260,431
106496,9,741,362,0,0,0,2,516,880
4667,4,159,347,5,2,0,2,552,908
47390,9,483,2,0,0,0,0,3,5
40169,11,812,192,2,0,0,0,191,385
52901,9,374,12,4,1,0,0,16,33
78787,10,550,2,0,0,0,0,11,13
170410,7,535,170,0,1,0,0,266,437
8031,4,159,107,2,2,0,0,141,252
77067,9,800,46,1,2,0,0,66,115
149572,6,78,138,10,5,0,0,210,363
33025,4,800,16,0,0,0,0,22,38
130249,6,140,40,3,2,0,0,86,131
3094,6,200,239,4,3,0,1,316,563
144119,5,556,17,1,2,0,0,26,46
159481,4,658,447,3,2,0,1,632,1085
61975,6,124,105,3,1,0,0,166,275
78227,6,124,137,9,4,0,2,144,296
110559,6,200,185,3,4,0,0,265,457
35573,7,484,15,2,2,0,0,27,46
75749,7,226,10,0,0,0,0,22,32
103824,11,800,333,16,0,0,0,354,703
10372,10,111,387,12,8,0,1,572,980
21550,7,74,40,2,1,0,1,60,104
117841,4,800,283,4,1,0,3,426,717
593,10,917,33,0,1,0,1,98,133
49558,8,623,38,4,2,0,0,75,119
10365,5,296,187,2,2,0,1,288,480
127707,8,403,50,1,1,0,1,65,118
3861,10,781,16,0,0,0,0,32,48
19636,6,78,108,3,2,0,1,182,296
94776,7,741,39,0,0,0,0,57,96
13506,7,741,42,3,1,0,0,59,105
26047,7,563,122,13,5,1,3,284,428
130610,10,474,71,4,1,0,2,144,222
40321,10,256,154,1,1,0,1,230,387
21775,10,256,63,1,1,0,0,95,160
71560,10,256,15,0,0,0,0,35,50
17285,5,159,141,7,6,0,0,203,357
90000,9,427,54,0,0,0,0,187,241
75724,7,56,130,6,2,3,0,131,272
43259,7,563,65,1,1,1,0,148,216
129811,11,693,178,2,0,0,0,202,382
21456,9,8,92,0,0,0,0,154,246
108827,9,800,1,0,0,0,0,0,1
40458,7,306,1,0,0,0,0,0,1
71406,7,306,27,0,0,0,0,96,123
51592,9,399,40,4,2,0,0,113,159
138618,4,923,69,3,3,0,1,112,188
98883,4,174,31,0,0,0,0,49,80
51453,7,306,119,0,0,0,1,213,333
111763,7,741,47,1,1,0,1,78,128
13234,10,81,2,0,0,0,0,4,6
124121,4,36,191,4,3,0,2,310,510
50254,7,669,12,0,0,0,0,17,29
147740,5,893,374,13,4,1,0,617,1009
26210,7,741,19,0,0,0,0,29,48
95050,9,630,3,0,0,0,0,1,4
36669,9,483,2,0,0,0,0,3,5
64471,9,427,94,0,0,0,0,207,301
57303,10,355,42,0,0,0,0,36,78
10434,10,355,9,0,0,0,0,13,22
2243,10,355,38,1,1,0,0,54,94
166574,4,36,91,0,0,0,0,149,240
164252,8,800,7521,422,175,37,47,12199,20401
121418,10,205,12,0,0,0,0,37,49
65119,7,587,12,0,0,0,0,18,30
140705,10,816,3,0,0,0,0,6,9
157740,10,355,69,0,1,1,0,89,160
152035,10,653,52,0,1,0,0,108,161
60111,4,890,494,5,3,0,1,722,1225
162158,9,30,4,0,0,0,0,10,14
70765,4,890,183,1,1,0,0,249,434
112842,11,214,41,0,0,0,0,47,88
106175,8,489,11,5,0,0,0,13,29
26376,6,263,223,0,0,0,0,361,584
82050,6,232,108,3,3,0,0,194,308
28437,4,159,56,0,0,0,1,80,137
68195,8,658,65,1,0,0,0,105,171
105731,4,375,68,0,0,0,0,100,168
75389,6,232,74,3,0,0,0,129,206
146003,6,518,216,4,1,0,1,345,567
118531,4,885,37,0,0,0,0,52,89
124778,6,518,12,0,0,0,0,17,29
80988,6,518,28,0,0,0,0,42,70
32588,4,658,68,0,1,0,1,83,153
161112,4,36,292,5,4,0,1,487,789
70878,8,209,13,1,0,0,0,19,33
96204,7,387,218,5,3,1,0,360,587
146630,4,923,75,2,1,0,0,98,176
37840,8,209,29,0,1,0,0,39,69
146135,10,917,85,1,1,0,1,120,208
85256,6,209,400,20,11,1,2,613,1047
17613,11,30,8,0,0,0,0,6,14
128418,9,469,52,0,0,0,0,103,155
33192,9,469,16,0,0,0,0,36,52
14398,8,403,312,4,2,0,0,487,805
21725,7,587,142,5,2,0,0,223,372
131482,8,214,934,12,6,0,1,1788,2741
93509,9,570,210,5,4,0,1,402,622
104001,8,403,245,0,0,0,0,385,630
94882,10,701,67,2,2,0,0,113,184
97720,6,404,81,0,0,0,0,91,172
102340,4,200,497,9,0,0,2,814,1322
52767,6,232,7,1,0,0,0,5,13
38266,6,232,21,1,0,0,0,29,51
160551,6,366,133,1,0,0,1,214,349
145429,7,46,20,2,2,0,1,50,75
60637,10,797,60,0,1,0,1,97,159
13177,6,885,106,2,1,0,1,178,288
128868,6,78,61,3,2,0,1,58,125
124398,9,640,942,8,0,0,0,1250,2200
122312,7,46,133,5,2,1,0,197,338
139168,9,427,77,0,0,0,1,164,242
106005,9,427,10,0,0,0,0,40,50
116736,5,893,41,0,0,0,0,54,95
154080,7,641,347,5,3,0,1,590,946
10609,7,641,194,2,1,0,1,302,500
72268,10,111,268,2,2,0,1,359,632
61742,9,100,294,7,5,2,2,514,824
1312,8,214,2,0,0,0,0,4,6
9628,9,100,43,0,0,0,0,56,99
66467,11,306,41,1,0,0,0,45,87
50174,8,812,783,33,15,1,6,1371,2209
96823,7,118,78,1,0,0,0,166,245
124810,11,885,399,14,0,0,0,439,852
65944,4,36,149,1,1,1,0,219,371
28501,7,496,116,1,0,0,0,210,327
53218,8,800,350,19,6,0,3,539,917
32982,9,100,266,6,3,0,3,385,663
83099,4,36,81,0,0,0,0,110,191
142403,8,545,29,0,0,0,0,33,62
10316,8,214,1491,39,15,3,10,2225,3783
154274,8,766,21,0,0,0,0,35,56
75358,5,479,837,44,20,4,5,1486,2396
44205,9,842,487,0,0,0,5,1270,1762
28267,6,159,302,4,1,0,0,461,768
101413,8,693,19,0,0,0,0,21,40
51151,8,800,109,1,1,0,0,195,306
134968,5,489,227,5,3,0,2,382,619
114037,8,403,520,15,8,0,4,856,1403
768,9,607,206,12,5,0,3,434,660
167986,9,314,304,10,1,2,0,427,744
92416,9,471,45,3,0,0,0,94,142
112016,4,725,72,0,0,0,0,95,167
108145,9,315,178,8,2,0,1,270,459
45042,4,885,490,1,1,0,3,723,1218
14835,8,214,84,0,0,0,0,158,242
126450,8,214,290,2,2,0,1,436,731
159008,9,157,234,0,0,0,1,527,762
24599,7,484,36,0,0,0,0,61,97
78825,6,489,226,1,0,0,1,365,593
2372,7,521,121,11,1,1,0,168,302
3517,4,923,411,16,11,0,3,655,1096
39583,4,220,60,0,0,0,0,103,163
41332,4,923,48,3,1,0,0,95,147
125439,7,521,40,0,1,0,0,62,103
170587,8,885,751,20,13,0,5,1163,1952
93358,7,126,17,0,0,0,0,28,45
12415,5,232,79,5,4,0,0,111,199
109163,9,693,5,0,0,0,0,7,12
141562,8,214,34,0,0,0,0,33,67
170298,5,4,27,1,1,0,0,32,61
50239,5,235,1118,46,21,11,6,1535,2737
145360,8,214,47,0,0,0,0,53,100
92144,7,56,66,3,2,0,0,87,158
60694,4,890,540,3,2,0,0,767,1312
103365,6,117,571,20,8,1,4,909,1513
38002,6,117,653,17,8,0,10,1011,1699
158698,6,225,82,0,0,0,0,113,195
165776,6,453,109,3,2,0,1,205,320
57323,10,917,15,0,0,0,0,21,36
167073,7,563,63,1,1,0,0,134,199
31862,4,923,354,8,1,2,1,516,882
93686,10,917,35,2,1,0,0,58,96
98272,10,917,16,0,0,0,0,24,40
58836,10,917,4,0,0,0,0,15,19
101713,8,885,500,8,4,0,4,868,1384
1016,9,374,6,0,0,0,0,10,16
26422,7,74,96,2,1,0,0,158,257
142771,4,199,66,0,1,0,0,104,171
63026,10,63,198,4,2,0,1,408,613
40647,10,63,77,0,0,0,0,151,228
161940,5,238,21,0,0,0,0,27,48
49503,7,79,36,2,1,0,0,58,97
94155,6,78,10,0,0,0,0,14,24
149861,11,885,43,0,0,0,0,48,91
73187,4,300,173,1,1,0,1,276,452
81595,8,214,540,12,3,1,2,899,1457
119796,9,8,159,5,3,0,1,266,434
111162,4,375,12,0,0,0,0,25,37
44065,9,589,367,8,6,0,2,747,1130
29538,11,214,40,0,0,0,0,43,83
5220,7,563,46,4,2,0,0,91,143
17473,5,489,419,34,10,8,3,683,1157
137584,4,923,60,3,4,0,0,96,163
153104,6,200,107,1,1,0,0,138,247
145532,7,489,52,0,0,0,0,68,120
29868,9,630,604,7,3,1,2,933,1550
99469,5,140,65,0,0,0,2,107,174
56421,6,235,534,9,5,0,3,748,1299
109341,7,196,111,1,1,0,0,166,279
57061,6,235,307,0,0,0,1,411,719
109322,6,570,3,0,0,0,0,10,13
131594,7,570,745,7,3,1,0,1106,1862
91540,7,641,56,1,0,0,0,80,137
160164,8,812,139,6,3,0,4,266,418
56153,10,653,167,3,2,0,1,278,451
916,6,106,78,1,0,0,0,143,222
18892,5,159,25,1,0,0,0,41,67
72694,8,214,90,2,1,0,0,133,226
47589,5,159,25,0,0,0,1,32,58
4315,5,893,437,17,5,1,1,884,1345
114392,5,404,19,0,0,0,0,25,44
166802,5,159,3,0,0,0,0,0,3
114719,4,890,757,22,8,1,3,1058,1849
56822,7,535,19,0,0,0,0,26,45
141908,8,596,904,20,9,0,11,1483,2427
3248,4,200,135,3,0,0,0,182,320
26741,4,36,220,8,5,0,2,380,615
157400,10,781,17,0,0,1,0,22,40
64166,10,781,1,0,0,1,0,0,2
3129,11,30,39,3,0,0,0,51,93
88437,4,200,15,0,0,0,1,18,34
127019,5,489,338,5,3,0,1,553,900
42892,10,653,34,0,0,0,1,59,94
164697,7,211,54,1,3,0,0,85,143
66169,8,403,618,20,8,1,2,916,1565
67924,8,623,493,18,4,1,3,613,1132
115350,6,658,163,3,2,2,3,240,413
167084,6,51,192,6,3,0,0,316,517
99094,5,159,19,0,0,0,1,44,64
71148,4,752,29,0,0,0,0,49,78
24246,9,6,368,8,5,0,1,515,897
62300,5,251,21,0,0,0,0,39,60
105674,9,6,54,1,1,0,0,124,180
50021,5,251,8,0,0,0,0,13,21
37980,10,820,89,0,0,0,0,135,224
41895,7,741,21,0,0,0,0,30,51
156809,10,66,93,1,0,1,0,128,223
86852,8,214,5,0,0,0,0,6,11
150914,10,628,84,4,0,3,0,156,247
153165,10,66,18,0,0,0,0,27,45
11171,10,66,4,0,0,0,0,17,21
97815,10,66,0,0,0,0,0,5,5
68618,10,66,0,0,0,0,0,5,5
70534,9,800,573,8,5,0,8,681,1275
98112,10,66,10,0,0,0,0,29,39
144637,4,885,152,0,0,0,0,276,428
67416,10,66,0,0,0,0,0,5,5
87138,10,66,0,0,0,0,0,8,8
82471,10,66,0,0,0,0,0,17,17
31238,10,66,0,0,0,0,0,5,5
135320,10,781,26,0,0,0,0,40,66
94047,9,489,256,7,2,1,4,473,743
119050,8,489,233,4,1,0,0,431,669
134005,5,251,6,0,0,0,0,11,17
108186,7,535,15,0,0,0,0,20,35
82814,9,819,49,3,1,0,0,122,175
138921,4,159,163,8,4,0,0,324,499
27315,10,66,29,1,2,0,0,48,80
62035,7,489,80,1,0,0,0,109,190
113871,10,628,90,0,0,0,0,150,240
62374,4,885,150,2,4,0,0,274,430
65803,6,827,95,4,4,0,0,115,218
44181,7,713,149,5,0,1,1,909,1065
64492,4,581,64,1,0,0,0,99,164
160400,11,355,9,0,0,0,0,5,14
53914,4,159,102,3,2,0,0,186,293
3096,6,800,684,15,9,0,5,1304,2017
91321,4,159,311,3,1,1,1,566,883
123304,5,693,233,8,9,0,0,424,674
108336,7,587,3541,115,37,7,27,6685,10412
89635,9,842,367,0,0,0,4,956,1327
26607,8,545,70,0,0,0,2,120,192
92153,8,214,272,0,0,0,0,358,630
41812,9,640,98,3,4,0,0,156,261
145380,6,165,121,0,1,0,0,182,304
135061,6,78,139,0,0,0,0,185,324
45643,9,367,27,0,0,0,0,66,93
141876,9,306,154,0,0,0,4,308,466
37006,9,640,225,3,0,0,1,350,579
78304,8,489,1102,25,10,4,10,1823,2974
49522,7,741,27,0,0,0,0,63,90
8947,6,103,46,0,0,0,0,81,127
47024,7,626,18,1,1,0,0,40,60
152037,7,626,9,0,0,0,0,14,23
149795,5,479,157,0,0,0,1,259,417
29465,6,165,144,4,3,0,0,262,413
123514,6,221,22,0,0,0,0,24,46
64847,9,325,4,0,0,0,0,3,7
128115,6,251,18,0,0,0,1,26,45
81197,5,235,530,18,9,1,3,909,1470
119722,6,453,25,0,0,0,0,36,61
34643,6,200,150,3,0,0,1,221,375
115244,7,367,27,0,0,0,0,41,68
64774,4,453,348,11,4,1,0,583,947
143500,7,570,65,0,0,0,0,114,179
62462,4,453,430,3,3,0,0,629,1065
56764,8,800,105,5,3,0,0,157,270
23574,4,375,24,1,0,0,0,32,57
69093,4,159,190,4,4,0,0,326,524
99247,5,200,2,0,0,0,0,2,4
39836,7,570,125,1,1,0,0,194,321
147342,8,812,653,15,14,0,6,1044,1732
146028,6,514,11,2,1,0,0,21,35
134213,7,578,1,0,0,0,0,9,10
71732,9,597,146,9,3,1,1,334,494
21681,8,812,408,9,4,0,3,618,1042
14722,6,570,56,4,2,0,1,148,211
47097,5,561,36,0,0,0,0,47,83
149838,8,812,158,1,1,0,1,219,380
39054,6,366,13,0,0,0,0,16,29
93666,8,693,54,0,0,0,0,58,112
146008,8,693,5,0,0,0,0,8,13
30165,8,489,165,0,0,0,0,233,398
21103,4,800,35,0,0,0,0,33,68
18221,8,214,277,2,0,0,2,386,667
73595,6,366,9,0,0,0,0,11,20
137382,4,212,13,0,0,0,0,25,38
60102,4,375,67,0,0,0,0,96,163
100659,8,403,152,6,2,0,0,287,447
167297,7,118,112,7,4,0,0,214,337
45151,10,797,105,0,0,0,1,160,266
167717,10,797,61,0,0,0,0,98,159
142538,11,214,128,7,0,0,0,138,273
52886,10,790,85,0,0,0,0,134,219
44694,10,797,65,0,0,0,1,91,157
130395,4,923,89,5,5,0,0,144,243
168893,5,225,60,0,0,0,0,77,137
73773,4,375,72,2,2,0,0,119,195
77918,7,484,40,1,1,0,2,76,120
26543,8,214,170,0,0,0,2,292,464
92643,5,225,311,6,4,0,2,485,808
55824,10,701,74,2,2,0,0,91,169
58481,4,200,116,2,1,0,1,179,299
46626,4,375,3,0,0,0,0,6,9
46164,10,66,12,0,0,0,0,15,27
14796,9,117,15,0,0,0,0,23,38
145309,8,812,49,2,2,0,1,92,146
79848,10,355,4,0,0,0,0,3,7
9772,9,631,27,1,1,0,0,54,83
46241,9,819,429,17,7,1,1,655,1110
67534,9,819,57,2,1,0,0,85,145
1995,4,800,188,1,0,0,1,291,481
134235,8,214,95,0,1,0,1,162,259
55958,8,489,110,0,0,0,2,176,288
150320,9,657,18,3,0,0,1,22,44
67568,4,519,104,0,0,0,3,176,283
99354,11,214,30,0,0,0,0,37,67
37447,6,290,5,0,0,0,0,3,8
3437,4,365,16,0,0,0,0,26,42
124062,4,519,96,2,1,0,1,130,230
110944,8,214,1176,8,2,0,3,1889,3078
93852,9,640,2055,100,36,12,9,3186,5398
39601,4,453,23,0,0,0,0,29,52
73729,8,812,410,23,14,0,3,674,1124
89706,9,607,282,8,4,1,0,443,738
114173,9,353,18,0,0,0,0,13,31
10097,6,103,31,0,0,0,0,38,69
100914,8,214,106,0,0,0,0,177,283
13018,9,684,2,0,0,0,0,3,5
24735,7,587,330,3,2,0,0,487,822
93589,8,214,185,6,1,0,1,428,621
7424,7,741,8,0,0,0,0,14,22
61293,6,200,391,4,1,0,0,567,963
28976,7,489,66,0,0,0,0,95,161
110169,11,30,122,8,0,0,0,140,270
22460,8,214,115,0,0,0,0,195,310
24075,5,78,85,0,0,0,0,84,169
82287,5,699,933,41,13,3,4,1314,2308
167857,7,836,24,0,1,0,0,39,64
2,7,214,55,0,0,0,0,79,134
132828,11,545,392,19,0,0,0,456,867
14065,5,371,293,15,5,2,2,432,749
153095,7,214,360,1,1,0,1,500,863
169869,7,214,159,0,0,0,0,244,403
138892,4,174,24,0,0,0,0,32,56
2873,11,214,291,13,0,0,3,325,632
149137,4,453,6,0,0,0,0,9,15
143304,5,773,94,2,0,0,0,144,240
58011,5,693,1750,168,94,15,15,2668,4710
101737,8,124,207,7,7,0,2,376,599
98107,10,105,67,1,1,0,0,134,203
98374,9,78,59,4,4,0,0,100,167
143848,7,149,80,0,0,0,2,155,237
98301,6,174,817,51,25,10,3,1096,2002
77332,9,367,125,0,1,0,1,209,336
145247,5,124,111,3,0,0,1,182,297
68439,10,105,10,0,0,0,0,17,27
104907,4,908,2,0,0,0,0,2,4
86233,9,469,123,1,1,0,0,277,402
34348,5,699,200,7,3,1,3,246,460
58957,5,176,815,15,11,0,3,1164,2008
118059,4,908,6,0,0,0,0,8,14
2827,6,306,310,0,0,0,1,503,814
120133,6,658,136,6,5,1,2,190,340
152709,5,124,529,21,11,1,4,915,1481
45044,7,741,149,9,3,0,2,247,410
124756,5,655,386,15,9,1,4,635,1050
20366,5,200,529,32,11,0,4,844,1420
3661,10,36,66,0,0,0,0,87,153
45406,6,235,14,0,0,0,0,15,29
70325,6,235,2,0,0,0,0,3,5
27008,8,623,374,8,1,0,4,524,911
106737,8,214,579,4,3,0,4,958,1548
63186,8,693,74,1,1,0,0,80,156
59226,5,693,292,1,1,0,0,469,763
81456,6,263,206,3,3,0,0,302,514
112709,4,174,33,0,0,0,0,53,86
87413,11,693,101,4,0,0,0,89,194
154831,9,374,83,0,0,0,2,141,226
88222,5,447,211,7,6,0,2,268,494
120680,5,58,185,9,4,3,0,262,463
157700,4,890,333,6,2,0,0,522,863
84201,4,159,272,9,7,0,0,565,853
153516,9,367,162,3,2,0,1,214,382
4611,8,812,155,1,0,0,5,212,373
164571,8,812,404,9,3,0,2,639,1057
26849,10,22,44,0,0,0,0,90,134
58231,4,115,38,0,0,0,0,62,100
57258,10,797,36,0,0,0,0,60,96
32360,8,800,300,14,10,2,1,555,882
91085,5,58,245,14,7,1,0,405,672
6410,8,623,52,0,0,0,2,86,140
99563,4,159,42,0,0,0,0,59,101
110671,5,238,6,0,0,0,0,5,11
26200,6,263,56,1,2,0,0,106,165
17138,7,587,66,0,0,0,0,93,159
8652,7,312,39,1,1,0,1,41,83
76733,9,469,19,1,1,0,0,38,59
55205,6,514,12,0,0,0,0,26,38
134001,7,77,2148,77,25,5,4,3173,5432
15969,5,375,51,3,3,0,1,61,119
4003,7,214,52,0,0,0,0,105,157
61060,8,489,614,9,1,2,1,908,1535
15409,7,484,181,4,0,0,0,265,450
151407,6,518,51,1,1,0,0,114,167
50343,7,77,152,7,3,2,0,251,415
126835,6,827,49,3,2,0,0,122,176
75694,6,827,60,2,0,1,0,146,209
93081,6,827,12,0,0,0,0,55,67
22890,6,453,90,1,0,0,0,151,242
74485,6,124,159,3,0,0,1,226,389
149539,6,235,257,8,4,2,7,427,705
16415,6,789,150,0,0,0,2,262,414
158283,8,403,198,1,0,0,1,337,537
44083,8,658,55,2,1,0,1,90,149
79755,6,843,16,0,0,0,1,24,41
144405,11,489,32,2,0,0,0,35,69
131198,6,232,27,0,0,0,0,35,62
31870,6,570,588,15,10,1,2,952,1568
156020,5,893,321,9,6,1,1,559,897
70807,7,587,69,0,0,0,1,100,170
43888,7,864,15,0,0,0,0,40,55
122792,5,693,170,1,0,12,0,233,416
156299,5,693,13,0,0,0,0,12,25
9576,5,200,114,3,2,0,0,142,261
153689,8,623,74,0,0,0,0,80,154
167124,10,81,45,1,1,0,0,83,130
108876,9,570,797,36,24,2,3,1232,2094
14953,10,653,314,7,0,0,0,485,806
9449,4,800,404,8,6,0,2,675,1095
26758,6,269,345,10,4,0,3,527,889
163473,6,269,414,15,2,1,3,629,1064
105465,6,209,3,0,0,0,0,5,8
117391,6,269,193,3,1,0,2,303,502
113125,10,200,3,0,0,0,0,7,10
64073,10,628,67,1,0,0,0,110,178
125466,8,658,138,1,1,0,0,236,376
114537,4,890,605,16,6,1,1,923,1552
80837,6,124,78,1,1,0,0,105,185
20606,10,653,134,0,0,0,1,207,342
169058,7,641,16,0,0,0,0,26,42
35589,8,545,38,0,0,0,0,76,114
163649,7,545,207,5,3,0,1,319,535
136574,4,725,47,0,0,0,0,56,103
151933,10,104,255,4,0,0,2,515,776
36101,10,841,18,2,1,0,0,39,60
56520,10,841,12,2,1,0,0,54,69
119432,10,841,75,3,1,0,0,118,197
86767,10,841,38,2,1,0,0,52,93
18550,10,841,69,2,1,0,2,97,171
23597,10,841,81,3,1,0,0,103,188
39196,10,841,181,3,2,0,2,254,442
121068,10,841,172,5,1,0,1,250,429
94253,10,841,9,2,1,0,0,14,26
65947,10,322,6,0,0,0,0,5,11
134342,9,367,4,0,0,0,0,4,8
119099,4,375,602,12,5,0,6,1129,1754
150104,4,725,86,0,0,0,0,128,214
91815,4,725,73,0,0,0,1,124,198
58847,8,545,45,0,0,0,0,63,108
168581,6,479,698,31,15,4,6,1041,1795
163771,8,489,94,1,0,0,0,117,212
140115,9,8,44,1,1,0,0,52,98
34507,9,640,268,7,6,0,2,379,662
117853,4,174,95,0,0,0,0,146,241
100504,4,174,100,1,0,0,0,151,252
149725,8,214,404,12,7,0,2,658,1083
50525,9,640,994,24,17,1,7,1369,2412
29723,4,908,20,2,0,0,0,16,38
37759,8,214,309,0,0,0,0,444,753
134616,5,235,87,5,2,1,1,150,246
34402,6,106,59,2,2,0,0,81,144
16238,10,458,38,0,0,0,0,89,127
89448,6,658,28,0,0,0,0,27,55
47552,6,140,12,1,1,0,0,17,31
95531,6,232,70,2,2,0,0,95,169
108967,9,489,22,1,1,0,0,44,68
105131,9,489,64,2,1,0,0,96,163
165471,7,741,93,0,0,0,0,140,233
16225,7,741,27,0,0,0,0,49,76
57360,9,489,152,0,0,0,1,234,387
8360,10,474,19,0,0,0,0,15,34
101526,10,172,13,0,0,0,0,62,75
18365,10,172,2,0,0,0,0,23,25
155195,10,172,6,3,1,0,0,44,54
122041,9,489,30,1,0,0,0,46,77
117310,5,200,443,16,9,0,3,651,1122
102348,10,172,5,0,0,0,0,26,31
104385,10,172,108,0,0,0,0,202,310
126675,4,36,183,8,0,0,0,333,524
3936,4,36,159,1,1,0,2,254,417
99530,6,200,53,0,0,0,0,75,128
82507,7,861,87,1,1,0,2,166,257
122263,6,200,65,0,0,0,1,51,117
87575,9,8,320,6,4,0,3,457,790
48353,6,78,248,4,4,0,3,358,617
148878,5,263,161,0,0,0,1,237,399
157433,5,408,47,4,0,0,0,80,131
89416,8,800,527,15,3,1,2,759,1307
53886,8,800,174,6,3,0,0,260,443
66804,4,36,17,3,0,0,0,27,47
50431,8,800,328,14,7,0,2,512,863
25938,7,648,19,0,0,0,0,27,46
116154,7,842,156,1,2,0,0,227,386
48318,4,519,24,1,0,0,0,45,70
36715,11,489,67,13,0,0,0,67,147
54442,6,200,326,2,1,0,0,441,770
47640,9,842,873,40,23,7,2,1367,2312
143654,7,521,38,0,0,0,0,48,86
121992,8,800,298,9,1,2,1,482,793
91044,7,492,4,0,1,0,0,7,12
48520,5,124,42,0,0,0,0,53,95
36965,7,74,27,1,1,1,0,26,56
138285,9,489,339,0,0,0,0,474,813
88918,5,263,210,0,0,0,0,354,564
44599,8,885,57,0,0,0,0,112,169
135064,8,623,236,8,2,1,1,690,938
110306,11,800,58,7,0,0,0,97,162
18368,6,885,64,2,1,0,0,95,162
43726,4,36,749,33,21,1,3,1268,2075
122465,8,800,85,1,1,0,0,175,262
129702,9,538,54,0,0,0,1,62,117
170341,5,124,182,6,5,0,4,289,486
83589,8,306,40,0,0,0,0,53,93
103878,9,462,55,2,2,0,0,139,198
121864,4,375,2,0,0,0,0,0,2
161552,4,752,2,0,0,0,0,4,6
167371,4,800,78,0,0,0,0,113,191
1541,8,489,29,0,0,0,0,41,70
98881,8,124,53,0,0,0,1,91,145
53578,5,124,58,0,1,0,0,103,162
121335,10,692,125,0,1,0,1,184,311
59558,7,207,6,1,1,0,0,22,30
85499,7,207,5,0,0,0,0,32,37
158526,8,812,51,3,0,0,1,71,126
32198,4,453,736,17,6,1,9,1970,2739
91893,4,174,129,1,2,0,1,198,331
117819,7,645,9,0,0,0,0,15,24
166966,9,483,72,1,0,0,0,105,178
102676,7,484,52,0,0,0,1,66,119
14515,7,744,408,6,4,0,5,572,995
99436,4,638,481,14,4,1,1,657,1158
160728,10,701,84,0,0,0,1,108,193
57506,7,61,51,0,0,1,0,95,147
113637,9,800,117,2,1,0,0,106,226
96895,6,235,47,0,0,0,0,82,129
89968,4,658,94,2,3,0,0,192,291
140840,10,831,117,4,3,0,0,277,401
51990,10,701,11,0,0,0,0,19,30
118434,4,800,10,0,0,0,0,8,18
146567,10,917,26,0,0,0,0,52,78
118321,6,290,31,1,1,0,0,53,86
166460,9,78,229,0,0,0,2,517,748
143697,10,334,4,0,0,0,0,5,9
64259,7,207,11,0,0,0,0,10,21
108789,10,334,12,0,0,0,0,19,31
36990,10,334,4,0,0,0,0,6,10
9275,10,881,45,0,0,0,0,77,122
34186,8,484,133,2,0,0,0,193,328
79160,7,207,2,0,0,0,0,4,6
22139,10,701,317,5,3,0,1,450,776
65324,10,701,143,1,1,0,0,167,312
43441,10,798,13,0,0,0,0,32,45
24203,9,78,16,1,1,0,0,33,51
105746,6,269,112,0,0,0,0,195,307
5429,4,638,99,1,1,0,0,149,250
31477,8,214,121,1,1,0,1,272,396
24090,8,403,178,0,0,0,1,296,475
40974,10,807,3,0,0,0,0,5,8
132716,7,232,43,5,2,0,1,99,150
154100,5,479,11,0,0,0,0,8,19
58699,9,640,191,0,0,0,1,241,433
156838,9,367,61,0,0,0,0,121,182
68117,6,269,59,0,0,0,0,78,137
31726,9,741,84,0,0,0,0,111,195
42901,10,653,192,5,4,1,1,329,532
25920,7,314,85,0,0,0,0,140,225
61048,6,140,18,0,0,0,0,30,48
154879,4,923,33,0,0,0,0,64,97
150928,11,214,27,1,0,0,1,24,53
105606,4,923,27,1,1,0,0,34,63
105511,6,537,15,0,0,0,0,22,37
42025,10,40,186,3,2,0,2,279,472
65807,7,207,7,0,0,0,0,10,17
118100,4,36,373,6,5,0,3,627,1014
112413,10,474,17,0,0,0,0,20,37
101971,7,492,8,0,0,0,0,12,20
72109,4,36,109,3,0,0,2,205,319
157627,9,78,185,0,0,0,0,428,613
17110,10,474,35,0,0,0,0,74,109
170351,10,111,30,0,0,0,0,57,87
107969,9,630,508,14,8,1,3,725,1259
76330,7,175,38,1,0,0,0,179,218
147815,4,375,329,3,2,0,0,464,798
63500,8,124,275,5,1,0,1,390,672
1385,10,820,21,0,0,0,0,27,48
137342,7,741,237,6,2,0,0,463,708
117900,10,820,33,1,1,0,0,75,110
105062,9,842,376,12,7,0,0,536,931
70467,6,800,50,3,0,0,1,87,141
45870,9,842,1730,57,31,2,11,2487,4318
166448,10,820,5,0,0,0,0,14,19
56555,9,842,130,5,4,1,1,247,388
89190,6,200,513,24,6,0,5,862,1410
114795,9,842,96,2,1,1,1,206,307
16594,5,159,37,0,0,0,0,48,85
71961,9,640,562,23,13,0,5,866,1469
16249,7,587,2493,57,18,4,10,3830,6412
21390,11,658,54,2,0,0,0,58,114
149780,5,479,413,0,0,0,1,608,1022
35237,6,78,477,2,3,0,6,641,1129
120051,9,640,432,15,7,0,2,579,1035
122621,9,640,84,1,1,0,0,122,208
3820,5,479,143,0,0,0,1,185,329
163633,5,800,236,4,3,0,1,400,644
146637,5,489,60,4,4,1,0,78,147
68672,6,165,31,1,1,0,0,56,89
112018,11,214,50,0,0,0,0,56,106
145505,7,909,50,2,1,1,0,88,142
106510,4,923,177,4,2,1,2,260,446
99150,9,640,54,0,0,0,1,83,138
58991,9,630,146,1,0,0,2,254,403
62807,8,812,457,15,11,1,3,699,1186
34170,9,842,116,0,0,0,0,173,289
51478,9,538,12,1,1,0,0,14,28
161131,9,538,12,2,1,0,0,25,40
87035,7,587,551,8,3,0,1,719,1282
125951,7,312,7,0,0,0,0,13,20
158320,8,812,151,4,2,0,1,288,446
4406,7,669,7,0,0,0,0,12,19
57839,9,78,211,2,1,0,1,278,493
70930,7,587,432,9,1,1,2,623,1068
48492,7,312,3,0,0,0,0,3,6
73608,8,214,187,3,3,0,2,337,532
116292,8,812,135,3,2,0,1,220,361
32235,10,653,118,4,3,0,0,163,288
17419,8,812,92,0,0,0,0,136,228
57119,9,630,987,17,11,1,5,1482,2503
85314,9,630,440,12,5,0,3,570,1030
57452,4,658,8,0,0,0,0,8,16
27955,9,630,372,1,1,0,2,543,919
148605,9,489,644,0,0,0,7,1010,1661
8289,7,312,1,0,0,0,0,4,5
154876,6,200,84,0,0,0,0,97,181
165481,7,312,5,0,0,0,0,7,12
84413,7,196,82,0,0,0,0,115,197
117665,4,200,131,4,2,0,0,158,295
48476,10,618,45,4,1,0,0,91,141
10981,10,40,25,2,0,0,0,56,83
48660,8,214,200,0,0,0,3,304,507
25372,11,885,14,5,0,0,0,18,37
140488,11,214,7,0,0,0,0,7,14
139129,8,214,122,0,1,0,0,185,308
113916,8,214,487,1,0,0,3,664,1155
124459,8,214,314,1,0,0,2,392,709
9585,8,214,383,4,0,0,2,614,1003
28552,10,820,11,0,0,0,0,55,66
55542,6,263,129,0,0,0,1,176,306
1317,9,380,117,2,2,1,0,212,334
56583,5,545,37,0,0,0,1,62,100
98278,10,63,24,1,1,0,0,30,56
56423,8,214,137,3,2,0,0,149,291
115751,10,617,95,7,4,0,1,142,249
57916,4,678,3,0,0,0,0,0,3
18972,6,200,106,0,0,0,0,176,282
142257,7,226,1,0,0,0,0,2,3
125955,10,807,27,0,0,0,0,43,70
84938,8,214,19,0,0,0,0,22,41
14574,9,306,940,0,0,0,9,1767,2716
9627,8,214,487,5,1,1,3,792,1289
116894,8,214,485,2,2,0,3,739,1231
56268,8,214,195,2,1,0,1,341,540
11405,8,214,131,0,0,0,1,189,321
167145,9,380,67,0,0,0,0,97,164
47807,9,158,32,2,0,0,0,70,104
16045,8,214,217,5,4,0,0,338,564
91814,7,496,39,1,2,0,2,128,172
11911,9,306,146,0,0,0,0,273,419
150617,7,496,45,0,0,0,0,136,181
73117,7,492,1,0,0,0,0,1,2
157916,4,678,305,9,8,0,2,447,771
102002,8,214,68,0,0,0,0,94,162
34124,8,214,404,1,0,0,1,595,1001
138240,8,214,280,0,0,0,0,429,709
155080,6,103,36,0,1,0,1,54,92
82012,10,105,8,0,0,0,0,36,44
1277,10,104,129,0,0,0,1,157,287
7248,8,306,156,1,2,0,0,195,354
53234,4,885,129,0,0,0,0,158,287
31551,7,196,46,4,3,0,0,72,125
103921,4,658,79,2,1,0,1,116,199
101466,9,570,69,0,0,0,0,95,164
86841,9,589,2,0,0,0,0,3,5
35192,9,483,66,2,1,0,1,90,160
26989,7,587,206,3,1,0,0,281,491
162670,7,587,256,3,3,0,0,401,663
86877,7,587,182,2,2,0,1,238,425
138252,9,302,89,3,3,0,0,150,245
161904,6,124,185,2,2,0,3,297,489
82656,6,124,963,18,10,0,7,1527,2525
144460,6,124,247,6,3,0,3,450,709
156793,4,200,362,10,4,1,2,656,1035
49895,8,489,91,2,1,0,0,152,246
80556,8,800,19,0,0,0,0,28,47
44404,9,462,15,0,0,0,0,31,46
101983,5,159,18,0,0,0,0,25,43
24500,6,402,38,1,1,0,0,68,108
120019,6,58,74,4,10,0,0,103,191
81628,9,302,329,5,9,0,2,525,870
121059,5,106,79,0,0,0,0,115,194
68250,9,306,93,0,0,0,1,159,253
41806,9,77,68,0,1,0,0,98,167
108003,8,214,619,13,4,0,5,1139,1780
75017,9,77,331,6,4,1,4,447,793
3099,7,861,193,0,0,0,1,347,541
138703,6,570,23,1,1,0,0,34,59
30561,9,640,153,1,1,0,1,242,398
152786,8,214,1231,35,12,1,12,2158,3449
69190,9,367,41,0,0,0,0,59,100
76720,7,157,54,1,1,0,0,76,132
46309,9,78,6,0,0,0,0,9,15
135919,9,374,2,0,0,0,0,3,5
72603,7,587,168,3,2,1,0,249,423
34127,6,821,183,2,2,0,0,327,514
138793,7,79,8,0,0,0,0,18,26
139968,6,78,188,1,1,0,1,346,537
55901,8,885,756,7,4,0,1,1260,2028
51009,6,165,903,32,13,4,8,1240,2200
141950,4,581,12,0,0,0,0,19,31
96237,10,820,32,0,0,0,0,81,113
436,10,334,2,0,0,0,0,3,5
142811,4,159,691,11,6,0,2,1193,1903
25524,10,40,93,0,0,0,0,119,212
91000,10,40,61,0,1,0,0,77,139
106513,10,63,166,2,1,0,0,220,389
79120,7,824,181,0,0,0,0,251,432
163609,9,640,168,5,3,1,0,248,425
140179,7,824,30,0,0,0,0,42,72
169694,4,200,287,11,1,0,0,301,600
114767,5,78,613,21,13,0,5,996,1648
95999,6,200,393,2,3,0,2,608,1008
58035,4,800,24,0,0,0,0,30,54
15506,4,658,14,0,0,0,0,16,30
42915,9,556,55,2,0,0,1,80,138
165408,7,748,2,0,0,0,0,5,7
134444,7,748,46,0,0,0,0,95,141
35738,7,748,19,0,0,0,0,30,49
111177,7,748,16,0,0,0,0,34,50
81916,7,748,13,0,0,0,0,19,32
146225,10,797,676,8,7,1,4,1186,1882
24647,4,923,84,3,1,1,1,213,303
103918,9,374,412,9,7,0,0,589,1017
17287,9,741,175,0,0,0,0,297,472
17816,9,145,4,0,0,0,0,33,37
91218,9,89,57,0,0,0,0,76,133
16098,5,408,149,12,6,0,1,227,395
7310,4,453,199,7,2,1,4,361,574
111058,8,489,69,0,0,0,0,78,147
120878,8,214,795,14,9,0,5,1377,2200
114174,8,489,34,0,0,0,0,48,82
126816,8,489,249,6,3,0,0,378,636
81028,5,821,36,2,3,0,1,62,104
132666,9,457,4,0,0,0,0,4,8
140460,5,821,91,3,3,0,1,113,211
165972,9,630,47,0,0,0,0,68,115
98927,5,821,18,0,0,0,0,28,46
90325,9,175,2,0,0,0,0,3,5
126978,9,800,3,0,0,0,0,5,8
158215,9,202,2,0,0,0,0,3,5
72547,6,200,35,0,1,0,1,60,97
109465,10,917,196,2,1,0,0,283,482
113561,4,658,157,2,4,0,0,294,457
111021,8,214,632,12,4,1,4,1003,1656
98072,10,790,27,0,0,0,0,122,149
110921,6,251,45,0,0,0,1,59,105
9798,7,521,134,1,1,0,1,234,371
99696,7,429,7,0,0,0,0,16,23
6786,4,375,255,4,3,0,2,487,751
121015,9,741,435,4,1,0,2,878,1320
25374,4,200,341,7,8,0,2,585,943
61963,6,59,4629,96,49,16,18,6794,11602
94818,10,200,240,3,2,0,1,380,626
141978,7,404,122,0,0,0,1,194,317
29945,7,126,102,1,0,0,0,170,273
136092,10,334,20,0,0,0,0,25,45
128181,10,334,6,0,0,0,0,9,15
81671,7,737,2,0,0,0,0,3,5
51924,5,66,60,2,1,0,0,101,164
117153,7,872,41,1,1,0,0,58,101
106011,7,693,37,1,1,0,0,58,97
77900,7,126,4,0,0,0,0,5,9
118169,8,623,42,0,0,0,0,82,124
110550,9,640,30,0,0,0,0,42,72
23995,7,755,205,7,0,1,1,288,502
44758,9,640,121,2,2,0,1,171,297
107024,9,640,115,8,2,0,0,174,299
21335,8,403,328,7,2,0,1,597,935
124384,8,209,58,1,3,0,0,74,136
163053,8,214,129,0,0,0,0,242,371
42639,9,314,282,6,17,0,5,375,685
106690,7,551,1137,0,0,0,0,31,1168
28692,7,551,10,0,0,0,0,16,26
89561,7,551,69,2,2,0,0,97,170
127845,7,645,2,0,0,0,0,2,4
112457,7,551,22,0,0,0,0,26,48
59440,9,657,1519,67,31,8,4,2415,4044
157502,9,367,35,0,0,0,0,48,83
110814,9,367,29,0,0,0,0,58,87
86766,9,367,21,0,0,0,0,36,57
139594,4,581,282,7,3,1,5,450,748
160017,6,209,25,2,1,0,0,34,62
168759,6,106,122,3,0,0,0,247,372
55261,4,300,468,9,7,0,1,847,1332
8861,5,159,482,20,5,1,3,853,1364
140061,6,728,455,9,8,1,0,758,1231
116538,8,209,8,0,0,0,0,12,20
151559,6,209,123,5,1,0,1,136,266
155653,5,404,232,1,0,0,1,360,594
142413,10,40,64,0,0,0,0,88,152
8233,8,200,89,4,2,0,0,385,480
135509,9,589,29,0,0,0,0,35,64
6550,10,104,55,3,1,0,0,235,294
138505,5,200,52,0,0,0,1,67,120
122292,10,66,53,0,0,0,0,122,175
12755,6,269,177,0,1,0,0,233,411
123173,10,289,418,6,3,1,1,587,1016
88080,9,589,34,2,2,0,0,32,70
45855,9,589,136,4,0,0,0,171,311
105739,8,766,217,3,0,0,0,296,516
111202,8,403,275,11,4,0,3,480,773
127895,8,489,251,4,0,0,3,424,682
12479,7,611,3,0,0,0,0,5,8
16931,6,800,33,0,0,0,0,43,76
156147,8,214,157,1,2,1,1,243,405
52615,8,427,28,0,0,0,0,36,64
146381,5,200,70,1,1,0,1,115,188
160497,5,200,21,0,0,0,0,40,61
42051,6,232,40,0,1,0,0,58,99
23023,7,909,55,2,1,0,0,64,122
103151,8,623,21,0,0,0,0,35,56
57403,5,885,16,0,0,0,0,21,37
112029,6,263,44,2,0,0,2,66,114
121872,4,593,83,0,0,0,0,143,226
160287,8,403,171,1,1,0,1,307,481
28047,11,693,104,8,0,0,0,119,231
158011,8,214,222,3,3,0,3,327,558
88464,4,885,108,0,0,0,0,143,251
32691,5,58,175,2,3,0,0,272,452
119259,9,374,206,11,4,3,1,410,635
151046,8,885,100,2,0,0,0,130,232
96033,8,489,137,5,1,0,1,208,352
118917,9,100,36,0,0,0,0,67,103
40022,7,489,316,2,2,0,0,441,761
162003,7,641,85,1,0,0,0,134,220
25665,7,912,78,3,0,0,0,116,197
52310,4,885,143,0,0,0,0,283,426
26625,7,641,51,1,0,0,1,84,137
23628,6,306,4,0,0,0,0,0,4
116540,6,489,121,1,0,0,0,178,300
143155,7,521,129,5,3,0,0,212,349
38345,5,58,278,3,0,0,3,388,672
14184,4,800,147,2,2,0,2,238,391
37129,4,658,247,0,0,0,1,439,687
150619,8,214,219,0,0,0,1,469,689
153374,8,214,531,5,3,0,4,774,1317
114799,8,214,19,0,0,0,0,32,51
120003,8,766,136,13,6,0,0,152,307
159215,8,812,168,5,1,0,1,302,477
18703,7,216,532,12,5,0,2,938,1489
12687,4,453,1,0,0,0,0,0,1
114458,6,800,245,0,0,0,0,603,848
22288,5,479,587,14,5,2,1,865,1474
139272,9,640,1873,95,51,4,8,2680,4711
94683,9,78,16,0,0,0,0,45,61
84000,6,200,63,0,0,0,0,74,137
135620,4,174,116,0,0,0,0,118,234
66194,9,315,7,0,0,0,0,10,17
108130,4,890,99,3,0,0,0,165,267
24835,9,570,151,2,2,0,2,237,394
41856,5,585,149,4,0,0,0,263,416
45134,7,175,44,1,0,0,1,68,114
49878,7,484,90,2,0,0,0,146,238
6802,11,214,183,16,0,0,0,169,368
18831,7,762,50,2,1,1,0,116,170
90226,9,100,449,9,8,0,1,695,1162
124824,7,762,282,26,7,1,1,446,763
153120,5,176,12,1,1,0,0,22,36
113082,7,570,46,0,0,0,0,46,92
79937,9,489,159,2,0,0,1,212,374
6922,4,200,440,3,2,0,0,896,1341
158617,4,200,25,0,0,0,1,43,69
159433,9,266,1,0,0,0,0,0,1
90579,8,766,234,6,4,0,2,338,584
73118,9,657,204,16,10,2,5,321,558
63852,8,812,453,16,10,0,2,730,1211
41677,10,617,85,0,0,0,2,109,196
161396,4,200,73,3,1,0,2,102,181
41073,4,885,539,16,10,0,2,866,1433
74504,8,214,515,14,7,0,4,874,1414
76769,4,200,99,1,1,0,1,152,254
68822,8,214,242,3,2,0,1,464,712
47487,9,640,403,10,6,2,2,583,1006
113770,8,214,74,1,1,0,0,73,149
120431,4,200,539,3,1,0,2,865,1410
27396,8,214,105,0,0,0,1,151,257
74069,5,78,185,3,1,0,1,271,461
95177,6,821,121,8,2,0,0,253,384
18837,7,80,23,0,0,0,1,33,57
81650,8,214,13,1,1,0,0,56,71
39680,8,885,48,0,0,0,0,31,79
55220,5,355,44,1,0,0,0,47,92
84332,5,355,120,2,2,0,0,159,283
66684,9,452,234,8,7,1,3,357,610
101519,8,355,943,30,12,1,4,1703,2693
120785,7,157,60,1,0,0,1,48,110
28657,9,630,300,8,4,0,4,423,739
2005,9,452,51,2,2,0,0,77,132
4437,4,569,58,0,0,0,0,79,137
148971,8,214,728,3,2,0,2,1031,1766
113078,4,36,271,5,3,0,3,401,683
111611,6,785,25,0,1,0,0,25,51
142506,5,124,348,6,4,2,2,538,900
68601,8,489,273,1,0,0,2,391,667
139346,4,36,52,2,2,0,1,97,154
101525,11,623,20,0,0,0,0,25,45
150150,4,36,21,1,0,0,0,23,45
133882,6,901,75,1,0,0,0,111,187
112424,8,489,566,0,0,0,2,844,1412
145211,9,657,25,1,1,0,2,45,74
12862,10,36,21,0,0,0,0,43,64
91410,11,800,37,0,0,0,0,36,73
102032,9,630,258,0,0,0,2,896,1156
29427,11,545,42,2,0,0,0,37,81
30623,9,630,282,0,0,0,1,707,990
64659,7,587,460,2,1,0,1,643,1107
51210,9,597,495,22,12,6,1,835,1371
148009,9,640,392,12,4,1,2,525,936
70627,6,235,430,5,3,0,1,483,922
154597,8,489,6,0,0,0,0,8,14
58017,8,800,44,1,1,0,0,53,99
103856,9,158,222,7,3,1,0,533,766
140262,9,158,168,2,2,0,0,341,513
110861,8,812,41,0,0,0,0,54,95
13837,7,630,149,3,1,0,0,262,415
90175,11,30,6,0,0,0,0,8,14
101732,7,489,178,9,4,0,2,271,464
19648,8,800,80,0,0,0,0,103,183
142757,5,200,2,0,0,0,0,3,5
31563,7,214,118,0,0,0,0,217,335
80005,11,306,225,11,0,1,0,342,579
91682,5,78,314,6,2,0,2,491,815
49311,8,623,764,13,5,0,6,1152,1940
123562,5,479,30,0,0,0,0,41,71
88849,10,63,72,2,1,0,1,204,280
3546,4,306,4,0,0,0,0,7,11
128285,5,728,279,20,11,4,0,454,768
99905,9,640,213,13,4,0,1,285,516
157078,5,489,310,5,3,1,3,659,981
112936,8,623,249,6,1,0,0,386,642
87938,10,653,281,3,1,0,2,451,738
120571,8,800,96,7,0,0,1,149,253
83098,8,489,220,2,2,0,1,397,622
149959,8,328,319,5,2,0,2,519,847
2550,10,36,23,0,0,0,0,20,43
53213,6,453,11,0,0,0,0,24,35
154332,10,217,72,1,1,0,0,78,152
97382,8,214,115,0,0,0,0,165,280
48117,7,100,108,4,0,1,0,175,288
82292,7,100,22,0,0,0,0,55,77
67063,7,100,14,1,1,0,1,48,65
92857,7,100,24,1,0,0,0,64,89
156357,9,719,13,0,1,0,0,17,31
84103,7,100,133,6,5,0,0,197,341
103241,5,655,318,8,6,0,2,476,810
144338,5,479,157,1,0,0,0,265,423
275,5,479,595,13,4,1,6,814,1433
138039,10,806,6,0,0,0,0,6,12
84687,7,214,91,0,0,0,0,128,219
129476,8,489,544,9,4,2,5,914,1478
26356,5,489,250,12,6,1,0,415,684
49557,10,653,233,9,0,0,3,366,611
123539,5,489,39,3,1,1,0,68,112
95513,8,124,82,0,0,0,0,118,200
53735,7,214,77,2,0,0,0,142,221
108133,5,124,10,0,0,0,0,13,23
133477,8,693,1107,58,26,4,3,1704,2902
31281,8,812,69,1,1,0,0,145,216
86498,10,653,182,0,1,0,2,250,435
108938,8,658,4,0,0,0,0,10,14
154189,7,800,100,1,1,0,1,182,285
88513,5,570,1,0,0,0,0,2,3
34342,4,453,47,0,0,0,0,63,110
142101,4,159,221,1,0,0,2,333,557
165600,6,729,25,0,0,0,0,43,68
132840,4,890,33,0,0,0,0,53,86
92623,8,812,47,0,1,0,1,75,124
99167,6,235,102,0,0,0,0,165,267
67140,7,157,226,5,4,0,1,432,668
120769,8,214,51,0,0,0,0,85,136
137880,8,403,30,0,0,0,0,34,64
158720,8,403,7,0,0,0,0,15,22
23078,8,800,127,0,0,0,0,183,310
169264,4,200,91,0,0,0,0,114,205
57931,6,785,72,2,1,0,0,79,154
42305,8,124,10,0,0,0,0,7,17
164639,6,570,72,8,2,1,2,114,199
153000,5,159,8,0,0,0,1,11,20
77407,4,519,8,0,0,0,0,17,25
130838,9,380,49,0,0,0,0,61,110
22173,5,444,34,3,2,0,1,45,85
50491,5,444,20,0,0,0,0,36,56
60932,7,693,22,2,1,0,0,46,71
88060,8,800,346,22,10,1,6,629,1014
55606,7,56,22,2,0,0,0,40,64
158764,9,630,281,11,8,1,2,379,682
42695,9,570,107,3,3,0,0,147,260
22642,5,200,300,6,5,0,2,470,783
84813,9,353,73,1,2,0,1,112,189
146190,10,111,68,0,0,0,0,123,191
144247,9,570,34,0,0,0,0,44,78
44916,9,302,45,3,3,0,0,85,136
150377,10,550,63,3,1,1,0,114,182
53489,4,36,52,0,0,0,0,81,133
130127,11,693,24,0,0,0,0,26,50
19762,8,623,304,6,2,0,3,498,813
57449,8,623,63,2,2,0,1,91,159
134701,9,306,36,0,0,0,0,46,82
66448,4,200,733,19,9,1,8,1156,1926
32272,5,489,23,0,0,0,0,33,56
19921,7,214,92,1,0,0,0,128,221
480,7,214,60,0,0,0,1,114,175
72564,10,617,205,1,1,0,4,284,495
57412,10,322,2,0,0,0,0,3,5
55452,5,78,95,0,0,0,0,200,295
115867,8,489,1444,44,9,5,10,2263,3775
76854,4,200,509,10,2,1,0,703,1225
146636,4,890,606,14,3,1,4,946,1574
25138,4,200,54,0,0,0,0,85,139
84506,6,453,8,0,1,0,0,14,23
142935,6,453,4,0,0,0,0,4,8
103480,5,821,5,0,0,0,0,13,18
155817,6,124,233,3,1,1,3,370,611
159759,5,306,380,2,2,0,0,553,937
11613,8,545,79,0,0,0,0,157,236
136537,11,30,185,2,0,0,0,233,420
97189,7,521,2,0,0,0,0,5,7
53354,4,36,54,3,1,0,1,76,135
18053,7,521,157,4,1,0,0,237,399
31180,7,447,161,0,0,0,1,228,390
102233,9,341,51,1,0,0,0,81,133
170072,5,885,11,0,0,0,0,10,21
161246,5,570,21,0,1,0,1,38,61
131350,4,375,9,0,0,0,0,8,17
21915,8,812,118,2,3,0,1,188,312
110417,4,351,169,2,2,0,0,231,404
40086,11,214,9,1,0,0,0,9,19
61172,9,489,211,5,4,1,1,322,544
68836,8,214,2,0,0,0,0,3,5
9862,7,100,19,1,1,0,0,40,61
100615,5,821,46,0,0,0,1,76,123
108422,7,100,12,0,0,0,0,21,33
93719,7,100,12,0,0,0,0,10,22
62950,5,381,77,0,2,0,1,115,195
5305,6,453,155,0,0,0,3,276,434
105905,8,403,189,1,0,0,1,336,527
9658,4,638,212,5,2,0,1,270,490
111070,9,693,195,10,2,0,1,299,507
46797,8,800,1,0,0,0,0,2,3
159578,9,100,62,0,0,0,0,124,186
47617,7,79,238,12,4,0,0,359,613
162310,4,174,64,1,1,0,0,91,157
15179,6,570,33,1,1,0,0,70,105
144459,7,508,66,1,0,0,0,163,230
153319,6,165,62,0,0,0,1,102,165
36034,6,269,324,8,4,0,1,485,822
41987,10,66,2,0,0,0,0,3,5
52258,5,489,8,0,0,0,0,10,18
143657,9,399,38,0,0,0,0,68,106
115539,10,66,11,0,0,0,0,12,23
137320,10,898,6,1,1,0,0,7,15
49762,10,111,340,7,2,1,0,400,750
78350,6,124,10,0,0,0,0,39,49
75936,6,78,348,6,1,0,0,549,904
21105,10,790,161,7,1,0,1,251,421
85953,8,623,38,0,0,0,0,71,109
100378,10,256,17,0,0,0,0,36,53
91992,6,296,11,0,0,0,0,29,40
152826,10,256,17,0,0,0,0,14,31
49195,10,256,61,3,1,0,0,90,155
96598,8,214,104,0,0,0,1,156,261
137266,6,489,115,0,0,0,0,150,265
67033,7,508,3,0,0,0,0,4,7
33326,4,890,158,0,0,0,2,292,452
162849,9,597,125,3,3,0,0,201,332
160737,7,460,13,0,0,0,0,23,36
170356,7,460,10,0,0,0,0,19,29
22438,8,214,477,1,0,0,2,754,1234
114823,6,165,1954,29,15,5,15,3101,5119
108891,5,489,33,0,0,0,0,44,77
70276,7,741,356,22,6,0,1,573,958
118923,10,474,1357,30,11,1,5,2389,3793
102783,9,489,336,0,0,0,3,870,1209
123161,4,36,93,2,0,0,0,135,230
132849,4,923,63,4,1,0,0,112,180
64182,7,909,233,1,2,0,0,259,495
88484,7,909,96,2,2,0,0,99,199
72374,7,508,34,0,0,0,0,45,79
20199,7,570,272,1,1,0,1,392,667
46883,7,587,218,9,0,2,0,383,612
89276,7,864,255,2,2,0,0,305,564
158858,6,78,339,3,4,0,3,462,811
145011,6,402,269,2,6,0,1,467,745
105104,9,341,47,0,2,0,0,106,155
7985,9,341,108,1,0,0,1,166,276
146628,4,908,17,0,0,0,0,19,36
15282,5,78,194,0,0,0,5,321,520
2638,10,355,3,0,0,0,0,18,21
14479,5,124,24,0,0,0,0,25,49
20640,9,341,19,0,0,0,0,47,66
100160,9,640,41,0,0,0,0,51,92
125933,9,640,116,0,2,0,1,187,306
19493,7,157,46,0,0,0,0,66,112
23006,4,159,334,12,8,0,2,579,935
110488,6,124,90,0,1,0,0,126,217
52522,6,263,142,2,1,0,2,207,354
27223,10,618,18,1,1,0,0,6,26
42804,7,492,2,0,0,0,0,3,5
84712,7,74,15,5,2,0,2,41,65
155886,4,752,2,0,0,0,0,0,2
5304,8,885,214,5,2,0,3,387,611
159160,4,174,31,0,0,0,0,50,81
118996,9,302,150,1,0,0,0,188,339
145774,5,570,544,21,15,1,4,932,1517
16766,9,640,435,11,6,3,0,679,1134
40816,10,289,8,0,0,0,0,17,25
89311,9,630,260,14,3,2,0,394,673
133187,6,200,21,0,0,0,0,25,46
130032,10,81,83,1,0,1,0,106,191
130667,4,569,102,0,0,0,0,171,273
163046,4,174,38,0,0,0,0,48,86
157236,5,200,1,0,0,0,0,1,2
82357,8,489,271,1,1,0,1,442,716
28084,6,235,411,8,5,0,4,682,1110
110587,9,842,641,7,5,0,3,956,1612
51726,10,289,12,0,0,0,0,15,27
55116,9,367,17,0,0,0,0,32,49
103304,9,842,86,0,0,0,0,147,233
123313,10,617,26,0,0,0,0,31,57
140811,4,174,25,0,0,0,0,44,69
165949,6,368,149,3,14,0,3,204,373
50581,7,741,4,0,0,0,0,9,13
10974,9,842,157,5,5,0,1,257,425
23626,6,165,3,0,0,0,0,5,8
73314,9,842,392,5,3,2,2,600,1004
94217,5,58,58,0,0,0,0,70,128
37164,4,519,134,3,1,0,1,253,392
125892,7,741,50,0,0,0,0,91,141
44297,4,890,105,3,2,0,0,174,284
46716,5,699,61,1,1,0,0,84,147
87282,8,403,264,1,1,0,0,417,683
103693,8,403,525,30,10,1,2,888,1456
75393,5,885,48,0,0,0,0,66,114
82990,5,885,84,1,0,0,1,129,215
167942,6,165,35,1,1,0,0,51,88
24742,11,489,28,2,0,0,0,20,50
42226,10,200,62,0,0,0,1,150,213
37865,9,630,770,0,0,0,7,1446,2223
60774,8,306,26,0,0,0,0,27,53
8566,8,306,15,0,0,0,0,19,34
147518,8,214,150,2,0,0,0,182,334
139681,8,403,410,19,7,1,3,636,1076
151795,8,214,326,0,1,0,2,500,829
10399,9,399,218,0,1,0,1,326,546
101058,6,789,13,0,0,0,0,21,34
79136,5,58,9,0,0,0,0,16,25
72863,9,570,8,0,0,0,1,12,21
61308,9,741,80,0,0,0,1,148,229
108147,9,741,238,0,0,0,1,413,652
136808,8,214,499,6,2,1,1,831,1340
170996,6,800,250,5,4,0,4,453,716
164578,4,890,240,8,2,0,1,334,585
152521,7,447,133,0,0,0,2,233,368
5931,7,447,218,1,1,0,0,321,541
154548,4,174,2,0,0,0,0,2,4
110564,9,630,249,10,7,0,2,320,588
108976,4,581,61,2,1,0,0,104,168
36918,4,200,28,0,0,0,0,41,69
98068,4,36,467,16,11,0,1,867,1362
166171,5,124,23,0,0,0,0,23,46
108569,5,427,14,0,0,0,0,18,32
150818,5,4,37,2,2,0,0,40,81
168071,5,306,436,3,1,1,3,687,1131
133192,8,800,365,16,3,1,2,674,1061
134359,9,842,150,0,0,0,0,468,618
139731,10,111,18,1,0,2,0,16,37
66620,10,111,6,0,0,0,0,7,13
151295,6,296,4,0,0,0,0,3,7
84666,11,545,231,10,0,0,0,274,515
154257,6,306,23,0,0,0,0,47,70
56777,8,214,207,1,0,0,0,299,507
25301,10,653,19,0,0,0,0,13,32
58888,9,427,154,0,0,0,0,279,433
159515,5,200,120,3,2,0,1,158,284
85346,8,693,13,1,0,0,0,10,24
65049,9,570,36,1,0,0,0,44,81
38547,4,658,82,0,0,0,0,128,210
85355,4,174,21,0,0,0,0,29,50
44188,5,78,73,0,0,0,0,109,182
142638,7,864,26,0,0,0,0,40,66
41099,6,885,450,13,9,1,1,681,1155
115482,8,214,385,0,0,0,0,501,886
27052,9,800,49,6,3,1,2,58,119
44764,4,200,179,1,0,0,0,285,465
53939,7,570,27,0,0,0,0,45,72
70821,9,570,69,0,0,0,0,102,171
11728,4,124,377,6,6,0,1,654,1044
25802,7,157,61,1,1,0,0,80,143
96551,9,78,318,13,10,0,2,490,833
148100,9,630,197,7,3,0,0,237,444
47722,6,124,37,3,2,0,0,62,104
163018,4,36,269,0,0,0,1,403,673
107188,11,545,205,12,0,0,0,216,433
111126,11,214,3,0,0,0,0,0,3
80616,10,436,4,0,0,0,0,4,8
101135,9,597,78,1,1,0,0,142,222
141355,9,607,385,7,6,0,2,514,914
72837,4,200,55,1,0,0,0,65,121
113018,7,521,190,2,1,0,0,287,480
44488,5,118,146,4,3,0,1,222,376
65789,4,200,2,0,0,0,0,2,4
52626,7,489,261,11,5,0,1,397,675
80211,4,923,17,0,0,0,0,37,54
106306,10,756,13,0,0,0,0,18,31
28310,11,214,4,1,0,0,0,2,7
90279,4,375,20,0,0,0,0,27,47
79296,10,831,28,0,0,0,0,44,72
155871,11,489,2,0,0,0,0,2,4
74988,4,658,104,2,1,0,0,184,291
96955,4,375,222,3,1,0,1,320,547
54332,11,545,247,21,0,0,0,286,554
74480,9,185,49,1,1,0,0,93,144
126722,6,800,161,8,3,0,3,271,446
128669,8,545,36,0,0,0,0,29,65
165246,8,545,83,2,0,0,0,112,197
59233,6,489,89,2,2,0,1,144,238
56162,7,551,84,4,2,1,0,171,262
64792,6,132,12,0,0,0,0,31,43
106083,7,551,36,2,1,0,0,76,115
2829,10,752,184,7,3,0,0,301,495
18205,6,827,285,13,5,3,1,554,861
148310,5,124,101,2,1,0,0,138,242
85666,8,489,440,0,0,0,3,677,1120
119934,8,545,146,1,1,0,1,282,431
53945,6,800,331,13,6,1,1,465,817
108117,10,66,202,3,3,0,1,336,545
42923,6,209,89,5,2,0,1,107,204
42946,6,209,29,1,1,0,0,48,79
93837,10,81,35,0,0,0,0,56,91
72252,6,165,19,0,0,0,0,33,52
25655,4,885,17,0,0,0,0,20,37
60675,5,200,24,0,0,0,0,39,63
137803,5,479,29,0,0,0,0,51,80
103908,10,474,356,3,1,0,4,507,871
57828,7,836,19,0,0,0,0,32,51
139638,10,474,212,2,1,0,2,374,591
86607,10,692,309,4,2,0,3,428,746
77530,11,545,162,14,0,0,0,191,367
67681,8,214,34,0,0,0,0,43,77
90476,4,885,66,0,0,0,0,87,153
132257,8,693,296,4,3,0,2,509,814
69083,7,306,182,0,0,0,1,281,464
157729,4,923,86,5,2,0,0,170,263
65306,9,378,10,0,0,0,0,10,20
22403,4,159,33,0,0,0,0,47,80
110697,8,801,481,11,4,1,1,652,1150
109392,6,165,170,6,4,1,0,217,398
47417,6,165,98,3,1,1,2,190,295
147021,9,378,28,0,0,0,1,28,57
166744,5,118,187,7,2,3,1,277,477
35635,4,885,243,3,1,0,0,402,649
101348,9,640,542,17,11,1,2,773,1346
5890,4,890,443,8,6,0,1,721,1179
68279,4,800,228,2,2,0,2,346,580
77808,6,165,9,0,0,0,0,10,19
69120,4,453,41,0,0,0,0,66,107
168503,4,890,112,0,1,0,1,192,306
163832,4,890,35,0,0,0,0,55,90
161867,4,453,44,0,0,0,0,85,129
161323,4,453,39,0,1,0,0,63,103
88376,8,801,112,1,1,0,0,133,247
96939,10,820,2,0,0,0,0,19,21
115731,5,124,50,0,0,0,0,62,112
148457,9,469,52,0,0,0,0,32,84
133282,10,820,18,4,1,0,0,38,61
117166,10,63,90,2,3,0,0,178,273
43639,9,79,1,0,0,0,0,1,2
66253,8,214,127,0,0,0,0,183,310
72566,11,375,38,1,0,0,0,42,81
101604,8,801,26,2,1,0,0,64,93
165590,7,535,58,2,2,0,0,112,174
65500,7,535,66,1,1,1,0,80,149
55177,10,820,6,1,1,0,0,27,35
80160,5,306,278,0,0,0,2,402,682
70350,10,820,2,0,0,0,0,2,4
75119,8,800,51,1,1,1,0,87,141
53733,10,413,2,0,0,0,0,3,5
66576,10,820,287,1,2,0,2,354,646
50346,10,709,117,2,1,0,0,303,423
64679,11,306,8,0,0,0,0,5,13
159483,10,709,104,1,1,0,0,281,387
164753,8,800,132,2,1,0,0,305,440
46440,5,453,42,1,1,0,1,76,121
150209,4,885,40,0,0,0,0,69,109
117462,10,709,51,2,2,0,1,160,216
169849,8,30,4,0,0,0,0,1,5
169899,6,306,351,1,1,0,5,550,908
66410,6,306,194,4,1,0,1,357,557
43532,6,306,67,0,0,0,1,162,230
41757,9,378,16,0,0,0,0,9,25
43978,4,453,1,0,0,0,0,0,1
162571,7,741,3,0,0,0,0,3,6
76491,9,100,117,11,3,2,1,203,337
76696,4,800,370,6,4,0,2,567,949
138183,10,841,112,1,1,0,0,173,287
93447,5,124,122,5,2,0,0,168,297
170003,5,124,88,2,0,1,0,104,195
45518,6,570,539,11,8,0,4,775,1337
158998,6,570,119,2,1,0,0,169,291
147776,4,453,390,4,2,0,2,519,917
66019,7,157,128,1,1,0,0,183,313
166307,4,200,95,3,0,0,0,130,228
80799,4,752,149,0,0,0,0,219,368
95323,6,124,9,0,0,0,0,15,24
19557,5,306,39,0,0,0,0,54,93
94197,6,306,25,0,0,0,0,45,70
46555,6,404,274,0,0,0,2,476,752
168563,9,912,1,0,0,0,0,2,3
78817,8,801,76,1,0,0,0,126,203
101054,5,181,211,6,2,0,2,409,630
170759,7,56,27,1,1,0,0,44,73
39286,8,801,28,0,0,0,0,35,63
6133,5,78,52,0,0,0,0,67,119
29232,9,640,1237,44,28,1,4,1967,3281
12465,6,489,224,10,5,2,1,342,584
75261,6,51,182,3,2,0,2,244,433
85321,8,800,39,0,0,0,0,69,108
161028,5,655,66,1,0,0,1,86,154
86183,6,800,10,0,0,0,0,8,18
73025,6,124,180,0,0,0,2,293,475
165300,4,306,11,0,0,0,0,25,36
31315,7,489,88,0,0,0,0,244,332
42498,6,124,1720,60,26,0,19,2960,4785
157250,11,214,4,0,0,0,0,2,6
36989,6,78,695,20,10,0,2,1085,1812
126905,6,78,50,0,0,0,0,85,135
137193,8,214,483,12,4,0,9,774,1282
127355,8,214,178,0,1,0,3,260,442
94554,7,489,206,6,2,0,1,319,534
64783,8,800,35,0,0,0,0,63,98
22141,10,355,0,0,0,0,0,16,16
22389,4,200,96,0,0,0,0,142,238
166131,7,79,101,6,2,0,0,153,262
26440,4,800,20,0,0,0,0,19,39
39338,5,561,36,0,0,0,0,48,84
144454,6,489,15,0,0,0,0,14,29
111930,8,403,63,4,2,0,0,112,181
152848,5,218,30,0,0,0,0,45,75
16039,8,800,610,16,7,0,3,989,1625
4056,5,479,17,0,0,0,0,32,49
7198,10,208,213,0,1,0,0,207,421
64036,8,623,338,12,3,0,2,615,970
111987,4,159,358,8,3,0,1,553,923
6421,7,864,2,0,0,0,0,3,5
131833,4,174,131,0,0,0,1,177,309
96960,6,885,103,4,3,0,1,171,282
106479,11,489,195,9,0,0,0,201,405
154422,10,914,78,1,0,0,0,118,197
99230,5,479,266,4,1,0,1,392,664
26089,5,479,52,0,0,0,0,92,144
115245,6,269,1,0,0,0,0,0,1
123650,8,800,549,21,6,0,5,912,1493
69687,6,269,5,0,0,0,0,10,15
110018,6,269,1,0,0,0,0,1,2
109382,7,56,55,2,1,0,1,95,154
19069,9,100,36,1,1,0,1,66,105
147227,6,124,855,28,13,1,5,1403,2305
65286,6,200,25,0,0,0,0,40,65
160348,6,200,63,0,0,0,0,96,159
44080,7,100,2,0,0,0,0,13,15
112306,6,489,133,0,0,0,2,232,367
169961,11,658,19,2,0,0,0,20,41
111575,4,174,39,0,0,0,0,45,84
168984,6,800,772,19,15,2,2,1722,2532
163004,8,30,65,0,0,0,0,91,156
136457,9,640,144,2,1,0,1,199,347
108671,9,842,275,4,3,0,2,426,710
43486,9,301,54,2,2,0,1,74,133
160837,9,489,191,4,3,1,2,292,493
60773,4,752,23,1,0,0,0,35,59
52400,4,220,52,1,1,0,1,111,166
33764,9,489,43,0,0,0,0,63,106
329,4,220,110,1,1,0,1,182,295
26950,9,658,2,0,0,0,0,3,5
5958,9,658,10,0,0,0,0,17,27
90215,11,812,2,0,0,0,0,2,4
10237,11,812,25,0,0,0,0,21,46
73832,10,66,13,0,0,0,1,20,34
70664,4,36,318,14,7,1,1,463,804
60925,4,200,85,1,0,0,2,128,216
86577,9,630,374,16,2,1,3,590,986
84010,10,36,3,0,0,0,0,2,5
90143,4,200,69,0,0,0,0,107,176
13539,9,575,34,2,2,0,0,68,106
53501,9,575,95,1,1,0,1,165,263
157322,6,140,32,0,1,0,0,66,99
35036,9,418,19,1,0,0,0,40,60
96047,9,374,23,1,1,0,1,29,55
122336,4,923,54,1,1,0,0,106,162
137311,6,789,17,0,0,0,0,18,35
116667,11,545,61,8,0,0,0,71,140
7308,5,821,35,0,1,0,0,42,78
22575,4,174,17,0,0,0,0,28,45
42461,4,174,77,0,1,0,0,115,193
68525,9,489,85,1,2,0,2,134,224
119495,9,489,98,2,2,0,0,133,235
6750,9,640,324,21,10,0,1,524,880
63418,11,306,8,0,0,0,0,8,16
50650,5,78,1,0,0,0,0,1,2
70837,9,100,643,0,0,0,0,1236,1879
38360,8,489,239,0,0,0,2,377,618
50929,6,537,53,0,0,0,0,79,132
100413,4,375,102,0,0,0,0,159,261
3311,6,901,94,12,1,0,0,147,254
1692,5,78,161,2,1,0,1,243,408
131471,7,387,154,2,1,0,1,245,403
57975,6,235,338,10,5,0,2,588,943
40080,7,693,6,0,0,0,0,11,17
8835,5,453,28,0,0,0,0,42,70
109643,5,453,8,0,0,0,0,16,24
124141,7,741,247,3,2,0,3,386,641
124462,10,807,27,0,0,0,0,81,108
11259,10,743,8,0,0,0,0,33,41
154639,8,214,4,0,0,0,0,7,11
68407,7,741,56,0,0,0,0,83,139
78881,8,623,229,8,4,0,0,391,632
63955,7,175,228,13,5,1,0,477,724
105321,7,521,10,0,0,0,0,16,26
166724,7,521,26,0,0,0,0,44,70
11540,7,587,176,7,2,0,1,254,440
105653,10,617,40,0,1,0,0,62,103
98435,7,521,1,0,0,0,0,2,3
85473,9,489,77,3,2,0,2,143,227
74084,9,489,97,5,2,0,2,131,237
27045,6,785,26,5,1,1,0,43,76
125944,9,630,247,6,3,0,3,302,561
104851,9,427,37,0,0,0,0,66,103
5360,10,111,24,0,0,0,0,28,52
46547,8,812,153,2,1,0,1,218,375
82877,8,545,9,0,0,0,0,12,21
20304,8,623,184,3,1,0,1,299,488
26026,9,607,335,7,5,0,2,461,810
129508,6,140,34,0,0,0,1,54,89
45437,9,607,152,5,2,0,1,235,395
133805,8,214,56,0,0,0,0,53,109
138024,8,623,21,0,0,0,0,22,43
31336,7,587,54,0,1,0,0,80,135
10062,7,741,874,26,13,0,6,1405,2324
107999,9,367,50,1,1,0,0,96,148
129211,9,427,74,0,0,0,0,155,229
63065,9,427,48,0,0,0,0,135,183
141795,9,8,107,1,0,0,0,164,272
3211,9,8,38,0,0,0,0,60,98
92458,9,427,24,0,0,0,0,100,124
167738,9,462,9,0,0,0,0,9,18
15785,9,427,525,0,0,0,5,982,1512
157677,7,24,54,0,0,0,0,114,168
44741,9,30,22,0,0,0,0,37,59
36565,9,30,27,0,0,0,0,52,79
44021,7,196,38,2,2,0,0,50,92
141085,4,375,5,0,0,0,0,8,13
47714,9,545,25,1,1,0,1,42,70
126137,6,827,32,0,0,0,0,48,80
75611,6,729,8,1,5,0,0,16,30
128885,6,200,499,9,5,0,1,708,1222
21918,7,861,57,0,0,0,0,91,148
29484,9,175,9,0,0,0,0,16,25
28984,9,42,15,0,0,0,0,17,32
67890,9,117,111,1,1,0,0,164,277
157962,9,462,75,1,0,0,0,144,220
57773,9,374,24,0,1,0,0,28,53
5365,8,489,337,7,3,0,5,560,912
67926,9,489,65,0,0,0,1,112,178
170637,4,752,219,4,3,0,2,335,563
12991,9,489,53,4,2,0,1,92,152
85493,9,489,88,1,0,0,0,101,190
69602,4,174,2,0,0,0,0,3,5
104033,9,427,27,0,0,0,0,84,111
153628,6,800,186,11,4,0,0,259,460
51052,11,30,17,4,0,0,0,17,38
98367,9,842,58,0,0,0,0,97,155
81133,7,669,4,0,0,0,0,8,12
56945,7,669,11,0,0,0,0,18,29
51756,7,669,4,2,1,0,0,12,19
52285,4,923,418,19,9,0,3,664,1113
26133,8,812,613,24,9,0,6,1137,1789
105859,7,56,10,0,0,0,0,15,25
73811,7,669,6,0,0,0,0,7,13
67013,6,375,57,1,2,0,0,86,146
45839,7,429,3,0,0,0,0,8,11
146026,7,429,17,0,0,0,0,61,78
67301,5,783,35,1,1,0,0,48,85
116646,5,159,41,0,0,0,0,57,98
80252,9,302,10,0,0,0,0,18,28
126059,9,302,11,5,0,0,0,42,58
27937,4,638,60,0,0,0,0,112,172
67904,11,403,75,5,0,0,0,90,170
84320,11,545,74,15,0,0,0,87,176
153452,8,489,35,0,0,0,0,56,91
34945,8,801,31,0,0,0,0,43,74
99693,5,140,42,0,0,1,0,74,117
113134,7,175,67,0,2,0,0,163,232
164688,7,175,17,0,0,0,0,85,102
6956,10,474,28,0,0,0,0,57,85
57074,9,575,617,28,13,1,7,1078,1744
164466,5,124,71,1,1,0,0,76,149
114676,4,174,626,16,8,0,2,1100,1752
24049,4,174,117,0,0,0,0,176,293
638,8,403,107,2,4,0,0,177,290
169810,10,355,5,0,0,0,0,9,14
110732,8,801,80,0,0,0,1,143,224
130365,10,81,110,0,0,0,1,140,251
6730,10,820,13,0,0,0,0,27,40
151052,5,225,60,0,0,0,0,86,146
36787,6,843,380,9,6,2,1,607,1005
52681,4,36,74,2,1,0,0,157,234
150506,11,214,16,0,0,0,0,19,35
121869,6,124,12,0,0,0,0,12,24
71118,9,427,67,0,0,0,0,171,238
1707,9,427,121,0,0,0,2,214,337
128191,6,200,83,5,0,0,2,109,199
41097,4,658,16,0,0,0,0,31,47
161338,8,214,12,0,0,0,0,13,25
152533,9,741,342,0,0,0,8,792,1142
90251,9,741,144,0,0,0,2,382,528
14594,10,820,7,0,0,0,0,15,22
14605,4,375,89,0,0,0,0,143,232
64789,7,157,51,1,1,0,0,76,129
61691,7,641,21,0,0,0,0,45,66
106937,7,641,8,0,0,0,0,27,35
21441,7,641,24,0,0,0,0,49,73
48919,4,569,42,1,0,0,0,64,107
13181,7,641,12,0,0,0,0,20,32
50760,11,214,51,0,0,0,0,44,95
148691,7,641,117,1,0,0,0,221,339
120130,7,508,36,0,0,0,0,59,95
64986,10,66,1,0,0,0,0,2,3
39834,7,641,183,0,1,0,0,296,480
35942,9,489,131,3,4,0,1,222,361
126072,7,157,191,4,5,0,1,281,482
116098,7,496,175,1,0,0,0,298,474
163953,7,508,60,1,1,0,1,124,187
1497,9,575,243,4,3,2,0,354,606
66118,7,698,87,3,2,1,0,144,237
74747,7,748,111,1,1,0,0,171,284
52248,7,748,118,1,1,0,0,207,327
145045,7,748,46,1,0,0,1,77,125
122487,7,508,7,0,0,0,0,17,24
143089,7,748,23,0,0,0,0,30,53
21506,7,748,63,2,0,1,0,76,142
147350,7,748,28,1,1,0,0,71,101
131357,7,748,32,4,0,0,0,52,88
101500,4,752,15,0,0,0,0,20,35
54246,4,923,56,2,2,0,0,82,142
145933,7,157,13,0,0,0,0,20,33
22489,5,306,51,1,0,0,0,70,122
62867,10,831,18,0,0,0,0,27,45
36687,6,885,63,0,0,0,0,87,150
137465,10,658,0,0,0,0,4,3675,3679
138732,9,589,168,2,1,0,1,303,475
103358,6,885,157,4,0,0,1,259,421
158397,7,578,607,20,6,3,2,922,1560
165424,8,812,155,0,0,0,0,239,394
72873,4,200,70,1,0,0,0,84,155
105885,9,597,10,0,0,0,0,9,19
131286,9,597,4,0,0,0,0,6,10
162002,9,597,171,4,2,0,1,210,388
147909,8,403,19,0,0,0,0,18,37
132898,9,597,10,0,0,0,0,11,21
13347,9,597,13,0,0,0,0,17,30
35350,9,589,427,12,4,2,3,819,1267
79238,5,427,210,6,7,0,0,332,555
83183,4,270,163,0,2,0,0,230,395
147797,5,655,43,4,0,1,0,75,123
69368,4,174,54,0,0,0,0,73,127
84264,10,701,5,0,0,0,0,15,20
95730,7,693,415,6,3,0,2,694,1120
151813,4,174,16,0,0,0,0,25,41
30113,4,453,25,0,0,0,0,39,64
88254,7,157,99,0,1,0,0,155,255
10676,7,214,103,2,2,0,0,154,261
115846,6,159,12,0,0,0,0,20,32
18625,8,214,58,0,0,0,0,83,141
86642,5,200,38,2,1,0,0,46,87
99505,8,515,117,2,1,0,0,151,271
66243,4,885,241,0,0,0,1,349,591
25898,9,800,36,0,0,0,0,55,91
133718,9,800,157,4,5,0,0,373,539
67150,9,630,84,4,0,0,0,109,197
102655,8,214,20,3,0,0,0,4,27
44582,9,427,188,0,0,0,0,386,574
111740,9,427,125,0,0,0,0,325,450
61124,7,196,18,0,0,0,0,46,64
92299,7,741,433,21,7,1,2,669,1133
132253,4,453,240,2,0,0,0,301,543
3392,7,492,28,0,0,0,0,44,72
139736,10,653,54,0,1,0,0,133,188
58754,9,838,3,0,0,0,0,1,4
117128,9,158,34,0,1,0,0,76,111
109317,10,798,37,0,0,0,0,46,83
147751,4,593,48,0,0,0,0,97,145
31685,4,593,53,0,0,0,0,71,124
147112,9,158,101,7,0,1,1,134,244
19988,4,453,7,0,0,0,0,3,10
126801,4,638,12,0,0,0,0,21,33
109068,9,452,6,0,0,0,0,7,13
137220,9,158,6,0,0,0,0,8,14
72524,7,587,10,0,0,0,0,15,25
18884,8,812,22,0,0,0,0,33,55
33296,9,158,13,0,0,0,0,9,22
6355,9,158,46,3,1,0,0,81,131
53001,8,812,113,3,0,1,2,157,276
56731,10,820,113,0,0,0,0,158,271
143602,10,798,4,0,0,0,0,4,8
123360,8,885,678,5,0,0,3,962,1648
81582,4,453,6,0,0,0,0,5,11
126591,11,214,13,3,0,0,0,10,26
71272,7,157,7,0,0,0,0,11,18
16350,4,174,64,0,1,0,2,66,133
85172,8,885,1520,21,5,1,14,2941,4502
36246,10,208,44,0,0,0,0,63,107
15780,6,263,792,18,12,1,6,1092,1921
48265,6,78,81,0,0,0,0,130,211
115630,6,263,290,1,0,0,3,419,713
22752,10,820,4,0,0,0,0,25,29
113730,10,820,6,0,0,0,0,25,31
151441,7,80,22,0,0,0,0,41,63
53532,10,917,25,1,1,0,0,49,76
35161,9,819,56,7,0,2,1,123,189
170757,9,78,835,0,0,0,3,1084,1922
37987,8,812,793,13,6,1,1,1233,2047
162092,7,118,249,7,4,1,1,406,668
167508,9,489,182,3,3,0,3,317,508
5193,9,489,12,0,0,0,0,16,28
119312,6,78,125,0,0,0,0,199,324
29539,6,901,48,3,2,0,1,95,149
61903,4,725,73,0,0,0,0,99,172
41694,5,238,56,0,0,0,0,145,201
111659,8,214,2,0,0,0,0,0,2
23773,7,589,227,6,7,0,0,560,800
37700,8,812,509,17,12,0,2,809,1349
42980,8,214,125,0,1,0,1,159,286
27920,4,36,110,2,1,0,1,190,304
138518,10,820,104,0,1,0,0,164,269
82801,7,484,9,0,0,0,0,16,25
110315,6,251,4,0,0,0,0,7,11
68328,8,214,268,7,3,1,1,536,816
81427,8,214,8,0,0,0,0,11,19
162527,9,492,17,0,0,0,0,27,44
25075,8,214,223,0,0,0,1,368,592
130933,4,800,22,0,0,0,0,26,48
153922,4,220,386,12,6,0,4,760,1168
119643,5,783,23,0,0,0,0,41,64
146775,4,199,34,0,0,0,0,51,85
128644,7,892,1,0,0,0,0,3,4
9954,6,132,21,0,0,0,0,18,39
110657,10,617,63,0,0,0,0,84,147
101912,11,30,1,0,0,0,0,1,2
5852,4,270,41,1,0,0,0,63,105
121189,9,243,23,3,1,0,0,26,53
164896,4,752,192,6,3,0,3,241,445
128205,4,752,88,0,0,0,0,116,204
148201,10,208,18,0,0,0,0,29,47
6371,9,243,12,0,0,0,0,11,23
66815,9,243,12,0,0,0,0,4,16
87255,8,214,28,0,0,0,0,41,69
140587,7,741,253,6,3,1,0,407,670
64500,9,367,295,0,0,0,3,384,682
143000,9,243,4,0,0,0,0,0,4
152249,8,489,100,0,0,0,1,154,255
72025,8,214,61,0,0,0,0,61,122
65076,9,630,44,0,0,0,0,64,108
158264,11,545,68,1,0,0,0,77,146
156087,5,293,12,0,0,0,0,13,25
39207,9,640,67,0,0,0,0,133,200
111404,8,800,357,11,2,4,4,687,1065
95756,4,375,139,1,3,0,0,289,432
163456,10,355,0,0,0,0,0,51,51
134087,9,597,116,2,1,0,0,178,297
102204,8,812,1612,57,34,0,13,2586,4302
6996,5,371,173,3,2,2,0,231,411
139768,4,800,24,0,0,0,0,34,58
106252,8,812,110,0,1,0,1,177,289
109468,6,827,15,0,0,0,0,31,46
3179,7,551,35,3,3,0,0,53,94
1473,7,521,41,0,0,0,0,67,108
116857,7,872,74,0,0,0,0,82,156
75665,7,521,28,0,0,0,0,42,70
50278,7,521,17,0,0,0,0,21,38
46796,5,773,58,0,0,0,0,58,116
125158,5,209,11,1,0,0,0,14,26
143390,9,243,16,0,1,0,0,37,54
48219,5,58,112,9,7,0,1,173,302
121405,9,341,59,1,0,0,0,101,161
132245,9,145,12,0,0,0,0,31,43
131227,9,243,25,0,0,0,0,23,48
37247,8,489,196,1,2,0,1,315,515
125532,9,545,7,0,0,0,0,23,30
37,8,885,5,0,0,0,0,10,15
96656,4,200,77,0,0,0,0,129,206
123631,8,124,158,2,1,0,0,262,423
13333,9,380,8,0,0,0,0,12,20
82337,9,42,6,0,0,0,0,9,15
137149,4,658,124,2,3,0,1,173,303
111559,4,200,212,2,1,0,2,311,528
11025,4,800,5,0,0,0,0,8,13
126843,7,861,23,0,0,0,0,51,74
116826,9,100,409,0,0,0,1,840,1250
13783,8,489,124,1,0,0,2,178,305
100836,7,374,6,0,0,0,0,11,17
50944,11,693,89,16,0,0,0,102,207
167852,10,355,31,1,1,0,1,38,72
29815,10,617,114,4,2,0,0,162,282
38502,7,310,17,0,0,0,0,30,47
90352,9,630,35,0,0,0,0,54,89
12305,9,427,112,0,0,0,0,173,285
53692,5,699,478,16,8,0,1,722,1225
52055,7,175,152,1,1,0,1,328,483
53110,8,214,28,0,0,0,1,55,84
76555,7,374,2,0,0,0,0,9,11
66050,7,374,12,0,0,0,0,30,42
84596,7,737,6,0,0,0,0,9,15
76983,10,208,26,0,0,0,0,45,71
36502,7,74,52,2,1,0,0,81,136
90474,7,508,14,0,0,0,0,18,32
46158,9,640,304,6,4,0,2,493,809
86281,10,781,12,0,0,0,0,32,44
86915,8,885,201,4,3,0,4,333,545
67057,9,630,87,2,0,0,0,153,242
50724,5,427,275,0,0,0,0,376,651
20148,9,570,13,0,0,0,0,19,32
148901,9,630,95,0,0,0,0,126,221
12733,9,570,9,0,0,0,0,15,24
69704,9,489,505,22,7,1,2,912,1449
72808,4,800,14,1,1,0,0,13,29
149659,4,923,13,0,0,0,0,7,20
102421,5,800,33,0,0,0,1,58,92
11895,10,18,78,2,0,0,0,138,218
77013,6,800,98,2,2,0,1,151,254
100458,10,111,25,0,0,0,1,37,63
10509,8,693,3,0,0,0,0,6,9
171059,7,157,6,0,0,0,0,13,19
134783,9,640,152,5,2,0,2,244,405
121480,8,124,463,0,0,0,1,773,1237
144955,4,658,77,0,0,0,0,116,193
61013,9,427,42,0,0,0,1,175,218
104668,10,66,17,0,0,0,0,65,82
63703,10,66,1,0,0,0,0,83,84
115582,10,66,300,5,2,0,2,526,835
74774,10,66,6,0,1,0,0,50,57
46031,5,585,27,0,0,0,0,41,68
65141,6,489,158,0,0,0,0,190,348
111288,9,306,14,0,0,0,0,19,33
161204,9,469,11,0,0,0,1,16,28
56088,4,453,23,0,0,0,0,36,59
87698,9,469,3,0,0,0,0,3,6
151181,9,630,260,0,0,0,0,424,684
98084,9,469,5,0,0,0,0,11,16
16708,4,658,77,0,0,0,0,83,160
28705,9,469,4,0,0,0,0,4,8
112555,8,489,465,17,5,1,1,840,1329
148237,4,658,42,0,0,0,1,77,120
118801,9,630,2,0,0,0,0,3,5
130954,7,741,260,5,5,0,3,376,649
35078,9,469,374,7,3,0,3,532,919
45364,9,570,195,0,0,0,0,303,498
159045,7,306,508,1,2,0,5,813,1329
26712,9,570,267,0,0,0,2,452,721
159649,4,885,6,0,0,0,0,5,11
23987,10,653,326,9,1,0,4,544,884
103753,4,733,17,1,1,0,0,32,51
155943,7,693,23,1,1,0,0,44,69
86743,9,367,124,0,0,0,0,237,361
36045,9,243,93,0,1,1,2,98,195
84991,10,576,7,2,0,0,0,50,59
120758,9,367,184,4,3,1,0,286,478
63669,4,519,30,0,0,0,0,42,72
73615,7,306,31,0,0,0,0,40,71
164721,11,545,98,1,0,0,1,113,213
11009,11,214,13,0,0,0,0,20,33
79440,9,302,103,1,0,0,0,249,353
146302,7,489,312,12,6,0,0,515,845
104774,9,575,1,0,0,0,0,0,1
70499,7,489,356,9,5,0,1,598,969
68011,7,861,82,4,1,1,1,216,305
152142,10,653,103,1,0,0,0,151,255
586,10,653,58,0,0,0,1,80,139
40346,11,545,32,1,0,0,0,44,77
80239,10,653,276,0,0,0,2,337,615
17014,8,812,136,3,2,0,1,175,317
112205,10,653,43,0,0,0,0,101,144
152629,10,36,95,3,3,0,1,167,269
131403,8,812,140,0,0,0,2,221,363
50767,5,821,22,0,0,0,0,27,49
50076,10,653,72,0,0,0,0,103,175
78318,9,302,432,4,1,0,1,779,1217
99360,7,748,24,0,0,0,0,40,64
71939,9,800,40,1,1,0,0,52,94
143520,7,748,59,0,0,0,0,106,165
61009,9,909,65,0,0,0,0,108,173
122575,9,379,81,0,0,6,0,120,207
78499,9,78,82,0,0,0,0,98,180
99435,8,30,3,0,0,0,0,3,6
139744,7,472,60,0,0,0,0,82,142
142091,7,489,492,8,8,0,5,763,1276
116624,6,922,31,0,0,0,0,30,61
88898,7,46,94,2,0,0,0,173,269
154871,5,263,74,0,0,0,0,96,170
96883,9,367,160,5,3,1,2,230,401
15002,8,214,77,1,0,0,0,104,182
96808,8,812,73,2,1,0,0,120,196
152431,9,828,16,3,1,0,0,14,34
78169,10,200,43,0,0,0,0,80,123
37564,5,58,157,1,0,0,0,266,424
165545,8,812,84,1,1,0,2,166,254
148386,5,58,23,2,0,0,0,42,67
95480,11,545,16,1,0,0,0,16,33
11136,9,658,4,0,0,0,0,6,10
123738,9,658,5,0,0,0,0,8,13
78130,8,812,140,0,0,0,0,198,338
102884,9,607,62,0,0,0,0,92,154
117577,9,658,6,0,0,0,0,10,16
20725,5,489,136,0,0,0,0,178,314
41749,10,917,15,0,0,0,0,67,82
34632,9,658,11,1,1,0,0,22,35
15566,9,658,2,0,0,0,0,8,10
6780,8,812,136,5,1,0,4,221,367
64515,10,413,57,2,1,0,0,76,136
136717,5,489,168,10,9,0,1,312,500
160023,5,225,309,4,3,0,1,444,761
147594,9,306,102,0,0,0,0,304,406
8654,4,800,45,0,0,0,0,82,127
38355,6,59,54,2,2,0,2,98,158
120029,6,59,26,0,0,0,0,46,72
72543,5,59,127,2,0,0,0,203,332
77789,11,403,57,1,0,0,0,65,123
132536,6,556,20,0,1,0,0,45,66
84855,8,623,252,5,2,0,2,471,732
66505,8,812,265,0,0,0,2,348,615
80395,10,617,31,0,0,0,1,59,91
105756,8,545,74,0,0,0,0,122,196
163944,4,200,264,2,1,0,1,383,651
9860,10,104,305,3,1,0,0,463,772
128862,4,885,39,0,0,0,1,75,115
7732,10,104,90,0,0,0,0,118,208
13094,8,623,48,0,0,0,0,57,105
3692,8,623,17,0,0,0,0,16,33
129300,8,623,157,1,1,0,0,202,361
81379,10,917,9,0,0,0,0,18,27
45355,10,63,93,0,1,0,0,113,207
73326,6,789,41,1,0,0,0,56,98
99625,8,214,1999,75,30,7,14,3416,5541
2153,8,214,10,0,0,0,0,16,26
138911,10,63,246,5,2,0,1,351,605
100911,7,658,31,0,0,0,0,52,83
19628,8,214,349,4,2,0,1,657,1013
101116,8,214,244,0,0,0,1,490,735
120852,6,570,243,6,3,0,0,455,707
44479,4,800,132,0,0,0,2,206,340
154020,5,479,54,0,0,0,0,78,132
119790,6,922,30,1,1,0,0,43,75
124677,6,489,60,0,0,0,2,119,181
47969,4,453,5,0,0,0,0,11,16
28390,5,176,11,0,0,0,0,21,32
79177,7,77,34,1,1,0,0,52,88
35077,9,741,340,0,0,0,2,838,1180
40395,7,263,45,0,0,0,0,92,137
131834,10,111,23,0,0,0,0,47,70
25274,7,611,5,0,0,0,0,7,12
114454,10,781,10,0,0,0,0,12,22
90208,10,781,30,0,0,0,0,46,76
111102,10,820,11,0,0,0,0,24,35
126771,8,306,144,0,1,0,0,234,379
140300,8,515,255,3,3,0,0,399,660
14128,4,159,144,3,1,0,0,226,374
105115,5,570,50,0,1,0,0,65,116
66446,4,159,10,0,0,0,0,13,23
100634,5,489,649,29,12,1,6,1218,1915
50859,10,831,76,2,1,0,0,221,300
170100,5,235,258,12,7,1,3,348,629
34543,6,556,38,2,1,0,0,79,120
39639,8,214,511,1,0,0,3,816,1331
79446,5,667,253,4,3,1,0,370,631
134277,6,200,72,0,0,0,0,108,180
114385,8,306,33,0,0,0,0,36,69
20918,4,453,288,1,1,0,2,371,663
119513,8,623,233,1,0,0,0,346,580
18039,7,589,85,1,1,0,1,111,199
122159,7,484,31,0,0,0,0,39,70
116889,8,623,76,0,0,0,0,111,187
103236,7,737,6,0,0,0,0,9,15
117599,4,174,73,5,4,0,0,126,208
121044,5,489,44,0,0,0,0,67,111
161719,5,489,36,0,0,0,0,53,89
42512,7,46,37,1,1,0,0,66,105
131928,5,124,31,1,1,0,0,76,109
43,4,752,336,1,1,0,2,524,864
23160,9,367,5,0,1,0,0,9,15
74118,9,452,117,3,4,0,0,187,311
92797,11,214,2,0,0,0,0,2,4
15783,9,452,26,0,0,0,0,45,71
141371,6,200,121,1,1,0,1,204,328
115820,6,489,284,4,1,0,0,407,696
92823,9,452,2,0,0,0,0,6,8
101635,9,452,14,0,0,0,0,19,33
24793,6,209,31,1,0,0,0,42,74
14463,5,783,179,0,0,0,0,238,417
26976,8,214,247,5,2,0,2,359,615
67932,7,489,24,0,0,0,0,28,52
138271,8,623,163,5,4,0,0,238,410
62461,5,427,210,4,3,0,0,335,552
168458,10,653,175,3,2,0,1,303,484
70500,7,157,50,0,0,0,0,96,146
144817,8,214,17,0,0,0,0,20,37
107881,7,157,38,0,0,0,0,62,100
119179,6,165,14,0,0,0,0,10,24
14402,5,58,334,15,7,0,2,501,859
145570,8,800,251,11,5,0,1,358,626
50111,5,232,84,5,2,0,0,139,230
81758,4,453,43,0,0,0,0,49,92
145715,9,842,1689,3,4,0,10,3227,4933
131667,10,81,339,0,0,0,3,546,888
29535,6,693,34,1,0,0,0,47,82
81397,4,124,77,0,0,0,0,91,168
9402,10,701,268,9,4,0,2,389,672
21712,9,640,79,1,1,0,1,88,170
21157,9,640,306,5,5,0,3,364,683
60124,9,145,2,0,2,0,1,11,16
92467,9,597,15,1,0,0,0,23,39
40868,9,597,4,1,0,0,0,5,10
3740,8,88,2,0,0,0,0,4,6
63621,6,235,16,0,0,0,0,16,32
39970,4,159,100,0,1,0,0,159,260
152514,10,81,17,0,0,0,0,20,37
4975,5,140,128,0,0,0,0,190,318
22283,7,824,41,0,0,0,0,64,105
55445,5,106,144,0,0,0,0,186,330
97648,6,263,228,4,2,0,1,271,506
165237,10,653,67,0,1,0,0,133,201
89608,9,79,12,0,0,0,0,16,28
134922,9,79,8,0,0,0,0,23,31
15197,10,701,49,1,1,0,0,78,129
109586,9,79,13,0,0,0,0,25,38
161652,4,752,11,0,0,0,0,10,21
54609,8,214,18,0,0,0,0,24,42
158860,6,922,2,0,0,0,0,2,4
157304,5,699,168,2,1,0,2,243,416
116255,5,140,61,0,0,0,0,115,176
150809,4,36,317,2,1,0,2,557,879
7593,8,623,83,2,2,0,1,122,210
167028,8,812,50,1,1,0,0,75,127
128621,8,812,46,0,0,0,1,78,125
28826,7,489,156,6,5,1,0,223,391
119280,10,653,15,0,0,0,0,55,70
69516,10,653,6,0,0,0,0,14,20
113429,6,785,102,4,1,1,2,146,256
29726,9,800,166,6,5,0,2,445,624
154694,7,861,98,1,1,0,0,175,275
138596,7,861,69,0,0,0,0,157,226
157760,7,885,203,9,4,1,0,600,817
146608,5,821,25,0,0,0,1,50,76
16134,6,209,50,2,2,0,0,70,124
8736,6,785,546,24,13,1,2,818,1404
16865,5,159,100,1,2,0,2,182,287
12463,4,923,121,0,1,0,0,219,341
136788,9,147,37,0,0,0,0,33,70
137719,9,302,16,0,0,0,0,15,31
125825,9,302,126,1,0,0,1,195,323
168822,4,174,62,3,2,0,0,93,160
98787,8,214,599,8,2,0,3,960,1572
83308,5,225,10,0,0,0,0,13,23
22312,7,78,159,4,1,0,0,250,414
135531,4,351,25,0,0,0,0,45,70
96467,4,658,396,11,6,0,3,683,1099
125679,8,693,15,0,0,0,0,18,33
68353,10,701,145,0,0,1,0,165,311
52882,10,692,147,5,1,0,0,263,416
80481,10,692,117,3,2,0,1,179,302
88821,10,474,158,6,3,0,0,304,471
72529,10,841,47,1,1,0,0,120,169
147081,10,841,58,8,1,0,0,93,160
71421,10,63,45,1,1,0,0,67,114
4924,10,63,33,1,1,0,0,51,86
98381,6,827,205,7,2,0,1,413,628
145590,6,453,46,2,1,0,0,81,130
50644,6,827,11,0,0,0,0,29,40
9304,6,827,19,1,1,0,0,65,86
150020,7,741,145,0,0,0,0,291,436
117591,5,200,31,0,0,0,1,63,95
54347,5,404,118,0,0,0,0,176,294
71012,4,220,6,0,0,0,0,4,10
163638,5,375,242,12,7,3,1,370,635
45942,5,159,290,5,4,0,2,491,792
46450,11,214,22,0,0,0,0,23,45
132710,10,29,17,1,0,0,0,21,39
85192,10,797,28,0,0,0,0,42,70
85420,10,550,22,0,0,0,1,62,85
59814,10,820,52,0,0,0,0,88,140
119193,5,159,35,2,1,0,0,53,91
69373,8,214,232,2,2,0,2,344,582
49024,9,741,153,3,1,0,2,231,390
80216,5,225,721,12,3,0,4,1194,1934
61725,5,225,209,0,1,0,0,319,529
52209,8,623,5,0,0,0,0,5,10
71763,5,106,151,4,1,0,1,210,367
154868,9,306,77,0,0,0,0,119,196
45073,9,657,155,5,1,1,1,248,411
110634,8,489,630,1,1,0,1,1026,1659
127320,10,841,250,2,1,0,2,374,629
121815,5,381,209,0,0,0,0,312,521
92216,10,820,3,0,0,0,0,8,11
95073,8,484,139,1,0,0,2,197,339
21809,4,923,43,0,1,0,0,80,124
105020,9,640,429,14,11,0,2,826,1282
80920,7,741,99,2,0,0,1,139,241
53609,9,640,304,1,3,0,1,511,820
80980,7,484,93,1,1,0,1,121,217
22663,4,200,202,3,1,0,0,289,495
117034,6,489,129,2,1,0,1,135,268
17382,8,489,112,2,2,1,2,144,263
27372,4,200,227,2,0,15,0,245,489
144882,8,800,140,6,3,0,1,226,376
159584,9,158,106,1,1,0,0,186,294
70907,9,538,407,65,35,7,0,623,1137
119618,7,896,3,0,0,0,0,3,6
32070,8,484,83,1,0,0,0,120,204
20959,8,211,114,8,3,0,2,196,323
109567,7,741,208,4,1,0,3,341,557
152397,8,622,30,1,1,0,0,38,70
88524,8,489,772,4,2,0,9,1307,2094
47613,9,693,32,0,0,0,0,50,82
154103,9,693,45,0,0,0,1,88,134
7718,10,653,581,13,7,5,6,1037,1649
23619,8,658,54,0,0,0,0,75,129
153167,7,611,1,0,0,0,0,1,2
150611,7,601,56,3,1,0,0,105,165
80863,11,489,3,0,0,0,0,2,5
34979,6,200,24,0,0,0,0,31,55
22876,8,766,3640,93,27,10,11,5712,9493
61337,6,251,2,0,0,0,0,2,4
155673,7,489,145,4,1,0,2,108,260
128671,8,658,72,0,0,0,0,99,171
131952,8,214,2,0,0,0,0,7,9
140991,7,861,161,5,2,0,0,331,499
79458,7,861,47,1,0,0,0,113,161
160032,9,427,11,0,1,0,0,25,37
7848,5,159,28,1,0,0,0,52,81
89026,9,367,241,4,2,0,2,429,678
60945,11,658,41,1,0,0,0,57,99
109417,6,103,25,0,0,0,0,41,66
76772,10,798,2,0,0,0,0,2,4
26574,6,901,111,0,0,0,0,177,288
20513,9,367,24,1,0,0,0,49,74
72885,6,922,10,0,0,0,0,17,27
81132,7,508,21,0,0,0,0,28,49
65657,8,214,249,0,0,0,1,374,624
167634,7,157,15,0,0,0,0,23,38
45758,8,623,120,1,0,0,0,163,284
103669,7,157,26,0,0,0,0,49,75
69432,9,302,10,0,0,0,0,14,24
63994,7,157,3,0,0,0,0,2,5
67283,8,545,195,1,0,0,0,284,480
86059,8,545,46,0,0,0,0,60,106
25389,7,56,108,4,4,0,0,173,289
115416,4,174,74,5,2,0,1,116,198
15563,8,214,127,4,1,0,0,246,378
92121,9,640,177,3,4,0,1,291,476
145627,6,843,86,0,0,0,0,120,206
91908,4,752,10,0,0,0,0,11,21
106642,5,124,281,5,3,0,1,414,704
6083,7,484,18,1,1,0,0,36,56
97703,7,822,15,0,0,0,1,30,46
5069,8,214,331,8,6,0,1,506,852
58684,6,453,91,2,2,0,0,136,231
112929,6,453,27,0,0,0,0,40,67
7050,8,214,160,1,1,0,0,473,635
106960,9,842,468,11,2,0,1,663,1145
134771,5,570,302,9,5,1,1,427,745
48977,9,838,43,0,1,0,0,67,111
20601,8,623,259,0,0,0,0,390,649
71355,6,124,78,0,0,0,0,120,198
12904,8,800,174,6,4,0,0,285,469
82064,9,640,177,8,4,0,1,218,408
82080,8,800,15,0,0,0,0,23,38
95062,6,78,103,0,0,0,0,92,195
74057,8,214,23,0,0,0,0,38,61
47434,10,653,117,0,0,0,2,200,319
376,4,159,178,1,0,0,0,255,434
132242,9,607,348,16,6,3,5,576,954
105404,4,200,114,3,3,0,0,148,268
104023,4,375,6,0,0,0,0,12,18
75641,4,36,153,4,4,0,1,242,404
170428,10,701,215,6,1,3,2,419,646
159124,7,487,3,0,0,0,0,3,6
158352,11,214,54,1,0,0,0,57,112
142003,7,472,20,0,0,0,0,26,46
70330,7,472,41,3,2,0,0,88,134
76711,6,200,232,0,0,0,0,359,591
24232,6,200,124,3,1,0,1,151,280
45424,7,472,7,0,0,0,0,19,26
170239,4,159,239,4,0,0,1,378,622
131322,5,821,171,7,6,0,1,326,511
134776,5,821,70,0,0,0,0,85,155
17497,5,479,102,0,0,0,1,171,274
24262,7,100,60,2,1,0,0,164,227
56955,8,214,577,11,6,0,3,930,1527
26303,8,812,48,1,1,0,1,100,151
34749,7,74,145,11,6,3,2,253,420
34887,4,800,199,1,2,0,1,348,551
8382,4,800,15,0,0,0,0,29,44
59981,4,200,36,0,0,0,0,42,78
108141,4,200,303,4,3,0,2,379,691
8747,7,660,4,0,0,0,0,3,7
10548,11,306,139,2,0,1,0,151,293
113884,8,812,46,3,1,0,0,79,129
85126,9,630,345,9,3,0,1,482,840
136555,5,381,70,0,0,0,0,98,168
26295,6,269,565,19,7,0,3,953,1547
31379,5,728,101,6,5,0,1,136,249
97589,7,263,9,0,0,0,0,14,23
20849,10,242,10,0,0,0,0,19,29
88172,5,118,180,5,6,0,0,390,581
101531,8,124,134,0,0,0,1,293,428
9622,4,200,387,6,3,0,1,640,1037
5146,9,800,5,0,0,0,0,111,116
51983,4,375,89,2,0,0,1,127,219
143005,10,841,102,0,0,0,3,227,332
55480,4,375,31,0,0,0,0,55,86
85946,10,841,183,4,4,0,2,320,513
5087,10,355,0,0,0,0,6,511,517
2967,7,367,49,0,0,0,0,69,118
16341,7,61,91,1,1,0,1,165,259
60750,4,453,41,0,0,0,0,58,99
138247,4,375,30,0,0,0,0,38,68
121491,7,737,16,0,0,0,0,22,38
161724,5,306,7,0,0,0,0,5,12
92616,4,159,64,0,0,0,0,89,153
94556,8,214,769,10,3,0,2,1245,2029
9311,4,658,27,0,1,0,1,37,66
112136,4,159,11,0,0,0,0,18,29
124293,6,235,1,0,0,0,0,2,3
165912,10,653,138,3,1,0,1,224,367
17815,9,538,32,3,0,0,0,53,88
112779,4,658,77,1,1,0,1,114,194
109811,9,80,11,1,0,0,0,36,48
119163,5,570,29,0,0,0,0,36,65
105913,6,290,47,0,0,0,0,54,101
26649,4,453,8,0,0,0,0,21,29
43196,5,225,146,5,2,0,1,250,404
130292,9,640,255,3,1,0,2,369,630
59875,7,556,54,4,0,0,0,65,123
98121,9,640,94,5,3,0,1,135,238
164682,8,214,792,7,0,0,1,1221,2021
107949,8,214,196,2,2,0,1,322,523
142761,10,200,8,0,0,0,0,18,26
162101,4,800,2,0,0,0,0,3,5
43794,7,228,48,5,2,0,0,91,146
164849,7,484,18,5,1,1,0,24,49
154395,8,214,2,0,0,0,0,7,9
151284,8,214,334,4,1,0,2,548,889
76350,8,556,6,0,0,0,0,9,15
20645,8,214,943,1,2,0,5,1452,2403
46133,4,200,194,1,0,0,0,353,548
76226,9,100,74,0,0,0,0,161,235
49960,10,66,4,0,0,0,0,35,39
15963,9,597,2,0,0,0,0,1,3
137833,4,200,109,2,1,0,0,189,301
138878,10,66,13,0,0,0,0,29,42
78957,8,489,36,0,0,0,0,52,88
28517,5,225,66,0,0,0,1,107,174
69113,8,658,341,7,4,0,1,580,933
84176,11,306,85,1,0,0,0,69,155
64501,4,159,9,0,0,0,0,15,24
136556,5,489,38,3,1,0,0,53,95
71651,6,165,187,6,6,1,1,305,506
127484,4,200,158,2,2,0,1,235,398
49854,4,200,8,0,0,0,0,12,20
53287,4,365,6,0,0,0,0,10,16
4359,8,403,131,2,2,0,1,241,377
144051,11,403,75,2,0,0,0,79,156
17646,5,118,92,0,0,0,0,157,249
16168,9,374,18,1,1,0,0,23,43
50094,7,741,24,2,0,0,0,51,77
135276,10,474,34,0,0,0,0,93,127
13270,10,653,131,0,0,0,1,180,312
127048,5,699,231,2,1,0,3,356,593
28416,5,800,93,1,0,0,0,179,273
142201,5,235,31,0,0,0,1,43,75
137236,7,741,11,0,0,0,0,10,21
589,5,489,48,0,0,0,1,54,103
25841,5,263,95,1,0,0,0,145,241
110869,10,841,152,8,1,0,2,292,455
93985,6,785,25,0,0,0,0,50,75
75481,4,36,7,0,0,0,0,4,11
143429,8,214,161,9,4,0,2,321,497
117343,8,124,243,0,0,0,1,364,608
83701,8,800,477,11,7,1,1,725,1222
104251,10,29,23,0,0,0,0,46,69
149844,5,124,22,0,0,0,1,33,56
168270,10,917,18,0,0,0,0,27,45
110109,8,214,722,8,3,0,6,1153,1892
91602,8,214,241,0,0,0,0,368,609
41611,8,214,10,0,0,0,1,13,24
131647,7,577,2,0,0,0,0,2,4
42027,10,18,56,1,0,0,0,75,132
99691,7,310,95,2,3,0,0,175,275
103924,4,519,17,1,1,0,0,33,52
168838,5,371,98,1,1,0,0,143,243
90648,5,773,19,0,0,0,0,29,48
25681,9,487,36,4,0,0,0,77,117
131693,4,658,14,0,0,0,0,20,34
51460,7,741,2365,68,22,7,9,4424,6895
68078,8,623,44,0,0,0,1,73,118
3112,9,95,6,1,1,0,0,8,16
139293,5,306,292,13,9,0,4,437,755
134943,4,174,18,0,0,0,0,20,38
150270,9,216,430,14,12,1,4,688,1149
2104,4,174,142,2,3,0,1,230,378
6769,5,225,103,0,0,0,0,158,261
23161,5,218,56,1,1,0,0,98,156
89433,5,296,206,6,0,0,0,252,464
47090,7,100,25,1,0,0,0,52,78
117134,8,800,70,0,0,0,0,124,194
87573,8,800,973,40,19,2,11,1519,2564
130583,10,701,62,0,0,0,0,61,123
62132,10,701,61,1,0,0,0,93,155
55369,10,807,3,0,0,0,0,2,5
124103,6,514,17,2,1,0,0,21,41
60444,7,484,15,4,2,0,0,28,49
71678,10,807,84,0,0,0,0,124,208
81850,7,641,4,0,0,0,0,7,11
64770,7,641,6,0,0,0,0,20,26
25368,10,807,24,0,0,0,0,93,117
80193,10,807,23,0,1,0,0,55,79
102243,5,545,194,11,9,1,1,324,540
5025,10,807,2,0,0,0,0,7,9
108736,10,807,8,0,0,0,0,10,18
137782,10,807,30,3,2,0,0,71,106
166718,10,807,10,0,0,0,0,13,23
81052,4,174,171,3,2,0,0,258,434
63481,9,630,340,2,0,0,2,509,853
16073,10,743,13,1,1,0,0,20,35
130991,4,519,538,3,2,0,1,863,1407
95443,9,374,132,4,3,0,0,322,461
92997,9,374,27,0,0,0,0,57,84
100863,9,374,22,0,0,0,0,45,67
96177,9,374,11,1,0,0,0,50,62
99144,10,29,67,2,1,0,0,81,151
130939,7,56,50,2,0,0,0,61,113
17054,7,861,158,7,3,0,0,244,412
27803,9,909,261,7,6,0,0,365,639
119480,7,861,6,0,0,0,0,6,12
46823,7,861,13,0,0,0,0,31,44
105485,9,909,2,0,0,0,0,3,5
58878,8,214,25,0,0,0,0,29,54
105514,5,371,37,2,0,0,0,32,71
52960,7,545,63,3,2,0,0,75,143
100905,4,200,32,0,0,0,0,50,82
34624,8,489,1040,20,13,0,7,1623,2703
6194,8,214,82,0,0,0,1,112,195
78191,4,199,11,0,0,0,0,12,23
137781,6,306,13,0,0,0,0,16,29
65714,4,752,270,6,4,0,1,396,677
123764,6,290,28,0,0,0,0,38,66
156117,6,290,91,2,1,0,0,125,219
163441,5,489,4,0,0,0,0,3,7
93464,11,489,305,14,0,0,0,340,659
125041,10,63,69,1,0,0,1,92,163
120415,8,800,56,0,0,0,1,105,162
162042,9,640,644,24,13,3,6,867,1557
100656,9,640,191,9,6,1,1,277,485
130694,8,427,48,0,0,0,0,111,159
101756,5,124,122,1,1,0,0,197,321
50661,7,157,55,0,0,0,0,71,126
48288,7,157,68,1,1,0,1,108,179
52447,7,157,92,0,0,0,0,180,272
139722,4,800,9,0,0,0,0,20,29
142410,7,157,20,1,1,0,0,39,61
58020,5,489,37,0,0,0,0,58,95
153638,8,812,280,4,0,0,3,402,689
110125,7,157,29,0,0,0,0,45,74
108261,8,812,96,0,0,0,1,148,245
119540,6,658,30,1,0,0,0,48,79
131951,9,325,83,1,1,0,0,134,219
82378,6,209,91,4,1,0,0,175,271
19175,8,812,121,1,1,0,3,182,308
166681,5,58,4,0,0,0,0,3,7
41628,6,135,90,1,1,0,0,145,237
85986,5,159,164,7,4,0,0,257,432
35453,8,214,39,0,0,0,0,54,93
147433,5,306,12100,396,156,21,126,22715,35514
156123,6,453,75,0,0,0,0,138,213
100997,5,821,3,0,0,0,0,5,8
96311,4,36,138,3,2,0,0,194,337
31668,8,214,330,2,1,0,1,465,799
96403,9,374,314,5,0,1,2,349,671
150447,9,630,64,0,0,0,0,55,119
63953,8,214,40,0,0,0,0,65,105
141069,9,842,280,0,0,0,0,649,929
82931,11,214,22,0,0,0,0,24,46
16177,9,462,1,0,0,0,0,2,3
164474,11,306,91,8,0,0,0,89,188
159989,9,741,341,0,0,0,2,803,1146
106167,8,214,172,2,0,0,1,263,438
60119,5,225,104,6,2,0,1,166,279
18739,8,812,115,4,5,0,3,181,308
5929,4,800,3,0,0,0,0,10,13
60839,7,648,465,8,3,1,3,784,1264
1077,9,842,110,0,0,0,0,329,439
46238,9,842,434,0,0,0,3,956,1393
67,5,235,49,0,0,0,0,109,158
42618,7,535,36,0,0,0,0,55,91
143756,8,214,13,0,0,0,0,15,28
165329,4,923,40,1,1,0,0,63,105
142809,8,800,460,16,7,1,3,809,1296
166437,9,375,7,0,0,0,0,16,23
167017,4,519,672,1,0,1,2,1523,2199
80621,6,263,147,2,1,0,0,224,374
51125,6,489,55,0,0,0,0,73,128
125676,4,658,35,0,0,0,0,57,92
6972,5,893,3,0,0,0,0,7,10
92385,7,861,48,0,0,0,0,75,123
167714,7,861,22,1,3,0,0,49,75
62266,8,403,337,5,0,0,3,564,909
151943,5,489,244,26,5,1,2,434,712
27974,9,405,2,0,0,0,0,2,4
63700,9,367,5,0,0,0,0,10,15
128422,9,78,280,2,4,0,2,491,779
126280,5,371,2,0,0,0,0,2,4
85958,7,693,81,1,1,0,2,122,207
1178,6,71,44,1,0,0,0,75,120
61981,8,885,1,0,0,0,0,0,1
118573,5,404,182,0,0,0,0,276,458
94395,9,78,1,0,0,0,0,2,3
154459,6,71,281,4,2,0,3,491,781
126365,7,79,2,0,0,0,0,4,6
44055,9,429,808,12,8,3,7,1209,2047
119701,4,427,239,1,0,1,0,288,529
113566,7,79,14,0,0,0,0,18,32
1496,7,79,17,1,1,0,0,32,51
130368,4,427,780,56,30,3,3,1961,2833
164336,6,821,354,8,1,1,0,514,878
39279,7,367,14,0,0,0,0,18,32
33897,7,79,17,0,0,0,0,38,55
153293,6,453,78,1,1,0,0,118,198
77036,7,79,28,1,1,0,0,39,69
142024,6,200,53,0,0,0,0,91,144
138136,6,71,77,0,0,0,0,96,173
16731,6,366,10,0,0,0,0,25,35
68989,7,587,33,0,0,0,0,47,80
163561,4,658,48,0,0,0,0,105,153
50369,5,251,33,0,0,0,2,49,84
74760,6,453,1,0,0,0,0,1,2
49676,7,587,175,1,1,0,0,227,404
117801,9,380,4,0,0,0,0,17,21
24952,9,380,3,0,0,0,0,6,9
3530,9,909,13,0,0,0,0,20,33
143943,10,36,282,6,1,0,1,444,734
27072,4,200,17,0,0,0,0,20,37
74397,6,78,434,7,3,0,6,718,1168
3577,9,575,203,16,2,2,0,344,567
161584,9,575,215,7,2,1,0,473,698
153833,9,302,48,0,0,0,0,108,156
90836,9,4,163,1,1,0,0,201,366
55974,6,821,95,0,0,0,1,137,233
79904,9,483,46,2,0,1,0,101,150
163295,7,77,466,28,12,0,1,698,1205
81913,4,200,81,2,1,0,0,131,215
148039,7,77,33,1,1,0,0,43,78
111492,5,176,14,0,0,0,0,20,34
100107,7,77,72,1,1,0,0,80,154
158203,7,77,47,1,3,0,0,56,107
120333,7,77,89,1,1,0,2,160,253
162237,5,355,206,2,2,0,1,302,513
115082,5,78,39,0,0,0,0,57,96
81662,5,159,418,11,8,0,3,716,1156
32443,5,218,129,8,5,1,0,218,361
115623,5,800,11,0,0,0,0,19,30
88253,9,306,157,10,0,0,3,385,555
109973,4,174,30,0,0,0,0,47,77
128358,7,741,51,0,0,0,0,90,141
124933,8,214,113,0,0,0,1,167,281
33783,7,484,8,0,0,0,0,15,23
34585,9,302,239,9,2,3,9,466,728
113585,7,56,33,2,1,0,0,35,71
134118,9,630,64,3,0,0,0,74,141
164392,7,312,3,0,0,0,0,4,7
8666,4,752,11,0,0,0,0,13,24
152246,11,403,124,4,0,0,0,140,268
6758,5,200,92,3,2,0,0,148,245
81363,8,766,49,1,1,0,0,69,120
88693,5,200,3,0,0,0,0,6,9
35236,9,842,297,0,0,0,2,660,959
133003,9,367,277,7,7,0,0,473,764
24888,9,367,91,3,1,0,2,140,237
26825,9,314,10,0,0,0,0,17,27
31701,9,367,179,5,1,0,1,265,451
126969,10,701,15,0,0,0,0,65,80
68291,9,800,4,0,0,0,0,7,11
71658,4,200,41,0,0,0,0,60,101
3679,4,453,4,0,0,0,0,10,14
30655,8,214,920,12,5,0,2,1333,2272
145472,6,200,182,3,2,0,1,257,445
77787,4,800,23,1,1,0,0,19,44
105067,7,578,9,0,0,0,0,10,19
163727,10,111,65,1,1,0,0,119,186
57113,10,111,3,0,0,0,0,5,8
31795,4,36,255,8,4,0,2,398,667
154233,9,341,41,0,0,0,0,66,107
43912,10,752,36,0,0,0,1,49,86
6978,4,752,19,0,0,0,0,19,38
124153,5,699,80,4,5,0,0,118,207
104686,4,923,25,1,0,0,0,46,72
135555,9,341,74,3,1,1,0,115,194
82602,8,306,1,0,0,0,0,0,1
97371,4,200,10,0,0,0,0,14,24
127664,6,78,333,7,5,0,1,498,844
86046,5,728,225,5,4,0,1,331,566
81414,9,640,46,1,0,0,1,70,118
26714,9,484,21,1,1,0,0,92,115
111519,7,741,195,3,1,0,3,313,515
30007,9,570,159,0,0,0,0,266,425
145764,7,263,15,0,0,0,1,41,57
100133,4,638,121,3,2,2,0,215,343
3809,7,861,63,0,1,0,0,139,203
15358,6,165,568,18,8,2,3,815,1414
39270,9,741,70,0,0,0,0,104,174
19318,8,812,87,8,3,0,1,136,235
118949,8,812,226,5,1,0,4,371,607
171054,8,812,125,2,2,0,2,239,370
126794,7,118,49,2,0,0,0,106,157
96907,8,812,92,3,3,0,0,136,234
165727,9,640,1596,42,21,2,5,2426,4092
135959,4,638,58,0,0,0,0,95,153
3274,6,235,202,11,3,0,2,351,569
126508,4,800,92,1,0,0,0,165,258
46461,4,780,155,2,0,0,0,222,379
156443,8,200,24,0,0,0,0,43,67
23022,10,474,23,1,1,0,0,114,139
165989,5,218,42,1,0,0,1,64,108
127102,8,403,72,0,0,0,1,164,237
132330,9,30,154,3,2,0,1,272,432
27866,9,30,8,0,0,0,0,5,13
117274,6,106,98,7,1,0,2,158,266
8788,9,570,357,24,13,2,0,546,942
46683,7,693,12,0,0,0,0,17,29
169407,4,800,3,0,0,0,0,4,7
81055,4,453,326,8,5,0,1,449,789
147219,8,800,67,1,1,0,0,110,179
41290,10,820,2,0,0,0,0,3,5
140104,4,36,62,1,1,0,0,96,160
40170,10,628,15,0,0,0,0,29,44
89432,7,693,37,1,1,0,1,52,92
165045,8,623,14,0,0,0,0,11,25
18397,7,693,30,0,0,0,0,38,68
144972,5,570,103,6,1,3,0,198,311
141375,10,36,243,0,0,0,2,622,867
34290,9,842,119,4,1,0,3,321,448
74856,8,916,54,0,3,0,0,85,142
5811,9,457,13,0,0,0,0,16,29
158809,4,212,49,0,1,0,0,81,131
160721,10,474,92,3,4,0,1,170,270
67181,6,235,138,1,1,0,0,204,344
243,7,864,38,1,0,0,1,58,98
50557,7,748,77,2,0,0,0,146,225
6549,9,640,463,12,4,1,3,667,1150
129166,4,800,149,0,1,0,1,237,388
70782,6,106,123,2,2,0,1,221,349
49488,8,489,382,10,3,0,2,642,1039
58223,8,489,149,1,0,0,0,283,433
93970,5,78,127,0,1,0,1,228,357
127824,10,256,62,0,0,0,0,82,144
9008,5,479,1050,23,13,0,9,1767,2862
93192,9,306,135,0,0,0,0,255,390
68854,7,521,57,0,0,0,0,78,135
7656,6,269,238,0,0,0,0,351,589
124146,4,800,28,1,0,0,0,37,66
117829,7,263,10,0,0,0,0,18,28
164775,6,785,84,0,0,0,0,125,209
25543,7,535,183,11,1,1,1,405,602
66892,5,225,111,0,0,0,1,205,317
95635,5,225,53,0,0,0,0,93,146
18051,5,200,3,0,0,0,0,2,5
18745,7,556,7,1,0,0,0,10,18
99340,7,263,146,6,3,0,3,238,396
20255,9,367,155,5,3,0,1,134,298
62623,9,367,94,2,0,1,2,158,257
7553,9,367,29,0,0,0,0,50,79
97251,5,570,26,1,0,1,0,34,62
12623,5,773,7,0,0,0,0,9,16
132148,4,596,137,0,0,0,1,227,365
165269,10,917,22,0,0,0,0,32,54
14844,8,545,902,19,5,2,7,1337,2272
2028,8,306,38,0,0,0,0,55,93
72024,4,923,4025,110,41,9,12,7204,11401
121782,7,864,40,0,0,0,0,83,123
61350,9,589,263,14,2,3,2,397,681
104256,4,375,182,5,6,0,1,306,500
114878,8,214,12,0,0,0,0,10,22
31288,6,658,78,4,1,0,0,123,206
33970,9,8,9,0,0,0,0,30,39
132051,9,8,68,1,1,0,1,85,156
150698,7,56,83,1,1,1,0,109,195
26489,4,174,64,0,0,0,0,105,169
9244,11,812,4,0,0,0,0,4,8
58478,6,290,6,0,0,0,0,9,15
141821,7,157,44,0,0,0,0,226,270
119704,9,380,46,0,0,0,0,99,145
72877,10,701,70,0,0,0,1,122,193
60287,10,63,42,0,0,0,0,68,110
44964,10,40,4,0,0,0,0,4,8
34991,10,40,6,0,0,0,0,9,15
121910,10,40,4,0,0,0,0,5,9
57605,6,800,104,2,1,0,1,144,252
152792,4,658,18,0,0,0,0,34,52
16952,4,519,22,0,0,0,0,78,100
134323,7,552,43,0,0,0,0,67,110
98002,9,607,17,0,0,0,0,24,41
70461,6,821,109,2,1,0,0,201,313
123816,6,821,90,0,0,0,0,147,237
36444,9,399,15,0,0,0,0,17,32
115403,10,355,167,3,2,0,0,229,401
41817,6,821,62,0,0,0,0,101,163
146176,6,789,6,0,0,0,0,8,14
12604,10,653,5,0,0,0,0,8,13
104332,5,783,136,5,2,0,0,252,395
169983,7,669,8,0,0,0,0,11,19
37739,7,484,71,0,0,0,0,113,184
94869,8,214,84,0,0,0,0,124,208
29212,8,214,110,0,0,0,0,161,271
133611,5,200,27,1,0,0,0,36,64
104500,10,36,97,0,0,0,0,146,243
136811,10,413,8,0,0,0,0,10,18
60797,7,367,26,0,1,0,0,82,109
159911,9,202,8,0,0,0,0,9,17
112712,8,427,36,0,0,0,1,58,95
4775,9,640,66,3,5,0,0,103,177
24997,6,658,14,0,0,0,0,23,37
16277,8,812,161,4,1,0,5,330,501
141601,5,371,9,2,1,0,0,14,26
156449,9,427,113,0,0,0,4,334,451
159130,5,821,60,0,0,0,0,72,132
13654,8,812,136,2,1,0,3,214,356
80826,7,489,1,0,0,0,0,1,2
112915,5,479,9,0,0,0,0,11,20
11192,7,194,23,0,0,0,0,25,48
24188,7,713,165,1,0,0,0,240,406
121883,9,117,204,10,3,1,3,316,537
54712,10,413,15,0,0,0,0,26,41
159795,10,781,60,0,0,0,1,75,136
89053,8,306,8,0,0,0,0,5,13
154237,4,890,375,10,2,0,0,692,1079
63309,9,575,302,11,7,0,1,483,804
108871,9,575,168,4,1,1,4,254,432
118091,9,301,175,8,4,0,0,310,497
63310,8,693,1586,47,13,3,10,2604,4263
87086,10,722,433,6,5,1,0,688,1133
56844,10,917,8,1,1,0,0,9,19
150366,9,570,37,1,0,0,0,65,103
82746,5,159,17,0,0,0,0,22,39
170862,5,176,197,6,2,2,1,263,471
106613,9,741,83,4,3,0,0,141,231
106811,5,371,97,3,0,0,0,150,250
16950,6,235,140,0,0,0,1,199,340
96985,8,124,35,0,0,0,0,60,95
27481,8,124,80,0,0,0,0,100,180
77832,9,77,75,2,1,0,1,120,199
69982,8,545,31,0,0,0,0,54,85
17605,7,492,31,0,0,0,0,48,79
76921,7,79,263,5,2,1,3,349,623
29670,8,214,715,3,2,0,2,1303,2025
166508,4,200,23,0,0,0,0,36,59
154924,4,200,155,1,0,0,0,196,352
121466,10,550,27,0,0,0,0,69,96
124067,10,550,22,0,0,0,0,31,53
39035,7,216,374,9,5,0,2,625,1015
37119,9,367,36,0,0,0,0,54,90
8275,9,589,254,9,6,0,1,244,514
99349,5,118,46,4,2,0,0,81,133
16178,9,489,508,19,12,0,4,1036,1579
35513,9,575,21,0,0,0,0,22,43
83258,9,575,229,8,4,2,1,266,510
17892,4,200,50,1,1,0,0,74,126
3622,11,30,181,0,0,0,0,206,387
37082,5,200,24,0,0,0,0,36,60
11686,8,124,57,0,0,0,0,102,159
161543,7,535,50,1,1,0,0,45,97
46763,7,157,68,1,1,0,0,128,198
86644,7,611,82,3,1,0,0,122,208
118359,9,341,4,1,1,0,0,23,29
67096,9,158,128,4,0,0,0,278,410
72250,7,211,137,12,3,0,1,235,388
13851,11,545,16,1,0,0,0,19,36
104582,9,800,36,0,0,0,0,48,84
158285,5,78,118,3,2,0,0,173,296
44031,9,800,2,0,0,0,0,0,2
112625,9,657,102,2,1,1,2,157,265
30597,9,800,36,3,1,1,1,79,121
71508,9,538,2,0,0,0,0,2,4
11961,4,800,146,1,1,0,1,273,422
88054,9,538,242,9,4,1,2,386,644
53148,9,842,56,1,2,0,0,75,134
166920,10,104,38,0,0,0,0,23,61
170826,5,124,36,2,2,0,1,55,96
96173,9,607,295,18,2,3,3,469,790
38100,9,489,298,0,0,0,2,421,721
102727,4,658,6,0,0,0,0,11,17
21382,11,812,16,0,0,0,0,20,36
89000,7,484,11,0,0,0,1,9,21
45456,7,118,137,4,2,0,0,271,414
13449,6,290,77,1,1,0,0,118,197
38032,6,306,10,0,0,0,0,5,15
92075,5,489,16,0,0,0,0,20,36
105127,6,181,206,6,2,1,0,356,571
129437,9,575,29,1,1,0,0,55,86
92268,6,200,80,1,0,1,0,111,193
77303,9,842,227,0,0,0,2,387,616
107004,9,842,241,0,0,0,2,434,677
25132,9,575,74,4,0,0,0,137,215
166299,6,821,35,1,1,0,1,48,86
67668,6,601,26,0,0,0,0,31,57
65612,5,225,193,1,1,0,1,308,504
132734,8,489,95,1,1,0,1,159,257
92973,7,118,26,0,0,0,0,50,76
73284,6,404,27,0,0,0,0,39,66
156264,9,589,65,2,0,0,0,88,155
27280,4,800,96,1,0,0,0,172,269
144312,7,118,93,1,0,1,0,151,246
93216,7,80,148,2,1,0,0,182,333
33300,4,36,119,3,2,1,0,212,337
78876,7,80,194,3,2,0,1,237,437
85872,9,492,21,0,0,0,0,29,50
78281,6,537,190,4,3,1,0,246,444
15568,9,469,17,0,0,0,0,18,35
18860,5,375,10,0,0,0,0,11,21
150257,5,118,454,25,10,2,7,733,1231
43267,4,200,57,2,1,0,0,92,152
157348,7,589,80,0,1,0,0,153,234
22138,6,209,4,0,0,0,0,8,12
90136,8,658,19,1,0,0,0,22,42
138108,8,693,26,0,0,0,0,29,55
166919,4,375,15,0,0,0,0,17,32
135107,7,118,16,1,1,0,0,20,38
78601,9,367,42,0,0,0,0,41,83
65680,4,453,22,0,0,0,0,40,62
170086,9,526,4,0,0,0,0,4,8
154973,5,225,91,3,2,0,1,135,232
144420,4,159,72,1,0,0,0,113,186
90887,9,684,3,0,0,0,0,5,8
2647,9,658,14,0,0,0,0,14,28
58585,7,741,245,3,3,0,1,352,604
9410,10,797,127,2,1,0,0,238,368
50923,6,106,59,0,0,0,1,84,144
76154,11,623,5,0,0,0,0,6,11
148376,7,429,12,0,0,0,0,8,20
124309,9,570,206,0,0,0,0,427,633
116839,7,74,9,0,0,0,0,34,43
93301,7,741,185,3,1,0,0,276,465
35982,9,89,9,0,0,0,1,12,22
156183,7,157,8,0,0,0,0,12,20
27023,6,821,23,0,0,0,1,34,58
106619,6,420,106,2,1,1,0,150,260
125704,8,214,985,34,15,0,9,1938,2981
75122,9,693,52,0,0,0,0,116,168
128204,9,489,151,3,3,0,0,251,408
143620,9,306,46,0,0,0,0,59,105
145098,7,484,34,1,1,0,0,63,99
64928,9,216,57,3,3,0,0,78,141
102788,4,800,14,0,0,0,0,29,43
53167,6,570,24,0,0,0,0,54,78
121334,6,570,14,0,0,0,0,23,37
107607,5,885,21,0,0,0,0,20,41
28340,8,800,77,2,2,0,1,139,221
115811,9,570,52,0,0,0,0,112,164
65811,9,489,409,10,6,1,0,590,1016
22206,8,489,426,11,2,2,4,754,1199
35773,8,489,332,7,9,0,1,562,911
80444,9,800,35,2,0,0,0,133,170
121529,6,218,18,1,1,0,0,22,42
164727,6,785,8,0,0,0,0,16,24
77458,6,922,19,1,1,0,1,25,47
68212,6,728,136,3,2,0,0,177,318
132782,8,658,11434,352,103,47,59,18179,30174
150842,5,489,42,0,0,0,0,48,90
65808,6,269,148,3,0,1,0,210,362
108484,6,106,24,1,0,0,0,28,53
94171,8,214,212,0,0,0,0,309,521
4816,9,100,53,4,1,0,0,95,153
109369,6,232,147,5,4,0,0,240,396
108085,7,404,65,0,0,0,0,96,161
159158,4,188,885,30,11,8,2,1542,2478
37767,4,174,89,1,1,0,1,179,271
107334,7,429,58,4,3,0,1,188,254
85635,7,429,371,23,5,3,2,682,1086
123583,10,653,84,0,0,0,1,105,190
131903,4,159,61,0,0,0,0,91,152
87467,7,587,95,6,3,0,0,131,235
60098,10,701,0,0,0,0,0,54,54
86404,9,489,382,15,9,1,3,588,998
125449,7,312,2,0,0,0,0,3,5
149354,10,797,71,0,0,0,1,118,190
137924,10,111,42,3,1,0,1,73,120
79016,7,587,269,6,3,0,0,424,702
11499,4,270,53,0,0,0,0,80,133
107294,4,200,867,21,13,1,7,1305,2214
90603,4,124,261,2,1,0,1,411,676
46358,9,589,19,0,0,0,1,25,45
75988,9,800,134,0,1,0,2,188,325
139509,7,207,50,3,1,0,2,230,286
94853,9,589,140,0,0,0,1,329,470
154928,8,489,2,0,0,0,0,3,5
87337,8,403,134,1,1,0,0,258,394
74298,8,812,117,3,2,0,1,132,255
138799,10,413,3,0,0,0,0,12,15
93610,9,800,6,1,0,0,0,17,24
142000,6,78,84,1,0,0,0,148,233
148006,6,78,152,7,1,0,0,256,416
42472,10,413,2,0,0,0,0,8,10
32177,10,413,2,0,0,0,1,5,8
147061,6,901,246,16,7,2,0,441,712
143167,6,922,51,0,0,0,0,109,160
158310,4,36,115,4,1,0,0,167,287
137363,7,570,109,0,0,0,1,182,292
152930,7,741,44,1,1,0,1,75,122
128844,7,216,223,2,3,0,1,315,544
98581,7,741,10,0,0,0,0,16,26
12988,7,741,112,0,0,0,0,196,308
58472,7,741,24,0,0,0,0,29,53
155925,5,78,20,0,0,0,0,36,56
138314,9,302,41,0,1,0,0,83,125
106968,7,741,37,2,0,0,1,57,97
123519,5,200,55,1,0,1,0,102,159
142232,8,124,114,0,0,0,0,180,294
152851,6,800,66,0,0,0,0,124,190
68094,9,43,4,0,0,0,0,10,14
130204,7,587,27,0,0,0,0,40,67
63514,9,157,9,0,0,0,0,15,24
123761,5,489,70,0,0,0,0,123,193
57505,5,200,38,0,0,0,0,44,82
40127,9,589,325,10,3,0,1,546,885
96285,9,157,14,1,0,0,0,37,52
129635,9,157,87,1,0,0,0,116,204
76092,9,589,235,3,1,1,2,491,733
141418,9,589,48,3,1,0,0,68,120
125625,9,589,5,0,0,0,0,7,12
146705,10,653,115,1,0,0,0,203,319
71898,10,653,67,2,2,1,0,140,212
134560,11,545,87,5,0,0,0,106,198
64566,10,653,174,0,0,0,4,329,507
36096,7,741,72,0,1,0,1,97,171
156348,9,741,111,0,1,0,0,158,270
48045,8,489,4,0,0,0,0,3,7
56390,9,741,92,2,1,0,0,142,237
121656,9,741,27,0,0,0,0,42,69
153711,10,208,0,0,1,0,0,0,1
82213,7,367,70,0,0,0,1,84,155
15769,6,117,206,7,1,0,0,317,531
154270,4,351,286,3,2,1,0,492,784
82690,7,741,34,1,1,0,1,70,107
24173,7,741,24,1,1,0,1,66,93
116346,4,159,119,1,0,0,0,169,289
50449,10,111,114,1,0,0,1,147,263
74454,4,658,182,3,2,0,0,455,642
150426,8,214,46,1,1,0,0,70,118
169077,10,917,75,5,2,1,0,165,248
129770,7,387,418,9,0,0,0,608,1035
6845,11,693,105,2,0,0,0,119,226
112331,5,78,146,5,0,0,0,226,377
123646,8,800,50,1,0,0,0,72,123
34602,8,800,23,0,0,0,0,27,50
57827,10,797,48,0,0,0,0,80,128
68565,8,800,235,4,2,0,2,346,589
107552,4,270,116,3,2,0,0,169,290
125760,7,741,17,0,0,0,0,29,46
19009,6,106,117,5,3,0,1,230,356
148755,6,106,73,0,0,0,1,134,208
25586,8,800,13,0,0,0,0,19,32
150555,6,269,112,1,1,0,0,184,298
116854,10,36,7,0,0,0,0,12,19
11277,8,800,12,0,0,0,0,10,22
127853,8,800,67,1,1,0,0,115,184
64682,9,909,125,3,2,1,1,205,337
67195,4,124,297,9,10,0,1,443,760
139382,10,200,18,0,0,0,1,75,94
5579,7,748,21,0,0,0,0,32,53
52785,6,200,223,2,1,0,1,335,562
168245,8,124,35,0,0,0,0,59,94
134360,10,797,90,0,0,0,0,119,209
18498,8,623,16,0,0,0,0,16,32
131765,10,841,76,1,0,0,0,144,221
11577,8,623,9,0,0,0,0,16,25
880,10,653,27,0,0,0,0,26,53
143493,5,118,8,0,0,0,0,15,23
96852,10,474,87,2,2,0,0,194,285
44938,10,474,16,0,0,0,0,46,62
135131,10,752,150,2,0,0,0,186,338
137746,7,861,25,0,0,0,0,36,61
131878,5,218,58,9,2,1,0,68,138
90342,6,821,27,0,0,0,0,42,69
45805,9,100,246,0,0,0,0,548,794
136317,8,622,165,1,1,0,0,243,410
117468,7,79,126,4,4,0,0,179,313
10235,7,79,50,0,0,0,0,66,116
140240,7,79,12,0,0,0,0,25,37
57224,9,640,182,1,2,0,2,309,496
101678,4,200,205,5,4,0,1,286,501
41578,9,302,11,1,0,0,0,15,27
75849,8,214,1117,34,15,1,7,1824,2998
151618,7,79,103,1,1,0,1,150,256
21482,9,640,87,0,0,0,0,159,246
163062,9,657,460,21,9,3,1,751,1245
95672,9,657,151,4,2,0,0,231,388
136431,4,200,841,15,7,1,2,1140,2006
142810,4,200,221,2,0,0,0,315,538
146931,9,912,99,1,1,0,0,162,263
66732,9,302,16,0,0,0,0,16,32
18676,6,789,99,2,1,0,1,172,275
26015,6,124,55,0,0,0,0,76,131
143476,6,124,6,0,0,0,0,10,16
143038,6,658,122,8,4,0,0,199,333
95553,9,842,41,3,0,0,0,161,205
69259,10,413,2,0,1,0,0,3,6
61088,10,628,125,1,1,0,0,174,301
73934,10,799,60,3,1,0,0,102,166
21542,10,208,37,0,1,0,0,55,93
87749,9,640,997,14,9,2,4,1332,2358
1534,7,232,13,0,0,0,0,26,39
47707,8,214,16,0,0,0,0,15,31
146856,9,741,14,0,0,0,0,25,39
135588,9,741,13,0,0,0,1,19,33
48174,9,741,11,0,0,0,0,21,32
111057,9,489,100,0,0,0,2,166,268
123110,4,800,159,0,0,0,1,232,392
131453,9,462,236,9,6,1,2,367,621
40797,8,693,3,0,0,0,0,4,7
10163,4,188,7,0,0,0,0,5,12
67345,8,800,167,10,8,0,0,264,449
47571,9,630,12,0,0,0,0,14,26
84200,7,228,467,7,5,1,2,662,1144
104645,6,290,0,1,1,0,0,0,2
126068,7,118,25,0,0,0,0,24,49
79715,7,196,105,3,2,0,1,164,275
84669,7,556,89,0,0,0,1,127,217
68351,7,535,260,5,5,0,1,384,655
1763,7,306,1,0,0,0,0,0,1
136791,6,269,45,0,0,0,0,63,108
122492,7,56,27,1,0,0,0,23,51
8442,8,209,39,1,0,0,0,49,89
162648,8,623,38,0,0,0,0,49,87
170886,8,623,76,1,1,0,0,103,181
157844,8,623,66,0,0,0,2,111,179
66573,10,917,75,5,1,0,0,142,223
30569,7,126,96,8,1,0,1,168,274
124866,7,157,180,1,0,1,1,222,405
85414,7,157,34,1,1,0,0,40,76
116657,10,618,41,2,1,0,0,74,118
170210,7,74,11,1,0,0,1,48,61
11810,6,643,221,5,0,0,1,266,493
54816,6,643,23,0,0,0,0,34,57
37547,6,643,78,1,0,0,0,121,200
11444,4,885,28,1,0,0,0,29,58
139167,8,489,155,3,0,0,0,228,386
19271,9,597,122,0,0,0,1,161,284
95245,9,693,170,2,3,0,0,279,454
38967,7,824,63,0,0,0,0,107,170
64204,10,799,11,0,0,0,0,26,37
72483,10,256,55,0,0,0,0,74,129
36,9,203,107,4,0,0,1,186,298
142634,9,65,90,1,0,0,0,162,253
78377,9,640,70,2,0,0,0,130,202
9540,10,917,13,0,1,0,0,36,50
29251,9,65,118,7,4,0,0,173,302
132857,10,799,2,0,0,0,0,7,9
55366,10,81,2,0,0,0,0,5,7
143048,7,80,15,0,0,0,0,15,30
50528,9,65,19,0,0,0,0,28,47
13973,10,81,11,0,0,0,0,13,24
143619,9,65,6,0,0,0,0,7,13
100908,8,812,713,35,14,0,7,1161,1930
151319,9,65,24,0,0,0,0,36,60
160720,10,66,4,0,0,0,0,3,7
82760,9,65,1,0,0,0,0,5,6
106443,9,800,44,4,3,1,0,150,202
131823,9,175,0,0,1,0,0,0,1
156442,8,489,20,0,0,0,0,27,47
125780,5,489,298,8,8,1,1,383,699
46961,7,285,319,4,0,0,3,538,864
119570,7,79,152,9,3,3,0,250,417
144163,9,65,32,1,1,0,0,69,103
45487,9,65,4,0,0,0,0,14,18
120981,7,285,74,0,0,0,0,102,176
40450,10,22,48,0,1,0,0,73,122
102939,7,748,20,2,0,0,0,47,69
88644,8,623,178,4,2,0,1,276,461
72270,8,623,29,0,0,0,0,43,72
25626,7,578,54,2,0,0,0,100,156
91271,7,496,49,0,1,0,0,59,109
74120,6,800,3,1,0,0,0,1,5
38684,9,78,192,2,1,0,2,288,485
81873,10,474,19,0,0,0,0,10,29
32422,9,78,149,6,2,0,0,275,432
107287,11,427,5,0,0,0,0,6,11
2382,7,587,149,7,3,0,2,204,365
39774,9,630,391,16,8,1,1,556,973
150097,6,290,24,3,0,0,0,46,73
163570,6,290,164,14,7,1,1,250,437
110722,6,290,83,1,1,1,0,110,196
154030,5,124,56,0,0,0,0,92,148
95661,6,218,107,2,0,0,0,132,241
38354,6,290,36,0,0,0,0,41,77
100974,6,290,4,0,0,0,0,2,6
19255,6,290,6,0,0,0,0,8,14
84123,6,263,204,5,1,0,0,325,535
61878,5,218,51,2,2,0,1,74,130
132486,4,519,2,0,0,0,0,34,36
152571,8,545,101,1,0,0,2,147,251
113577,8,124,145,3,2,0,0,259,409
118700,11,545,21,0,0,0,0,30,51
9791,11,545,3,0,0,0,0,3,6
95592,7,693,7,0,0,0,0,18,25
81025,7,78,23,0,0,0,0,25,48
87967,8,800,342,0,0,0,0,564,906
55443,9,243,2,0,0,0,0,3,5
106241,6,570,105,3,2,0,1,149,260
18099,7,484,12,0,0,0,0,21,33
135830,9,640,377,13,1,0,2,554,947
28868,6,263,31,0,0,0,0,52,83
7565,6,263,49,0,0,0,0,92,141
135824,7,864,13,0,0,0,0,17,30
160371,6,263,24,1,2,0,0,52,79
129682,7,521,196,3,2,0,2,238,441
90484,11,244,163,2,0,0,0,187,352
88783,5,479,617,19,12,1,4,985,1638
78433,4,200,223,1,0,0,1,387,612
42053,11,124,36,0,0,0,0,97,133
21933,8,214,71,0,0,0,0,88,159
104613,11,693,25,1,0,0,0,29,55
118750,10,63,65,3,2,0,0,89,159
148120,10,63,76,0,0,0,1,155,232
165502,5,200,18,0,0,0,0,21,39
170365,5,306,81,1,1,0,0,93,176
49122,5,655,27,0,0,0,0,35,62
61480,4,200,4,0,0,0,0,20,24
15654,8,693,35,0,0,0,0,40,75
83498,4,885,1,0,0,0,0,1,2
162585,11,800,71,4,0,0,0,66,141
36416,5,306,132,1,1,0,0,206,340
30450,5,885,26,0,0,0,0,20,46
108521,11,693,33,0,0,0,0,38,71
111567,7,263,56,0,0,0,0,105,161
33606,11,677,7,1,0,0,0,8,16
148548,5,783,60,1,1,0,0,100,162
167794,7,535,8,0,0,0,0,8,16
99890,8,484,305,3,1,0,1,448,758
6224,11,693,4,0,0,0,0,3,7
135971,11,30,150,7,0,0,0,155,312
48326,7,535,6,0,0,0,0,6,12
92058,6,78,114,1,0,0,0,191,306
103468,9,874,16,0,0,0,0,25,41
105590,10,550,27,0,0,0,0,51,78
142759,8,124,32,0,0,0,0,52,84
40430,4,174,6,0,0,0,0,7,13
90137,8,812,74,0,0,0,0,132,206
4145,8,812,94,1,1,0,0,165,261
51374,8,812,2,0,0,0,0,2,4
42048,8,812,73,2,1,0,2,102,180
49197,9,640,79,3,1,0,1,127,211
122149,4,752,413,2,2,0,2,592,1011
159061,4,159,2,0,0,0,0,3,5
29542,9,367,88,0,0,0,0,181,269
104103,8,124,84,0,0,0,0,121,205
137620,8,214,722,7,4,0,5,1214,1952
34178,10,743,35,1,0,0,1,65,102
158923,10,743,4,0,0,0,0,18,22
149311,9,640,3,0,0,0,0,2,5
129395,8,124,183,3,4,0,2,282,474
146921,7,353,8,0,0,0,0,10,18
149738,10,903,23,0,0,0,0,35,58
158440,5,106,27,0,1,0,0,54,82
465,5,218,86,2,1,0,1,117,207
123942,9,341,180,5,2,1,1,297,486
45222,4,200,119,3,2,0,2,156,282
122194,4,159,220,0,0,0,1,367,588
39079,10,200,13,0,0,0,0,24,37
49270,10,709,50,3,2,0,0,110,165
154520,9,556,3,0,0,0,0,5,8
101303,4,159,1,0,0,0,0,1,2
6456,7,56,5,0,0,0,0,7,12
70548,9,353,16,0,0,0,0,25,41
90865,7,484,19,0,1,0,0,35,55
163216,7,737,26,2,2,0,1,69,100
94216,9,457,12,0,0,0,0,18,30
94601,7,484,18,1,1,0,0,50,70
137756,7,741,185,2,3,0,1,282,473
39526,6,251,17,0,0,0,0,17,34
166240,9,632,7,0,0,0,0,8,15
72341,9,203,26,0,1,0,0,92,119
100641,9,532,89,1,1,0,0,136,227
73395,9,147,7,0,0,0,0,12,19
96444,9,796,3,0,0,0,0,3,6
20132,6,106,37,1,1,0,0,90,129
63356,9,360,1,0,0,0,0,2,3
20848,4,453,1,0,0,0,0,1,2
17742,9,657,46,4,1,0,1,84,136
38466,6,106,63,3,3,0,1,76,146
144070,6,106,217,8,4,0,1,388,618
49642,8,214,23,0,0,0,0,15,38
149042,10,474,49,0,0,0,0,144,193
160634,7,496,8,0,0,0,0,22,30
88564,11,306,12,2,0,0,0,13,27
165046,9,622,16,0,0,0,0,20,36
117914,8,328,435,16,6,0,3,703,1163
139077,7,78,83,4,2,0,0,129,218
141199,11,545,2,0,0,0,0,0,2
138853,8,403,5075,233,92,19,41,8544,14004
157134,7,74,71,0,0,0,0,98,169
21939,5,306,255,0,0,0,0,420,675
151663,4,375,9,0,0,0,0,11,20
46335,10,29,2,0,0,0,0,2,4
93625,6,785,115,2,1,0,1,167,286
32833,10,474,191,2,2,0,2,322,519
1443,7,641,30,0,1,0,0,41,72
138132,8,30,55,0,0,0,0,67,122
99430,10,917,20,0,0,0,0,36,56
113493,10,917,15,0,0,0,0,25,40
18183,10,917,5,0,0,0,0,40,45
91790,10,917,1,0,1,0,0,1,3
93657,7,285,264,7,1,0,2,388,662
99312,7,551,108,4,0,2,0,169,283
106970,8,484,175,9,5,0,0,302,491
91130,7,575,2,0,0,0,0,3,5
109125,7,285,161,3,3,0,1,189,357
79248,5,489,6,0,0,0,0,9,15
39978,6,785,17,1,1,0,0,51,70
92453,7,551,2,0,0,0,0,2,4
125221,7,748,121,3,1,0,1,207,333
72468,6,209,41,0,0,0,1,69,111
141352,8,484,35,1,1,0,0,56,93
155344,8,800,81,2,0,0,0,148,231
82593,8,800,106,2,2,0,0,173,283
13914,4,453,18,0,0,0,0,67,85
169195,6,885,14,0,0,0,0,20,34
87530,8,623,13,0,0,0,0,10,23
102538,7,207,49,2,1,0,1,218,271
45495,5,306,5,0,0,0,0,7,12
159217,6,124,323,13,8,0,5,514,863
150376,6,103,12,1,1,0,0,19,33
64876,4,581,12,0,0,0,0,15,27
152659,9,456,2,1,1,0,0,3,7
93317,4,375,35,0,0,0,0,53,88
36369,4,200,76,2,2,0,1,104,185
60991,4,159,7,0,0,0,0,10,17
25113,7,489,2,0,0,0,0,3,5
13504,8,214,65,0,0,0,1,108,174
43790,8,214,296,0,0,0,5,468,769
149321,9,367,503,22,14,2,3,1070,1614
21825,8,800,65,0,0,0,0,108,173
26868,5,225,202,6,6,0,0,312,526
70501,9,374,103,3,3,1,1,173,284
134838,5,381,71,3,1,0,2,117,194
38980,5,381,9,0,0,0,0,13,22
111687,8,214,34,1,1,0,0,49,85
122707,10,781,10,0,0,0,0,14,24
48369,9,657,127,0,0,0,0,226,353
156345,5,800,92,6,5,0,1,164,268
88964,4,519,85,0,0,0,1,129,215
32653,9,800,28,0,0,0,0,49,77
62007,7,521,1,0,0,0,0,0,1
126755,7,74,68,0,1,0,0,105,174
168977,4,220,134,2,2,0,0,219,357
130846,7,641,18,0,0,0,0,37,55
5041,4,36,614,25,9,1,5,1059,1713
71823,10,208,9,0,0,0,0,14,23
94972,7,521,1,0,0,0,0,0,1
160403,11,375,4,6,0,0,0,6,16
168065,5,225,103,3,3,0,1,192,302
66796,6,232,138,3,1,0,3,237,382
4214,6,785,9,1,0,0,0,15,25
137633,4,800,26,1,0,0,0,41,68
13406,7,175,38,2,1,0,1,64,106
12103,7,79,34,1,1,0,0,62,98
99699,11,812,8,0,0,0,0,4,12
20505,9,374,7,2,0,0,0,15,24
4134,4,199,26,0,0,0,1,36,63
85248,4,453,112,2,2,0,1,190,307
138592,7,175,21,1,1,0,0,45,68
137176,7,175,10,0,0,0,0,25,35
159756,7,157,15,0,0,0,0,26,41
8129,5,106,123,9,2,1,0,235,370
19867,5,200,57,2,1,0,0,91,151
67178,5,124,13,1,0,0,0,17,31
71690,6,235,2,0,0,0,0,2,4
68569,7,489,10,0,1,0,0,12,23
92770,7,713,56,0,0,0,0,106,162
80698,10,111,45,0,0,0,0,83,128
85747,9,374,47,1,1,0,1,108,158
57480,4,658,44,1,1,0,0,63,109
72339,9,842,674,28,9,4,4,1002,1721
155124,9,302,52,0,0,5,0,78,135
103066,9,570,55,1,1,0,0,83,140
82405,6,375,69,2,1,0,0,115,187
41520,6,885,322,6,2,1,1,444,776
117670,4,159,10,0,0,0,0,15,25
81020,10,722,6,0,0,0,0,3,9
105049,10,831,8,0,0,0,0,16,24
76815,6,585,5,0,0,0,0,5,10
41723,10,111,78,4,2,0,1,119,204
37439,10,111,80,0,0,0,2,137,219
134098,10,111,21,0,0,0,0,64,85
51386,5,885,245,9,6,0,2,375,637
150941,9,427,1,0,0,0,0,1,2
152025,4,124,38,0,0,0,0,50,88
95922,8,174,199,3,2,0,2,249,455
34431,5,667,36,0,0,0,0,53,89
80855,7,496,12,0,0,0,0,16,28
82477,9,95,18,0,0,0,0,31,49
46439,9,95,3,0,0,0,0,5,8
3779,7,77,97,0,0,0,1,151,249
140154,8,623,155,4,3,0,0,238,400
154496,11,489,3,0,0,0,0,3,6
79182,9,640,32,0,0,0,0,30,62
76894,9,374,51,0,0,0,0,100,151
69219,9,597,7,0,0,0,0,11,18
71271,8,214,134,1,1,0,0,214,350
135351,8,174,83,1,1,0,1,147,233
13302,8,214,104,0,0,0,0,131,235
119512,4,800,35,0,0,0,0,32,67
169681,9,367,2,0,0,0,0,2,4
123084,9,306,208,2,1,0,3,501,715
36075,9,306,323,2,1,0,5,683,1014
135911,8,489,243,6,5,0,1,381,636
77489,10,617,22,0,0,0,0,39,61
88703,5,821,35,0,1,0,0,50,86
56190,9,575,29,0,0,0,0,40,69
4250,8,214,411,1,1,0,2,605,1020
24020,4,200,80,0,0,0,0,107,187
119276,9,353,39,0,0,0,0,50,89
78932,4,923,52,2,1,0,0,86,141
168814,9,353,24,0,0,0,0,36,60
70454,9,353,4,0,0,0,0,8,12
125838,9,353,13,0,0,0,0,21,34
91925,9,597,79,2,2,0,0,103,186
60387,9,597,79,2,3,0,0,121,205
134687,6,885,14,0,0,0,1,23,38
133359,5,140,75,1,0,0,0,128,204
8086,4,752,3,0,0,0,0,3,6
117214,9,314,32,0,0,0,0,47,79
136140,8,658,89,0,0,0,0,150,239
128208,9,306,3,0,0,0,0,5,8
48298,9,741,225,0,0,0,2,402,629
92692,8,623,60,0,0,0,0,75,135
73068,9,741,8,0,0,0,0,18,26
46232,9,483,4,0,0,0,0,4,8
126290,8,801,34,0,0,0,0,48,82
143987,9,657,463,15,8,0,3,825,1314
103033,8,801,17,0,0,0,0,26,43
1423,8,800,58,1,1,0,0,81,141
88101,8,545,8,0,0,0,0,11,19
122943,8,812,25,0,0,0,0,56,81
33644,8,812,21,0,0,0,0,46,67
48255,10,355,140,2,2,0,1,217,362
154380,8,812,117,3,2,0,0,238,360
59279,9,570,5,0,0,0,0,6,11
24395,9,570,2,0,0,0,0,3,5
72266,8,489,152,1,0,0,1,252,406
97581,7,822,18,0,0,0,0,23,41
13824,4,375,88,3,1,0,0,124,216
52552,4,375,8,0,0,0,0,14,22
41436,8,306,375,3,0,0,0,534,912
69686,4,800,49,0,0,0,0,81,130
81640,4,375,2,0,0,0,0,2,4
12156,6,643,62,0,1,0,1,92,156
87270,5,218,129,4,2,2,1,181,319
18686,4,174,6,0,1,0,0,8,15
6542,9,306,70,0,0,0,0,276,346
17292,8,800,12,2,0,0,0,7,21
72108,9,589,28,0,0,0,0,49,77
14665,11,30,85,3,0,0,0,85,173
58578,4,923,10,0,0,0,0,16,26
90801,10,898,4,0,0,0,0,7,11
457,10,898,15,0,0,0,0,22,37
66512,10,898,37,1,1,0,0,70,109
93721,8,658,230,4,2,0,1,398,635
151578,6,693,51,1,1,0,0,74,127
8909,11,30,111,0,0,0,0,134,245
49200,10,550,51,2,0,1,0,84,138
95283,11,812,0,0,0,0,0,26,26
157321,10,781,4,0,0,0,0,3,7
107898,4,725,50,0,0,0,0,97,147
111261,5,371,140,5,4,0,0,235,384
148626,5,355,146,4,0,3,2,220,375
146739,8,885,420,0,0,0,0,651,1071
49566,8,623,257,6,3,0,1,382,649
81730,7,149,11,0,0,0,0,14,25
170676,7,713,252,6,6,0,1,435,700
3607,4,270,42,1,0,0,1,49,93
87601,4,658,96,1,1,0,2,170,270
125413,6,235,554,28,7,2,5,986,1582
87185,10,917,0,0,0,0,0,47,47
54507,10,917,0,0,0,0,0,39,39
22961,10,200,80,0,0,0,3,88,171
73071,6,235,154,5,0,0,1,244,404
168308,6,263,47,0,0,0,0,77,124
51814,4,569,23,0,0,0,0,33,56
155723,7,228,60,1,0,0,0,108,169
165670,10,474,37,1,0,0,0,54,92
129257,9,570,97,10,2,0,0,161,270
40663,10,474,4,0,0,0,0,10,14
86705,8,306,5,0,0,0,0,3,8
159653,8,489,86,1,1,0,1,159,248
26430,7,535,79,0,0,0,1,93,173
92065,11,214,24,0,0,0,0,23,47
170324,4,658,65,0,0,0,0,91,156
15022,7,744,14,0,0,0,0,16,30
146867,9,374,14,0,0,0,0,18,32
98140,9,374,15,0,0,0,0,15,30
12184,8,489,711,11,7,0,8,1186,1923
158826,5,78,345,13,6,1,0,525,890
157373,6,124,150,9,3,0,0,238,400
40148,6,124,217,4,4,0,2,338,565
39614,6,296,66,2,1,0,1,114,184
48137,9,538,57,0,0,0,0,74,131
157845,8,489,509,8,3,0,3,949,1472
44171,6,124,270,8,1,0,1,425,705
168649,8,800,133,1,1,0,0,257,392
72691,5,159,37,0,0,0,0,51,88
151075,7,263,11,0,0,0,0,12,23
43258,4,375,7,0,0,0,0,11,18
152586,11,214,54,1,0,0,0,46,101
91823,7,144,12,0,0,0,0,23,35
7657,9,487,109,2,3,0,0,139,253
123330,4,36,574,23,8,0,2,1107,1714
44908,4,375,66,0,0,0,1,93,160
121791,4,351,44,0,1,0,1,103,149
60311,5,124,71,2,0,0,0,118,191
157297,10,917,149,4,2,0,0,249,404
309,6,200,71,0,0,0,0,100,171
160217,6,124,3118,104,44,4,15,5017,8302
118452,10,63,61,0,0,0,0,113,174
16534,10,523,16,0,0,0,0,39,55
44484,6,78,176,2,1,0,1,266,446
119013,7,56,64,1,0,0,0,80,145
109466,4,200,230,5,1,0,1,309,546
6617,8,214,162,0,0,0,0,253,415
96220,8,214,233,2,2,1,1,446,685
144171,4,159,430,6,5,0,4,665,1110
55356,7,909,64,1,1,0,0,72,138
48191,8,545,128,2,0,0,0,173,303
59073,7,80,2,0,0,0,0,0,2
55269,9,100,241,0,0,0,0,426,667
63013,9,301,21,0,0,0,0,27,48
22604,5,78,63,1,0,0,1,89,154
158351,9,117,13,3,1,0,0,41,58
102478,9,630,46,0,0,0,0,59,105
28673,10,474,32,0,0,0,0,70,102
40372,9,117,64,1,1,0,1,113,180
12308,4,159,44,0,0,0,0,67,111
104022,5,200,24,0,0,0,1,34,59
166190,9,487,30,1,0,0,0,59,90
32415,6,124,87,1,1,0,2,136,227
66531,8,484,128,1,0,1,0,191,321
150528,7,489,358,12,5,0,3,440,818
53130,4,36,63,6,1,0,0,98,168
107961,11,306,8,1,0,0,0,4,13
70112,7,669,1,0,0,0,0,1,2
125429,5,225,48,7,1,0,1,73,130
168831,7,295,4,0,0,0,0,1,5
27655,5,225,19,0,0,0,0,27,46
5281,5,821,17,1,1,0,2,30,51
147695,9,469,8,0,0,0,0,10,18
40636,7,741,78,2,1,0,1,129,211
66910,5,800,1,0,0,0,0,0,1
82081,9,266,33,0,0,0,0,47,80
64532,9,630,35,1,1,0,0,45,82
130579,9,630,111,1,0,0,0,149,261
91427,9,95,2,0,0,0,0,0,2
103232,9,43,7,0,0,0,0,6,13
139111,10,617,20,0,0,0,0,30,50
65839,10,289,4,0,0,0,0,6,10
59950,10,701,53,1,0,0,1,105,160
59618,10,81,74,3,1,0,0,119,197
102495,10,799,8,0,0,0,0,13,21
137741,10,799,6,0,0,0,0,15,21
93256,4,174,30,0,0,0,0,65,95
19172,10,799,2,0,0,0,0,7,9
16654,7,552,170,7,2,0,0,230,409
82970,10,355,4,0,0,0,0,6,10
80056,10,355,7,0,0,0,0,10,17
86937,10,66,6,0,0,0,0,12,18
73510,10,66,4,0,0,0,0,28,32
39845,10,66,1,0,0,0,0,8,9
158300,10,66,1,0,0,0,0,10,11
19619,7,741,226,3,1,0,1,360,591
162767,9,589,23,0,0,0,0,100,123
42747,9,589,25,0,0,0,0,87,112
151540,9,589,21,0,0,0,0,90,111
131164,10,66,2,0,0,0,0,4,6
137230,10,355,2,0,0,0,0,3,5
112182,6,453,88,0,0,0,0,134,222
25024,10,355,14,1,1,0,0,30,46
155683,10,841,29,0,0,0,0,37,66
124055,10,716,19,0,0,0,1,40,60
94205,6,821,31,6,2,0,1,64,104
86559,10,355,11,0,0,0,1,19,31
169268,10,355,30,1,1,0,0,38,70
96257,10,799,2,0,0,0,0,18,20
151712,10,799,6,0,0,0,0,19,25
3282,10,799,0,0,0,0,0,5,5
125811,10,66,2,0,0,0,0,4,6
15874,9,630,317,4,4,0,0,484,809
146360,5,118,54,0,0,0,0,78,132
81984,5,296,136,4,2,1,1,222,366
18189,8,214,281,11,1,0,1,472,766
125435,5,479,487,8,3,1,2,696,1197
146686,9,597,8,0,0,0,0,10,18
147125,9,640,101,7,2,0,0,169,279
163620,9,325,590,10,8,0,2,1024,1634
128331,5,118,55,0,1,0,0,79,135
75781,9,325,134,3,2,1,0,234,374
35723,8,812,713,18,7,1,3,1058,1800
12138,9,741,151,0,0,0,1,334,486
54277,9,367,181,4,2,1,2,235,425
117231,8,489,254,7,4,0,0,471,736
92199,8,489,145,0,0,0,0,241,386
76297,8,800,70,0,0,0,1,122,193
61001,8,214,96,0,0,0,0,165,261
7006,9,374,12,0,0,0,0,20,32
26813,5,218,10,0,0,0,0,11,21
20488,11,214,87,0,0,0,0,100,187
107700,6,570,1898,49,29,5,10,2642,4633
103163,5,570,43,2,0,0,0,55,100
86248,5,225,120,1,0,0,2,170,293
143624,4,375,56,0,1,0,1,133,191
27275,9,302,22,0,0,0,0,72,94
6441,9,427,24,0,0,0,0,90,114
115712,9,427,66,0,0,0,0,158,224
138769,9,367,69,0,0,0,1,173,243
81665,9,693,15,0,0,0,0,43,58
23754,9,77,16,0,0,0,0,25,41
100056,9,302,251,6,1,1,1,349,609
162897,5,800,15,0,0,0,0,17,32
26336,9,77,123,3,1,2,4,171,304
158066,5,78,38,0,0,0,0,47,85
85369,7,587,172,2,1,0,1,279,455
26587,7,641,67,0,0,0,0,95,162
145102,6,885,247,7,4,0,3,387,648
51315,10,104,26,2,0,0,0,99,127
55178,8,214,170,9,1,0,0,253,433
8815,7,211,5,0,1,0,0,8,14
157342,9,399,4,0,0,0,0,6,10
147001,9,399,10,0,0,0,0,12,22
90713,9,243,81,0,0,0,0,159,240
125939,6,800,40,1,0,0,0,49,90
158110,6,585,0,0,1,0,0,0,1
122276,10,63,185,2,1,0,1,405,594
167321,7,100,74,0,0,0,0,90,164
82725,4,200,82,0,0,0,0,127,209
5496,4,200,138,4,2,0,1,213,358
11706,10,474,73,2,1,0,0,144,220
132658,10,474,46,0,0,0,0,78,124
15618,9,175,4,0,0,0,0,5,9
56569,6,221,24,0,0,0,0,54,78
30262,6,570,236,5,2,1,6,341,591
49240,9,8,4,0,0,0,0,15,19
76967,10,413,4,0,0,0,0,5,9
48035,10,413,2,0,0,0,0,3,5
35925,9,367,107,2,1,0,0,147,257
153856,9,8,11,0,0,0,0,39,50
24317,4,375,59,0,0,0,1,133,193
118648,10,653,49,0,0,0,0,147,196
62436,10,653,129,0,0,0,0,184,313
30810,6,729,30,0,0,0,0,41,71
148689,6,209,92,4,1,0,0,100,197
64001,6,693,18,1,1,0,0,32,52
30867,6,209,101,1,0,0,0,158,260
164939,8,30,3,0,0,0,0,4,7
96291,9,306,53,0,0,0,0,111,164
134940,10,111,7,1,0,0,0,12,20
106039,10,653,97,1,1,0,1,142,242
91576,10,653,124,6,1,0,0,228,359
10959,10,701,355,1,0,0,2,548,906
127076,9,874,11,0,1,0,0,14,26
43240,9,100,120,0,0,0,0,261,381
10402,10,917,0,2,0,0,0,4,6
170504,11,658,115,8,0,0,0,134,257
120652,10,917,37,0,0,0,0,32,69
91168,4,923,84,0,0,0,0,127,211
59725,8,545,10,0,0,0,0,17,27
25190,6,235,140,1,0,0,2,308,451
76203,9,315,165,4,4,0,1,302,476
112668,6,537,71,2,2,0,0,104,179
88227,10,413,0,0,1,0,0,0,1
166176,8,214,323,1,1,0,0,554,879
54248,9,325,5,0,0,0,0,5,10
62936,7,693,27,1,1,0,0,51,80
85880,9,4,79,0,0,0,0,109,188
144784,6,789,73,0,0,0,1,105,179
137877,6,232,213,1,2,0,1,363,580
146684,9,597,35,0,0,0,0,74,109
1250,9,4,38,0,0,0,0,36,74
48509,8,403,78,4,1,0,0,112,195
160973,9,597,26,0,0,0,1,41,68
65261,5,306,54,0,0,0,0,89,143
131485,9,46,64,1,0,0,0,113,178
46974,9,46,2,0,0,0,0,6,8
35929,9,46,4,0,0,0,0,8,12
145120,9,46,6,0,0,0,0,11,17
40972,9,46,4,0,0,0,0,3,7
95435,6,235,230,17,12,1,1,394,655
75360,8,623,232,2,0,0,0,428,662
66422,9,301,83,2,2,1,2,164,254
30613,4,36,34,0,0,0,0,46,80
128840,7,295,8,0,0,0,0,7,15
110383,9,157,7,0,0,0,0,6,13
146183,10,549,153,1,0,0,1,253,408
162056,5,200,420,9,7,1,2,525,964
66462,8,306,112,1,1,0,0,188,302
35212,5,699,83,1,1,0,1,125,211
148781,4,658,6,1,0,0,0,8,15
93450,7,74,52,2,2,0,1,111,168
169953,7,521,102,3,1,0,0,187,293
2262,9,374,3,0,0,0,0,1,4
50693,9,374,3,0,0,0,0,5,8
107862,5,408,106,2,1,0,0,144,253
11787,7,196,7,0,0,0,0,23,30
1852,6,453,10,0,0,0,0,18,28
745,7,74,13,0,0,0,1,59,73
170430,9,65,291,5,2,0,0,500,798
131024,9,469,52,3,0,0,0,60,115
111019,9,469,20,0,0,0,0,25,45
164390,7,896,41,5,2,0,0,71,119
60581,4,200,98,3,3,0,0,163,267
54866,6,556,139,4,3,0,0,202,348
49777,5,58,208,4,2,0,0,312,526
79511,9,158,17,0,0,0,0,37,54
86440,9,873,2,0,0,0,0,3,5
161927,9,151,7,0,0,0,0,10,17
83694,5,570,66,1,1,0,0,109,177
129631,9,65,3,0,0,0,0,3,6
102862,9,65,44,0,0,0,0,37,81
8334,5,885,79,2,1,0,1,143,226
109457,9,65,2,0,0,0,0,17,19
153153,9,65,7,0,0,0,0,6,13
13301,5,408,26,1,1,0,0,58,86
125082,9,65,15,0,0,0,0,11,26
48858,5,408,23,0,0,0,0,49,72
147985,5,124,126,3,0,0,0,208,337
150910,9,538,332,0,0,0,1,587,920
53560,9,538,119,0,0,0,0,189,308
25084,7,748,48,1,1,0,0,116,166
138442,9,640,329,10,6,1,3,558,907
50061,9,640,394,8,7,1,8,548,966
104796,9,630,87,2,2,0,1,159,251
123456,10,111,51,1,0,1,0,84,137
33315,10,917,111,3,2,0,1,201,318
57386,8,403,1522,51,19,0,7,2665,4264
88553,10,917,207,2,4,0,1,355,569
82007,6,263,94,1,1,0,0,168,264
86602,10,898,7,0,0,0,0,15,22
48878,9,800,49,2,0,0,0,61,112
20433,10,63,14,0,0,0,0,15,29
168199,8,214,9,3,0,0,0,0,12
70221,9,570,10,0,0,0,0,13,23
64588,7,563,17,1,1,0,0,71,90
170865,9,570,9,0,0,0,0,18,27
167375,9,570,11,0,0,0,0,21,32
37108,5,251,9,0,0,0,0,9,18
103601,5,404,103,0,0,0,1,177,281
89062,4,890,51,0,0,0,0,81,132
31714,4,200,98,1,1,0,0,135,235
149733,7,484,22,0,0,0,0,31,53
118490,7,484,13,0,0,0,0,30,43
3550,7,484,3,0,0,0,0,4,7
161845,10,617,52,0,0,0,2,71,125
111925,7,484,3,0,0,0,0,8,11
75109,9,630,410,0,0,0,2,519,931
168400,10,917,14,0,0,0,0,28,42
24142,10,111,14,0,0,0,0,27,41
82632,10,322,16,0,0,0,0,29,45
7540,9,632,14,0,0,0,0,31,45
12842,7,484,4,0,0,0,0,8,12
92814,6,922,36,1,0,0,0,57,94
36946,5,159,34,0,0,0,0,50,84
47871,9,315,6,0,0,0,0,3,9
118591,7,508,48,1,2,0,1,123,175
140963,7,157,8,0,0,0,0,12,20
142170,10,322,8,0,0,0,0,10,18
129081,10,256,6,0,0,0,0,8,14
158981,7,157,31,2,0,0,1,68,102
52732,10,322,4,0,0,0,0,6,10
81485,9,95,5,0,0,0,0,12,17
38449,9,912,77,3,1,0,0,119,200
120927,8,214,0,1,0,0,0,0,1
40705,4,159,23,0,0,0,0,35,58
79396,4,159,5,0,0,0,0,8,13
86944,10,200,8,0,0,0,0,11,19
18729,7,484,6,0,0,0,0,10,16
155455,7,484,20,0,0,0,0,26,46
12738,7,484,41,3,0,0,0,72,116
133628,7,484,29,0,0,0,0,42,71
104005,7,484,9,0,0,0,0,23,32
10825,9,302,99,2,0,0,1,164,266
66970,7,484,2,0,0,0,0,12,14
8158,7,484,0,0,0,0,0,5,5
100158,7,484,0,0,0,0,0,5,5
9808,7,484,0,0,0,0,0,5,5
132418,7,484,4,0,0,0,0,8,12
78257,7,263,115,2,3,0,1,170,291
111774,10,841,83,1,1,0,0,131,216
129280,5,225,18,1,0,0,0,23,42
68062,9,489,267,2,2,0,2,447,720
91356,11,214,4,0,0,0,0,6,10
94609,7,429,135,8,6,1,3,571,724
120121,5,489,162,5,4,0,2,311,484
84667,9,86,55,6,2,0,0,91,154
162256,4,199,2,0,0,0,0,5,7
87858,8,83,555,9,2,0,2,952,1520
139262,4,174,8,0,0,0,0,10,18
15741,7,56,4,0,0,0,0,10,14
113119,10,917,6,0,0,0,0,14,20
82769,9,489,103,1,0,0,0,90,194
31813,10,820,15,0,0,0,1,20,36
97047,10,413,16,0,0,0,0,23,39
168537,7,285,229,2,2,0,3,357,593
168825,7,157,13,0,0,0,0,25,38
7441,5,821,563,31,9,1,4,925,1533
112290,6,59,669,24,10,3,5,1156,1867
128814,11,214,8,0,0,0,0,32,40
28662,8,214,29,0,0,0,0,42,71
168114,7,157,107,0,0,0,0,148,255
145173,6,885,55,1,0,0,0,86,142
114576,9,630,135,9,1,5,0,159,309
156306,9,800,729,23,8,0,3,773,1536
76638,6,729,38,0,0,0,0,78,116
10560,6,235,295,8,6,0,6,472,787
62406,4,752,71,1,0,0,0,113,185
61336,4,752,68,0,0,0,0,81,149
121414,9,374,18,2,0,1,0,32,53
146274,8,489,96,0,0,0,1,132,229
42568,8,489,236,0,0,0,1,313,550
118442,9,367,449,14,4,1,0,592,1060
139697,7,175,158,2,1,1,0,237,399
86647,7,496,26,2,0,0,0,65,93
77261,5,238,28,1,0,0,0,42,71
55053,9,842,626,25,16,2,7,987,1663
48951,10,790,46,0,0,0,0,115,161
8330,10,790,67,4,1,0,0,139,211
25985,10,790,16,0,0,0,0,70,86
170119,10,790,37,0,0,0,0,81,118
157079,10,790,24,0,1,0,0,55,80
5464,10,790,12,0,0,0,0,38,50
114811,10,790,11,0,1,0,0,34,46
154740,10,217,117,0,0,0,0,145,262
117620,5,655,27,0,0,0,0,44,71
72917,7,118,3,2,0,0,0,4,9
117960,7,118,5,0,0,0,0,8,13
18781,9,658,222,10,4,2,2,415,655
58830,9,658,52,3,4,0,0,106,165
30220,7,824,21,1,0,0,0,22,44
57628,6,200,211,0,0,0,0,313,524
80694,8,489,602,17,8,0,6,923,1556
51068,9,658,56,1,0,1,0,146,204
64437,4,174,36,0,0,0,0,49,85
75330,4,800,24,0,0,0,0,43,67
127403,9,658,63,3,4,0,0,86,156
34597,9,658,29,1,1,0,0,56,87
41310,9,658,133,3,0,0,0,216,352
9692,9,658,98,0,0,0,0,156,254
121241,11,677,59,1,0,0,0,42,102
141126,4,890,281,7,7,0,2,407,704
94493,9,658,52,0,0,0,0,73,125
21046,9,658,97,0,0,0,0,130,227
76487,11,214,20,0,0,0,0,17,37
112511,7,658,159,3,0,1,2,268,433
70684,7,56,8,0,0,0,0,11,19
33993,4,174,50,1,1,0,0,72,124
112454,10,653,68,1,1,0,0,146,216
106911,4,453,1,0,0,0,0,0,1
111603,7,492,18,0,0,0,0,44,62
147863,7,521,30,0,0,0,0,36,66
29534,7,496,16,0,0,0,0,32,48
88751,7,861,33,0,0,0,0,90,123
112718,10,217,19,1,0,0,0,33,53
37523,9,657,489,17,11,3,3,828,1351
35511,10,256,4,0,1,0,0,10,15
28409,10,807,5,0,0,0,0,5,10
87610,10,807,7,0,0,0,0,8,15
60783,10,807,8,0,0,0,0,9,17
67705,10,807,15,0,0,0,0,44,59
87847,9,341,8,0,0,0,0,8,16
33686,10,653,27,0,0,0,0,13,40
139902,6,232,48,0,0,0,0,77,125
43111,5,159,85,1,1,0,0,137,224
66822,11,306,100,4,0,0,1,138,243
144041,11,306,19,1,0,0,0,21,41
100731,5,159,42,1,1,0,0,60,104
142323,9,589,111,13,6,3,0,201,334
135866,5,225,4,0,0,0,0,7,11
115409,9,589,111,0,0,0,1,249,361
113031,9,693,5,0,1,0,0,12,18
25669,10,29,44,0,0,0,0,70,114
94196,10,781,9,0,0,0,0,9,18
29446,10,781,43,0,0,0,0,77,120
99811,10,40,26,0,0,0,0,27,53
143699,6,235,82,1,2,0,1,149,235
73711,7,741,55,1,1,0,0,104,161
24171,4,658,65,0,0,0,0,94,159
158464,6,658,29,1,1,0,0,47,78
115282,11,214,8,0,0,0,0,6,14
166539,4,375,10,0,0,0,0,17,27
9559,9,630,39,0,0,0,1,56,96
62634,9,8,31,1,1,0,1,63,97
28364,7,861,6,0,0,0,0,32,38
156990,8,623,86,0,0,0,1,145,232
150203,8,623,199,3,1,0,4,365,572
71127,7,587,283,8,3,0,1,411,706
159438,4,800,16,0,0,0,0,27,43
63167,9,658,20,0,0,0,0,38,58
81535,9,658,2,0,0,0,0,6,8
16422,9,100,123,5,6,0,2,196,332
147438,7,861,56,1,1,0,0,88,146
55089,10,549,10,0,0,0,0,19,29
163222,7,741,11,0,0,0,0,17,28
99979,8,484,65,1,0,1,0,92,159
34216,10,799,16,0,0,0,0,28,44
67382,10,799,0,0,0,0,0,5,5
85599,10,722,2,0,0,0,0,3,5
141226,5,306,1155,46,27,5,6,1811,3050
104084,5,306,853,20,7,2,4,1257,2143
110229,5,489,110,0,0,0,0,162,272
51616,8,214,363,4,2,0,2,578,949
98103,8,214,492,4,2,0,3,769,1270
154655,6,601,81,1,0,1,2,106,191
138555,6,263,42,0,0,0,1,64,107
21604,5,570,115,3,0,0,0,172,290
151240,7,77,15,0,0,0,0,19,34
155272,7,77,69,1,1,0,1,91,163
51578,7,77,48,1,0,0,0,60,109
130532,6,159,104,0,0,0,0,174,278
159031,4,885,1,0,0,0,0,0,1
102736,5,200,4,0,0,0,0,4,8
5338,10,917,24,1,2,0,1,35,63
77645,7,748,9,0,0,0,0,23,32
2467,4,174,106,0,0,0,0,157,263
124882,5,306,51,0,0,0,0,69,120
63058,10,917,0,0,0,0,0,19,19
154803,6,570,145,6,1,0,1,221,374
151706,7,157,65,11,1,0,1,142,220
69733,10,111,12,0,0,0,0,12,24
20349,4,159,56,0,0,0,0,56,112
112694,10,917,4,0,0,0,0,9,13
102022,10,917,4,0,0,0,0,11,15
142535,10,917,10,0,0,0,0,9,19
61215,10,917,0,0,0,0,1,130,131
58492,10,917,0,0,0,0,0,12,12
164641,9,117,35,0,0,0,0,65,100
108007,9,117,13,0,0,0,0,14,27
77753,8,214,1,0,0,0,0,2,3
161226,4,375,2,0,0,0,0,3,5
150080,9,117,55,1,0,0,0,76,132
78164,5,232,16,0,0,0,0,26,42
34100,4,800,33,0,0,0,0,57,90
17481,6,209,28,4,2,0,0,34,68
138181,6,901,128,4,3,0,1,202,338
84626,9,483,1,0,0,0,0,1,2
51008,9,885,6,0,0,0,0,10,16
41762,9,885,8,0,0,0,0,10,18
125225,9,175,61,1,1,0,1,117,181
114606,9,86,19,1,1,0,0,59,80
108507,7,207,31,0,0,0,0,150,181
148594,5,263,139,3,2,0,0,210,354
91539,5,124,31,0,0,0,0,47,78
40984,9,842,432,13,8,0,3,670,1126
33569,4,200,224,2,0,0,0,295,521
75362,6,570,345,10,8,2,1,617,983
120870,10,200,44,0,0,0,0,90,134
136671,8,622,97,3,2,0,1,186,289
82102,7,226,4,0,0,0,0,5,9
168266,10,474,12,0,0,0,0,33,45
70150,5,106,14,0,0,0,0,14,28
82283,7,484,22,0,0,0,0,36,58
127816,10,716,1067,15,10,0,11,2416,3519
52318,5,225,90,1,1,0,1,124,217
29174,11,812,18,0,0,0,0,4,22
110820,10,413,4,0,0,0,0,3,7
135839,10,111,12,0,0,0,0,17,29
96473,6,78,759,21,9,0,1,1318,2108
1283,10,40,31,0,0,0,0,42,73
86728,4,885,2,0,0,0,0,5,7
27583,10,653,172,0,0,0,2,292,466
33340,10,653,5,0,0,0,0,10,15
162893,4,675,2,0,0,0,0,5,7
45722,9,380,96,1,0,0,0,144,241
128518,9,380,75,1,0,0,0,137,213
132219,9,380,47,1,3,0,1,173,225
134521,10,807,5,0,0,0,0,8,13
84033,5,200,12,0,0,0,0,16,28
80911,5,371,131,4,3,0,0,172,310
120089,7,587,108,0,0,0,0,172,280
9649,9,380,36,1,0,0,0,71,108
115463,7,302,3,0,0,0,0,4,7
115390,7,306,4,0,0,0,0,9,13
126981,9,8,68,1,1,0,1,98,169
107323,9,452,9,0,0,0,0,12,21
125779,9,452,8,0,0,0,0,15,23
12328,9,8,4,0,0,0,0,19,23
9886,9,8,5,0,0,0,0,18,23
151376,8,622,591,6,4,0,1,988,1590
86721,7,648,22,4,0,0,0,25,51
138368,11,214,23,1,0,0,0,27,51
61321,7,484,147,7,3,0,0,220,377
87908,9,117,33,1,0,0,0,40,74
57894,7,484,8,0,0,0,0,18,26
79404,8,622,194,7,2,0,2,387,592
123509,8,124,1,0,0,0,0,0,1
58101,9,306,92,0,0,0,0,140,232
17996,7,211,28,0,0,0,0,23,51
19576,8,515,218,0,0,0,0,314,532
129536,10,111,77,2,3,0,0,122,204
110442,8,489,21,0,0,0,0,26,47
47690,7,306,5,0,0,0,0,6,11
77632,9,367,310,13,11,1,4,600,939
91065,6,200,16,0,0,0,0,15,31
21271,10,781,2,0,0,0,0,11,13
138902,9,374,2,0,0,0,0,3,5
11583,9,30,15,0,0,0,0,31,46
113374,7,484,38,0,0,0,0,59,97
67519,9,30,0,0,0,0,0,3,3
59034,7,484,24,0,0,0,0,28,52
164776,10,111,20,1,0,0,0,47,68
83940,10,111,3,0,0,0,0,8,11
123301,9,510,46,3,1,0,0,71,121
149553,10,413,10,0,0,0,0,13,23
99217,9,658,6,0,0,0,0,8,14
9854,9,658,23,1,1,0,0,69,94
140863,10,413,9,0,0,0,0,13,22
127643,9,510,13,0,0,0,0,15,28
83082,4,174,15,0,0,0,0,18,33
138478,10,413,6,0,0,0,0,7,13
45127,4,375,92,0,0,0,0,125,217
109756,9,575,85,3,1,0,0,138,227
14450,9,819,211,10,5,1,0,353,580
58606,8,623,199,3,0,0,1,291,494
135422,9,483,2,0,0,0,0,4,6
161099,5,773,19,0,0,0,0,31,50
50433,9,570,93,0,0,0,1,137,231
137492,9,800,12,1,1,0,1,21,36
130377,4,885,12,0,0,0,0,15,27
45392,8,489,482,0,0,0,0,751,1233
80655,9,487,29,0,0,0,0,37,66
145872,9,374,10,0,0,0,0,12,22
46718,4,453,1,0,0,0,0,1,2
153456,10,793,21,0,0,0,0,26,47
121566,9,216,41,0,0,0,0,67,108
88614,9,909,10,0,0,0,0,10,20
4565,7,216,104,2,1,0,0,171,278
75167,5,893,51,0,0,0,1,109,161
40687,4,885,208,0,0,0,0,367,575
143332,7,387,41,1,1,0,1,66,110
141077,9,380,9,1,1,0,0,9,20
159564,9,545,10,0,0,0,0,16,26
61622,6,235,195,2,2,0,1,280,480
150448,5,263,73,0,0,0,0,104,177
73972,4,453,53,0,0,0,0,63,116
103084,7,535,355,19,5,1,2,692,1074
59828,6,514,28,0,0,0,1,36,65
40290,6,821,69,1,1,0,2,93,166
151190,6,181,52,0,0,0,0,84,136
156850,6,181,64,4,1,0,0,119,188
49206,5,235,103,2,2,0,0,178,285
107647,4,375,7,1,0,0,0,14,22
125992,9,462,75,1,1,0,0,113,190
38543,7,489,2,0,0,0,0,6,8
25042,10,289,4,0,0,0,0,5,9
52091,10,549,2,0,0,0,0,2,4
31127,9,367,61,3,2,0,0,100,166
11407,7,312,6,0,0,0,0,10,16
22494,9,367,97,6,3,0,1,139,246
19222,4,890,63,2,0,0,0,107,172
135135,10,200,17,0,0,0,0,64,81
81580,8,800,27,0,0,0,1,37,65
62049,10,628,16,0,0,0,0,21,37
169136,6,103,19,0,0,0,0,31,50
12031,10,716,31,1,1,0,0,60,93
13012,7,78,235,17,7,1,2,403,665
685,9,353,309,2,1,1,5,383,701
25522,9,910,8,0,0,0,0,21,29
122375,9,910,34,0,0,0,0,36,70
7301,9,556,19,0,0,0,0,32,51
36971,5,655,113,2,1,0,0,183,299
74773,9,589,225,6,3,1,2,340,577
51732,8,623,4,0,0,0,0,0,4
50854,7,693,17,0,0,0,1,27,45
105757,4,923,30,1,0,0,0,67,98
39974,9,306,187,4,2,0,1,257,451
91896,10,701,38,0,0,0,0,96,134
164314,5,821,369,6,4,1,2,603,985
159786,5,885,36,2,0,0,1,57,96
129296,8,812,32,0,0,0,0,50,82
15630,11,214,5,1,0,0,0,5,11
147516,7,312,6,0,0,0,0,9,15
91087,4,923,260,15,6,1,2,631,915
16278,10,797,23,0,0,0,0,38,61
18467,5,693,109,1,1,0,0,159,270
86720,5,263,9,0,0,0,0,13,22
167343,4,159,336,6,5,0,4,583,934
85096,5,693,33,0,0,0,0,44,77
144033,10,322,5,0,0,0,0,3,8
105849,9,575,49,1,0,0,1,78,129
37936,9,78,208,2,2,0,0,309,521
150190,4,159,118,3,1,0,0,189,311
118723,9,800,2,0,0,0,0,5,7
161120,9,367,297,35,17,3,1,397,750
147432,5,181,161,4,5,0,2,248,420
135226,9,658,4,0,0,0,0,10,14
107618,9,4,6,0,0,0,0,8,14
76063,9,367,8,0,0,0,0,15,23
109878,9,100,120,0,0,0,0,317,437
166019,5,489,335,13,5,0,2,516,871
33517,8,214,12,0,0,0,0,18,30
104359,9,427,52,0,0,0,1,130,183
166857,8,214,85,0,0,0,0,110,195
156743,11,623,22,1,0,0,0,24,47
151915,8,623,45,1,0,0,0,59,105
73438,5,140,35,0,0,0,0,68,103
131579,4,658,25,0,1,0,0,19,45
74011,9,489,154,0,0,0,1,216,371
125033,4,658,20,0,0,0,0,29,49
158303,4,658,40,0,0,0,0,76,116
28872,4,658,39,0,0,0,0,51,90
17792,9,302,125,5,3,0,2,219,354
116792,7,535,447,9,5,3,1,757,1222
160758,8,623,65,1,0,0,0,75,141
66190,4,658,22,0,0,0,0,38,60
95000,5,106,12,0,0,0,0,9,21
50348,8,214,28,0,0,0,0,21,49
80800,5,821,43,0,0,0,0,43,86
131186,11,812,29,0,0,0,0,32,61
84509,8,766,281,5,5,0,1,382,674
129076,6,366,220,3,0,0,1,339,563
100182,9,367,21,0,0,0,0,37,58
72467,9,630,77,0,0,0,0,120,197
15782,4,427,156,2,2,0,0,310,470
66312,8,214,3,0,0,0,0,2,5
147248,8,800,2,0,0,0,0,6,8
9574,4,800,32,0,0,0,0,44,76
194,9,302,16,0,0,0,0,27,43
125230,9,302,7,0,0,0,0,8,15
170137,9,842,1310,47,23,3,4,1880,3267
62693,10,917,19,0,0,0,0,18,37
87,7,79,41,4,0,1,0,75,121
73217,5,489,63,0,0,0,0,94,157
157927,7,79,26,0,0,0,0,54,80
132992,7,79,45,1,1,0,0,71,118
35424,10,208,20,0,1,0,0,18,39
74114,10,208,60,1,0,0,2,98,161
60089,5,479,41,0,0,0,0,60,101
165154,10,289,3,0,0,0,0,4,7
13261,10,289,2,0,0,0,0,3,5
89494,4,800,129,3,1,0,0,212,345
97952,4,658,60,0,0,0,1,92,153
41007,10,289,2,0,0,0,0,4,6
150800,7,861,52,1,1,0,1,69,124
126192,7,535,132,4,1,0,1,259,397
39882,5,225,40,1,0,0,0,70,111
72938,6,885,51,0,0,0,0,86,137
30701,8,489,45,0,0,0,0,63,108
167560,8,489,191,2,0,0,4,280,477
105645,7,844,31,1,1,0,0,37,70
12177,7,80,38,1,1,0,0,57,97
135145,10,781,4,0,0,0,0,8,12
143218,4,300,241,0,0,0,2,357,600
170160,10,781,2,0,0,0,0,4,6
146158,7,861,91,0,0,0,0,132,223
118763,4,200,113,3,1,0,1,175,293
105284,9,535,10,1,1,0,0,13,25
4610,11,306,19,2,0,0,0,19,40
99715,9,243,28,0,0,0,0,34,62
33461,9,100,263,0,0,0,2,505,770
28160,7,207,42,3,0,0,1,223,269
8407,9,100,159,0,0,0,1,400,560
124030,7,207,4,0,0,0,0,29,33
167689,9,243,169,1,0,3,0,215,388
74128,6,232,49,1,0,0,0,60,110
152297,5,893,86,2,0,0,0,138,226
71696,6,556,2,0,0,0,0,2,4
49718,9,145,63,1,1,0,0,83,148
24536,6,885,39,0,0,0,0,54,93
106965,8,885,147,5,1,0,1,287,441
47045,8,214,96,0,0,0,0,147,243
77455,7,391,195,1,1,0,3,253,453
19108,7,391,48,2,2,0,0,85,137
148797,8,545,6,0,0,0,0,19,25
16520,5,235,188,9,5,0,0,303,505
85210,9,800,30,3,1,0,0,62,96
50913,7,521,54,3,1,0,0,84,142
2534,7,391,26,0,0,0,0,45,71
31044,7,521,70,1,6,0,0,114,191
88540,6,124,128,0,0,0,1,194,323
134489,8,30,51,1,0,0,0,59,111
18878,4,658,20,0,0,0,0,26,46
52568,7,391,147,3,0,1,0,213,364
16232,7,521,7,0,0,0,0,11,18
91265,7,521,17,0,0,0,0,25,42
118159,9,100,43,0,0,0,0,100,143
155759,9,100,57,1,0,1,0,65,124
166841,4,36,745,34,17,1,6,1182,1985
163454,7,77,196,4,1,0,0,282,483
59984,6,232,22,0,0,0,0,34,56
54745,9,640,79,5,1,0,0,140,225
55106,7,489,66,1,1,0,0,93,161
66326,4,800,580,16,16,0,7,964,1583
66494,8,623,104,0,0,0,0,141,245
148010,8,214,98,0,0,0,0,114,212
117010,9,302,72,4,3,0,1,128,208
58277,6,51,129,0,0,0,0,188,317
44879,10,898,10,0,0,0,0,21,31
40331,9,302,77,1,1,0,0,95,174
8670,6,51,53,1,0,0,1,89,144
56864,8,124,36,0,0,0,0,52,88
154336,7,207,194,2,1,0,0,381,578
50244,5,232,44,0,0,0,0,67,111
64081,9,100,16,0,0,0,0,16,32
69213,9,100,4,0,1,0,0,8,13
84551,6,103,18,0,0,0,0,21,39
17149,5,225,63,0,0,0,1,103,167
105265,10,898,3,0,0,0,0,4,7
137128,9,630,216,7,3,1,1,302,530
142020,5,408,4,0,0,0,0,4,8
140486,9,306,74,0,0,0,0,177,251
144660,9,306,85,0,0,0,3,191,279
76237,9,306,1,0,0,0,0,0,1
69443,8,800,118,4,3,0,0,173,298
79972,4,581,10,0,0,0,0,15,25
102545,8,403,51,0,0,0,0,72,123
69637,8,489,6,0,0,0,0,4,10
38817,8,489,2,0,0,0,0,2,4
73886,9,640,2,0,0,0,0,2,4
15384,8,623,16,0,0,0,0,19,35
35155,7,254,15,0,0,0,0,17,32
131220,9,532,53,1,1,0,1,96,152
26897,4,159,125,0,0,0,1,208,334
32092,9,873,22,0,0,0,0,23,45
74166,7,254,36,1,1,0,0,51,89
99643,7,892,1,0,0,0,0,2,3
107451,5,124,102,0,0,0,1,127,230
144804,6,71,92,4,2,0,2,131,231
168350,7,892,1,0,0,0,0,2,3
90198,9,842,518,14,8,0,7,735,1282
21984,4,453,12,0,0,0,0,23,35
35907,4,115,45,0,0,0,1,59,105
101460,9,532,58,1,1,0,1,125,186
158417,6,693,416,15,3,2,4,784,1224
17378,8,623,109,0,0,0,0,163,272
64640,7,587,25,0,0,0,0,35,60
15770,9,873,10,0,0,0,0,7,17
19946,4,375,1,0,0,0,0,0,1
19063,6,693,34,1,0,0,0,46,81
62722,9,157,179,0,0,0,1,504,684
11187,5,225,66,1,0,0,0,142,209
40827,10,781,22,0,0,0,0,49,71
80244,6,693,17,0,0,0,0,32,49
157197,5,667,2,0,0,0,0,3,5
110056,9,575,5,2,3,0,0,7,17
110577,5,124,115,5,4,0,0,201,325
27202,9,489,40,0,0,0,0,66,106
68000,9,489,192,17,2,1,0,278,490
107860,11,244,21,1,0,0,0,30,52
6457,9,315,151,2,2,1,2,170,328
134677,7,861,18,0,0,0,0,25,43
164057,7,861,2,0,0,0,0,2,4
25302,10,66,1,0,0,0,0,1,2
52648,10,432,178,3,1,0,1,215,398
129129,10,29,30,0,0,0,0,37,67
37849,10,355,64,0,0,0,2,152,218
126367,8,403,293,6,3,0,0,509,811
46276,10,917,220,7,4,0,1,848,1080
79965,6,601,72,1,0,0,0,109,182
97045,6,601,54,3,1,0,0,66,124
41864,10,256,11,0,0,0,0,18,29
39422,10,256,28,0,0,0,0,91,119
147545,10,917,39,0,0,0,1,71,111
45025,10,549,24,0,0,0,0,21,45
139866,10,831,66,1,1,0,0,109,177
15407,10,289,5,0,0,0,0,9,14
50362,10,172,45,0,0,0,0,47,92
30263,10,81,8,0,0,0,0,24,32
100941,10,66,54,1,1,0,0,69,125
120542,10,914,119,2,1,0,0,173,295
44451,9,216,88,0,0,0,1,135,224
133657,9,302,246,14,9,2,1,321,593
35880,9,302,45,0,0,0,0,111,156
40423,7,741,8,0,0,0,0,9,17
26544,5,821,136,6,6,0,1,217,366
62061,5,821,82,1,2,0,0,102,187
164048,9,538,47,1,1,0,0,70,119
13771,7,824,18,0,0,0,0,28,46
89484,9,306,348,0,1,0,1,681,1031
62633,9,313,18,0,0,0,0,31,49
149976,9,607,38,6,3,2,0,94,143
54129,5,263,57,2,2,0,0,93,154
86029,5,263,305,9,8,0,0,520,842
9216,6,693,37,0,0,0,0,46,83
43847,6,922,14,0,0,0,0,29,43
119443,10,355,0,0,0,0,2,410,412
149381,4,115,53,0,0,0,0,82,135
45160,9,492,0,0,1,0,0,0,1
63276,7,157,24,0,0,0,0,41,65
125175,9,469,206,4,1,0,0,263,474
163199,4,923,65,1,1,0,0,120,187
135035,9,469,4,0,0,0,0,8,12
89618,8,124,18,0,0,0,0,32,50
17393,7,824,19,0,0,0,0,19,38
107884,6,235,128,0,0,0,1,217,346
29154,5,783,79,2,0,0,0,127,208
67783,8,214,44,2,1,0,0,82,129
4378,9,374,12,0,0,0,1,36,49
113434,9,487,96,3,2,1,0,186,288
158600,9,374,99,3,1,0,0,163,266
51062,9,741,71,2,0,0,0,106,179
159585,7,492,3,0,1,0,0,5,9
28407,5,225,117,2,2,0,1,185,307
5956,8,124,21,0,0,0,0,21,42
19185,9,597,180,6,2,0,0,297,485
101965,9,597,38,1,3,0,1,91,134
19610,6,601,42,2,1,0,0,69,114
20742,7,496,69,2,2,0,0,117,190
167193,7,861,63,3,3,0,0,117,186
148824,7,496,22,0,0,0,0,48,70
90039,4,159,249,5,4,0,2,419,679
88668,9,693,66,0,0,0,0,109,175
19617,9,873,2,0,0,0,0,2,4
98850,9,341,8,0,0,0,0,18,26
110493,9,452,20,0,0,0,1,40,61
144815,9,658,6,1,1,0,0,9,17
3636,8,623,85,0,1,0,0,141,227
150057,5,489,9,0,0,0,0,11,20
117442,5,159,12,0,0,0,0,15,27
87975,4,519,150,0,0,0,0,224,374
65674,7,578,33,1,0,0,0,52,86
38760,9,607,101,0,0,0,0,155,256
107009,7,484,33,1,1,0,0,34,69
148882,9,607,18,0,0,0,0,25,43
12153,7,157,3,0,0,0,0,5,8
31347,4,36,83,4,2,0,0,157,246
74628,7,641,123,2,3,0,0,177,305
63240,9,657,29,1,1,0,1,44,76
64363,10,653,34,0,0,0,0,63,97
84549,10,355,12,0,0,0,0,10,22
1108,10,355,14,0,0,0,0,21,35
165337,4,306,3,0,0,0,0,4,7
50190,4,800,123,0,0,0,0,179,302
166699,4,658,35,1,1,0,1,77,115
154683,10,820,5,0,0,0,0,18,23
12230,6,209,51,0,0,0,0,66,117
158929,11,214,15,0,0,0,0,18,33
2822,9,842,287,9,2,2,2,438,740
92516,10,200,64,3,3,0,0,90,160
10697,7,367,23,0,0,0,0,21,44
35699,9,131,4,0,0,0,0,5,9
89992,9,131,10,0,0,0,0,15,25
85373,11,885,4,0,0,0,0,2,6
160015,7,367,16,0,0,0,0,20,36
96378,5,124,49,0,0,0,0,64,113
12720,6,301,129,1,0,0,1,275,406
47708,11,214,27,0,0,0,0,37,64
54156,11,489,272,12,0,1,0,360,645
103231,7,578,73,0,0,0,2,130,205
77460,5,66,39,0,0,0,0,68,107
87842,8,214,72,0,0,0,1,89,162
138200,8,214,83,0,0,0,1,88,172
68921,9,575,92,2,2,0,1,157,254
78253,4,200,87,1,1,0,1,155,245
144902,9,575,115,3,3,0,2,177,300
162221,9,538,23,1,1,0,1,50,76
35683,9,545,15,0,0,0,0,14,29
29274,9,575,10,0,0,0,0,16,26
103490,9,575,26,2,0,0,0,28,56
118903,7,589,30,0,1,0,1,48,80
44403,9,575,33,1,1,0,0,50,85
157957,7,589,40,0,0,0,0,49,89
23201,7,74,7,1,0,0,0,34,42
118551,7,74,5,1,1,0,0,28,35
55084,7,74,1,0,0,0,0,9,10
141488,7,194,29,0,0,0,0,53,82
18859,7,74,0,0,0,0,0,27,27
32207,7,74,50,0,0,0,0,76,126
167484,9,575,17,0,0,0,1,9,27
107772,6,209,323,21,6,1,2,500,853
108552,6,251,10,0,0,0,0,11,21
71703,8,489,282,0,1,0,2,444,729
106759,8,489,1107,28,14,3,7,1878,3037
49818,9,575,8,0,0,0,0,13,21
103442,9,575,10,0,0,0,1,16,27
42945,7,175,20,0,0,0,0,42,62
68193,6,200,20,0,0,0,0,27,47
30641,5,159,303,10,4,0,2,504,823
4570,6,821,271,5,5,0,1,357,639
100950,8,800,57,5,2,0,0,88,152
3833,9,630,27,1,2,0,0,38,68
78041,7,587,24,0,0,0,0,34,58
160273,7,864,22,0,0,0,0,26,48
129737,9,374,18,0,0,0,0,37,55
27078,4,174,0,0,0,0,0,1,1
116747,7,328,26,0,0,0,0,32,58
159352,7,56,23,0,0,0,0,20,43
61100,5,655,350,10,6,0,2,530,898
148434,8,306,3949,99,38,2,21,6691,10800
165603,11,214,20,0,0,0,0,24,44
149492,11,214,86,0,0,0,0,93,179
17923,5,140,23,1,1,0,0,45,70
32884,4,375,52,0,0,0,0,91,143
88416,5,140,5,0,0,0,0,8,13
165491,9,556,13,0,0,0,0,13,26
8867,10,722,44,4,1,0,0,75,124
132096,10,81,54,2,2,0,0,70,128
25342,10,66,3,0,0,0,0,0,3
162082,6,601,33,2,1,0,0,57,93
167525,7,611,2,0,0,0,0,2,4
167888,10,820,3,0,0,0,0,9,12
170276,7,741,258,10,1,1,0,462,732
103791,7,741,31,0,0,0,0,48,79
103876,7,741,14,0,0,0,1,31,46
117955,9,510,69,2,0,1,0,98,170
108132,7,741,20,1,1,0,0,31,53
5067,5,71,73,1,1,0,1,130,206
140223,8,403,25,0,0,0,0,37,62
71795,5,71,44,0,0,0,0,74,118
132347,10,868,12,0,0,0,0,14,26
102637,4,375,125,5,5,0,0,236,371
34388,5,176,16,0,0,0,0,19,35
133316,5,176,18,0,0,0,0,34,52
166624,8,489,1419,43,13,8,8,2331,3822
44271,8,403,4,0,0,0,0,2,6
146517,5,78,2,0,0,0,0,3,5
157309,8,622,148,3,0,0,0,241,392
42182,9,556,56,4,2,0,1,114,177
92049,11,812,37,0,0,0,0,45,82
108237,7,521,2,0,0,0,0,3,5
36585,8,427,15,0,0,0,0,28,43
57332,5,773,9,0,0,0,0,10,19
5539,4,923,4,0,0,0,0,2,6
134122,6,235,71,0,0,0,0,103,174
27621,6,200,195,5,1,0,1,307,509
56874,9,30,22,0,1,0,0,33,56
83608,9,693,195,10,6,2,1,250,464
157164,5,232,45,1,1,0,0,72,119
109282,8,623,145,0,0,0,1,228,374
51299,7,861,39,0,0,0,0,52,91
84606,9,800,60,1,0,1,0,97,159
104515,8,489,156,0,0,0,1,254,411
27890,6,658,9,0,0,0,0,13,22
138237,6,232,16,0,0,0,0,31,47
120167,10,81,9,0,0,0,0,18,27
106467,4,222,111,0,0,0,1,201,313
153373,9,575,9,0,0,0,0,9,18
52138,10,322,11,0,0,0,0,11,22
145318,4,453,13,0,0,0,0,14,27
105684,4,923,8,0,0,0,0,10,18
155042,8,800,15,0,0,0,0,15,30
36518,10,474,94,4,1,0,0,125,224
92179,10,334,19,1,0,0,0,26,46
152233,4,159,24,0,0,0,0,33,57
82400,8,214,3,0,0,0,0,0,3
152590,8,214,17,0,0,0,0,11,28
811,6,263,250,8,3,1,1,367,630
84464,4,519,7,0,0,0,0,20,27
51464,9,489,95,1,1,0,1,167,265
72661,9,489,178,6,2,1,2,396,585
162149,4,752,622,17,6,0,3,971,1619
126958,8,174,117,0,1,0,0,159,277
49282,11,677,34,1,0,0,0,35,70
48700,9,589,67,1,0,0,2,119,189
73528,9,800,69,3,0,0,1,86,159
6850,9,315,3,0,0,0,0,7,10
85142,4,519,4,0,0,0,0,15,19
141685,4,200,31,0,0,0,0,50,81
77072,10,66,12,1,1,0,0,24,38
49461,10,722,55,1,0,0,1,70,127
79821,8,545,170,0,0,0,1,276,447
75820,10,66,33,0,0,0,0,71,104
144852,10,831,58,0,0,0,0,75,133
98282,9,570,27,0,0,0,0,41,68
48274,9,570,5,0,0,0,0,5,10
27965,9,570,25,0,0,0,0,31,56
29529,11,545,5,0,0,0,0,4,9
29682,8,766,6,0,0,0,0,9,15
20534,9,399,24,1,0,1,0,44,70
164228,7,587,107,0,0,0,0,133,240
103258,4,885,30,0,0,0,0,50,80
76492,9,469,24,0,0,0,0,38,62
35711,7,861,13,0,0,2,0,16,31
144270,9,469,26,1,1,0,0,67,95
166788,7,861,51,0,0,2,0,59,112
101863,9,469,4,0,0,0,0,4,8
48540,8,214,10,0,0,0,0,9,19
159188,9,78,97,0,0,0,2,176,275
113266,7,527,15,0,0,0,0,16,31
14861,4,115,60,0,0,0,0,93,153
48069,6,209,130,8,4,1,3,228,374
32123,10,917,16,0,0,0,0,18,34
91023,8,489,159,1,1,0,1,295,457
106082,9,243,25,0,1,0,0,38,64
152552,10,63,64,0,0,0,0,117,181
29015,4,174,6,0,0,0,0,6,12
154033,9,487,90,1,1,0,1,144,237
130685,6,667,87,3,1,0,0,145,236
46570,5,200,362,1,0,0,4,620,987
166736,5,821,233,11,6,0,2,378,630
88364,9,469,8,0,0,0,0,12,20
125015,8,885,146,2,2,0,0,317,467
95379,8,885,299,13,3,1,2,669,987
4284,4,159,16,0,0,0,0,20,36
113459,8,214,28,0,0,0,0,40,68
126292,7,496,51,0,0,0,1,83,135
82423,7,484,29,0,0,0,1,49,79
44072,4,453,10,0,0,0,0,12,22
51038,7,601,75,1,2,0,0,91,169
11478,4,581,14,0,0,0,0,16,30
170678,6,269,125,0,0,0,0,199,324
107438,8,812,121,6,3,0,1,230,361
68156,5,381,151,1,1,0,0,198,351
6399,4,338,108,0,0,0,0,129,237
132201,7,211,26,1,1,0,1,38,67
65258,7,226,8,1,1,0,0,12,22
126812,11,30,45,1,0,0,0,58,104
149917,11,214,4,0,0,0,0,4,8
77663,7,669,4,0,0,0,0,9,13
13620,7,698,72,2,2,0,0,99,175
104383,9,374,34,5,2,1,0,80,122
94031,6,785,32,0,0,0,1,34,67
25900,7,698,67,3,1,0,1,113,185
10387,7,698,17,0,1,0,0,34,52
140297,10,355,17,0,0,0,0,33,50
38635,10,355,4,0,0,0,0,18,22
156457,10,355,3,0,0,0,0,20,23
162402,9,873,28,1,1,0,1,93,124
133875,4,200,115,1,0,0,0,195,311
4627,7,698,15,1,0,0,0,36,52
38177,8,209,18,0,0,0,0,26,44
100350,6,232,59,1,0,0,0,95,155
108565,9,741,17,1,0,0,0,34,52
125875,8,693,377,3,1,0,2,626,1009
89287,8,623,241,1,0,0,0,335,577
157757,5,174,258,0,0,0,2,399,659
96670,5,371,22,0,0,0,0,43,65
116990,7,194,15,1,0,0,0,21,37
138876,6,117,91,0,1,0,0,158,250
97393,4,678,3,0,0,0,0,8,11
68856,9,379,436,7,5,1,1,584,1034
143647,7,216,137,2,2,0,0,222,363
62484,9,489,297,9,8,0,2,461,777
124375,8,623,33,0,0,0,1,43,77
7604,6,106,78,5,1,0,1,129,214
17576,8,812,210,4,3,0,2,329,548
161259,5,176,570,18,10,7,6,960,1571
9048,6,827,74,2,3,0,1,135,215
3977,6,827,17,0,0,0,0,22,39
120942,6,209,21,0,0,0,0,21,42
11243,6,827,45,0,0,0,1,81,127
146634,8,545,293,0,0,0,0,429,722
102933,7,909,248,6,3,0,1,347,605
126514,4,174,51,1,0,0,0,114,166
117092,7,157,28,0,0,0,0,53,81
118355,5,479,6,0,0,0,0,7,13
113461,5,444,21,0,0,0,1,32,54
37425,7,587,39,0,1,0,0,74,114
149092,6,165,5,0,0,0,0,14,19
170036,8,812,33,0,0,0,0,59,92
70865,7,563,39,0,0,0,0,58,97
43987,7,563,2,0,0,0,0,4,6
104541,9,306,9,0,0,0,0,9,18
45664,9,306,11,0,0,0,0,18,29
58845,10,322,2,0,0,0,0,3,5
141039,8,693,428,9,4,0,2,663,1106
128759,4,174,12,0,0,0,0,15,27
170244,10,831,51,2,1,0,0,197,251
4330,9,100,11,0,0,0,0,14,25
168128,7,521,493,13,6,1,3,639,1155
81342,7,563,52,0,0,0,0,81,133
112557,10,111,32,0,0,0,0,38,70
81252,8,812,68,1,1,0,1,97,168
33093,11,812,2,0,0,0,0,2,4
45956,8,623,9,0,0,0,0,9,18
32393,5,263,78,0,0,0,0,112,190
119882,11,214,42,1,0,0,0,48,91
28858,9,589,35,0,0,0,0,62,97
133974,10,40,5,0,0,0,0,5,10
104624,10,40,8,0,0,0,0,5,13
5442,9,469,1,0,0,0,0,1,2
101467,6,78,66,0,0,0,0,96,162
52242,10,549,11,0,0,0,0,8,19
87079,7,563,276,1,1,0,1,327,606
57492,10,917,265,6,2,1,2,983,1259
67513,7,589,26,0,0,0,1,55,82
87652,4,200,194,1,0,0,0,337,532
165191,9,741,64,0,0,0,0,88,152
84718,6,103,10,0,0,0,0,16,26
100375,9,741,9,0,0,0,0,18,27
155148,7,748,74,7,3,0,1,180,265
154501,4,159,36,0,0,0,0,52,88
7207,7,79,42,2,1,1,2,78,126
64100,7,79,54,1,1,0,2,83,141
70044,4,222,421,10,7,0,1,813,1252
170635,5,489,74,0,0,0,0,113,187
124556,9,302,115,3,3,1,2,245,369
46863,8,306,10,0,0,0,0,18,28
169045,7,587,24,0,0,0,0,31,55
116596,7,194,9,0,0,0,0,15,24
42084,11,124,22,0,0,0,0,21,43
117502,10,256,34,1,0,0,0,42,77
168849,10,256,63,0,0,0,1,79,143
128092,7,100,93,12,7,1,0,270,383
141777,7,556,10,0,0,0,0,13,23
39849,7,864,22,0,0,0,0,43,65
125612,7,587,47,0,0,0,0,58,105
114824,7,748,115,0,1,0,0,162,278
16144,7,157,308,8,6,0,0,482,804
78365,7,611,6,0,0,0,0,7,13
72494,7,202,28,0,0,0,0,35,63
109528,7,492,2,0,0,0,0,3,5
108979,4,375,16,0,0,0,0,33,49
21136,6,209,40,0,0,0,0,66,106
76320,7,214,30,0,0,0,0,46,76
63988,7,214,4,0,0,0,0,6,10
28257,9,243,154,3,2,0,1,247,407
45525,8,214,237,0,0,0,2,392,631
54857,7,508,23,1,0,0,0,40,64
7303,9,157,37,0,0,0,0,77,114
67020,4,351,30,0,0,0,0,46,76
68280,9,538,235,14,10,0,1,349,609
67149,5,489,43,0,0,0,0,57,100
26933,9,909,5,0,0,0,0,7,12
69581,9,243,61,2,1,0,1,114,179
71623,11,30,46,1,0,0,0,39,86
141207,5,181,1,0,0,0,0,0,1
24760,7,228,11,0,0,0,0,8,19
95624,4,658,49,0,0,0,0,60,109
121215,9,367,12,0,0,0,0,17,29
88642,9,374,20,3,2,1,3,53,82
122524,9,909,47,2,2,0,0,66,117
119153,9,314,8,0,0,0,0,12,20
106251,9,367,58,3,2,0,0,81,144
58964,9,457,18,0,0,0,0,33,51
49982,10,790,31,0,0,0,0,47,78
19896,6,643,63,1,1,0,0,87,152
50531,9,570,57,0,0,0,1,75,133
165259,6,643,42,0,0,0,0,57,99
125102,6,209,36,0,0,0,0,63,99
105510,4,375,1,0,0,0,0,0,1
136215,4,519,2,0,0,0,0,2,4
52282,7,545,64,2,2,1,1,82,152
64820,7,157,40,1,1,0,1,61,104
126135,7,157,34,0,0,0,0,43,77
106141,7,194,3,0,0,0,0,4,7
79774,9,469,66,4,3,0,0,98,171
59296,7,194,50,4,0,1,0,92,147
131424,5,263,135,0,1,0,1,238,375
70077,7,496,38,0,0,0,0,63,101
41262,7,496,6,0,0,0,0,16,22
114287,7,587,41,0,0,0,0,44,85
13155,11,403,8,1,0,0,0,9,18
36006,7,551,9,0,0,0,0,19,28
161181,8,623,213,4,3,0,2,349,571
120459,8,214,87,0,0,0,0,134,221
32044,9,575,57,3,2,0,0,166,228
105795,5,159,68,1,1,0,0,130,200
139620,9,575,505,10,8,1,1,766,1291
120394,8,403,5,0,0,0,0,5,10
140031,10,550,18,0,0,0,1,29,48
5723,10,550,10,0,0,0,0,31,41
62122,10,550,16,0,0,0,0,54,70
111441,10,550,7,0,0,0,0,21,28
146932,10,355,4,0,0,0,1,8,13
31087,5,159,22,0,0,0,0,36,58
51730,6,885,60,3,1,0,0,96,160
87565,8,766,55,0,0,0,0,54,109
24230,4,800,25,0,0,0,0,44,69
152811,4,351,4,0,0,0,0,6,10
144468,9,741,65,7,4,0,0,105,181
11848,9,741,4,4,1,0,0,2,11
94150,9,741,50,1,0,0,0,70,121
65586,6,821,50,0,0,0,0,71,121
99028,8,489,2,0,0,0,0,3,5
96454,9,741,189,3,3,0,1,316,512
36448,9,741,29,0,0,0,0,60,89
75151,5,306,63,1,0,0,0,100,164
82075,7,232,8,0,0,0,0,7,15
80125,7,872,71,1,1,0,0,92,165
27163,7,587,301,15,5,1,0,442,764
47575,7,149,6,0,0,0,0,4,10
31426,8,214,5,0,0,0,0,5,10
64329,7,100,10,1,1,0,0,14,26
23405,7,232,14,0,0,0,0,5,19
166000,4,800,1,0,0,0,0,0,1
147367,4,124,683,26,9,0,4,1100,1822
94449,5,176,257,9,3,0,0,445,714
161739,9,184,13,0,0,0,0,26,39
49654,8,124,132,0,0,0,2,231,365
151907,6,453,147,2,1,0,0,270,420
154098,8,545,340,9,8,0,1,580,938
18080,8,545,330,12,8,0,1,506,857
37561,5,200,18,0,1,0,0,28,47
115384,11,693,119,10,0,0,0,140,269
157620,9,100,16,4,1,0,0,44,65
26029,8,623,79,3,3,0,1,129,215
140684,6,269,36,0,0,0,0,51,87
18384,11,658,38,2,0,0,0,52,92
32283,7,175,28,0,0,0,0,43,71
120127,6,209,89,3,2,0,1,124,219
37472,6,785,103,3,1,0,0,86,193
120073,4,885,15,0,0,0,0,27,42
171082,4,885,2,0,0,0,0,2,4
168349,6,103,45,3,1,1,0,102,152
133044,6,124,39,1,1,0,0,61,102
100548,7,484,22,0,0,0,0,29,51
78995,9,741,4,0,0,0,0,11,15
32281,8,801,30,1,1,0,0,47,79
130080,7,429,7,0,0,0,0,4,11
86350,7,429,91,2,1,1,0,265,360
5727,5,667,114,12,7,0,0,188,321
137300,7,611,2,0,0,0,0,3,5
56262,7,563,36,0,0,0,0,51,87
34081,7,611,24,1,1,0,0,47,73
24116,7,611,13,0,0,0,0,15,28
40894,11,214,87,3,0,0,0,91,181
161203,7,611,9,0,0,0,0,14,23
121214,7,611,44,0,0,0,0,68,112
168795,7,611,11,0,0,0,0,17,28
117976,9,640,83,1,1,0,0,109,194
144404,7,611,0,0,0,0,0,9,9
141240,6,885,11,0,0,0,0,18,29
15363,7,314,10,1,0,0,0,22,33
61752,8,214,18,0,0,0,0,29,47
139794,9,575,40,0,0,0,0,44,84
84148,9,492,31,1,0,1,0,44,77
94266,9,374,18,0,0,0,0,22,40
66231,6,827,184,7,5,1,1,280,478
127761,7,216,60,0,0,0,0,82,142
20300,5,232,19,0,0,0,0,48,67
55368,8,812,108,7,3,0,1,164,283
134554,8,623,192,1,3,0,0,291,487
77614,9,575,58,4,1,0,0,119,182
1969,5,427,4,0,0,0,0,11,15
84131,9,314,34,1,0,0,0,69,104
69214,9,575,43,2,2,0,0,76,123
23483,7,575,49,3,2,0,1,89,144
17463,8,489,4,0,0,0,0,3,7
57454,7,575,128,7,2,0,0,203,340
55360,10,914,0,0,0,0,0,55,55
86375,8,403,111,10,6,0,1,251,379
77461,9,575,260,11,6,1,0,399,677
135618,6,200,8,0,0,0,0,15,23
151822,7,77,58,0,1,0,0,95,154
91635,9,489,70,3,1,0,1,110,185
12408,9,314,13,0,0,0,0,18,31
19350,9,314,26,0,0,0,0,36,62
9819,9,314,17,0,0,0,0,32,49
83000,10,322,20,0,0,0,0,22,42
151666,4,36,157,6,1,0,0,179,343
154807,9,575,14,0,0,0,0,25,39
147523,9,575,8,2,3,0,0,29,42
154146,9,314,17,0,0,0,0,27,44
1069,7,314,32,4,2,0,0,63,101
86973,9,314,24,0,0,0,0,52,76
129772,8,214,546,9,4,1,4,1045,1609
68784,6,263,124,4,1,0,0,212,341
23753,10,63,32,0,0,0,0,350,382
19554,5,106,385,9,3,0,0,638,1035
162468,11,623,8,0,0,0,0,9,17
112605,9,306,127,0,0,0,3,205,335
62560,6,827,137,8,3,1,0,270,419
156632,6,827,162,1,0,0,1,267,431
41779,4,174,10,0,0,0,0,13,23
6198,10,63,132,6,5,0,1,201,345
148168,5,176,9,0,0,0,0,12,21
170583,9,469,159,5,2,1,1,215,383
21281,6,124,59,1,1,0,0,105,166
77487,8,800,7,0,0,0,0,7,14
35690,7,578,25,1,1,0,0,39,66
14160,7,578,20,2,0,1,0,32,55
47950,8,545,79,0,0,0,2,149,230
78292,9,538,2,0,0,0,0,8,10
40925,9,457,298,13,6,2,6,350,675
76402,9,575,0,0,0,0,0,3,3
113396,11,214,12,1,0,0,0,11,24
73385,5,885,18,0,0,0,0,33,51
32014,5,893,197,4,0,0,0,347,548
101729,8,214,23,0,0,0,0,16,39
93380,6,514,236,5,2,2,3,341,589
73849,4,200,6,0,0,0,0,14,20
43953,4,174,21,0,0,0,0,31,52
140703,6,128,24,1,0,0,0,32,57
157403,6,729,7,0,0,0,0,17,24
133304,6,165,21,0,0,0,1,36,58
12027,4,885,4,0,0,0,0,10,14
123555,9,630,133,0,0,0,0,160,293
126809,7,157,46,1,1,0,2,65,115
68712,6,200,113,5,2,0,0,203,323
8908,9,145,148,6,2,1,0,231,388
101284,8,214,72,0,0,0,0,103,175
25099,5,159,108,3,3,0,2,188,304
33862,9,630,173,4,4,0,0,236,417
58135,9,158,10,0,0,0,0,32,42
116545,9,145,5,0,0,0,0,20,25
77366,10,841,6,0,0,0,0,2,8
133562,4,159,153,3,0,0,0,272,428
71722,4,159,64,0,0,0,0,97,161
53321,7,713,155,1,1,0,0,302,459
90252,7,713,70,0,1,0,0,135,206
145685,4,658,39,0,0,0,0,64,103
131185,7,713,55,1,1,0,0,162,219
110171,11,489,65,0,0,0,0,77,142
132995,9,367,272,6,5,1,2,343,629
80279,4,200,4,0,0,0,0,4,8
78699,10,66,6,0,0,0,0,20,26
145323,10,81,2,0,0,0,0,6,8
158951,10,81,6,0,0,0,0,23,29
102278,7,861,66,2,2,0,1,136,207
138082,4,306,37,1,0,0,0,67,105
133245,11,403,148,6,0,0,0,150,304
101196,8,124,82,2,2,0,1,116,203
126386,4,200,65,0,0,0,0,99,164
169041,5,800,19,0,0,0,0,27,46
151808,6,59,112,2,0,0,0,163,277
46200,6,232,67,0,0,0,0,117,184
167878,6,251,18,0,0,0,0,15,33
29800,4,174,6,0,0,0,0,8,14
135580,4,658,41,0,0,0,0,60,101
2284,4,923,45,1,0,0,1,68,115
64870,7,46,33,0,1,0,0,41,75
34677,9,374,18,0,0,0,0,39,57
77733,9,819,11,0,0,0,0,20,31
84838,8,489,122,0,1,0,0,161,284
47495,8,489,77,0,0,0,0,94,171
103451,9,243,155,1,0,1,1,275,433
131770,9,813,30,0,0,0,0,57,87
64028,7,24,1,0,0,0,0,15,16
119135,9,243,13,0,0,0,0,20,33
14599,7,194,54,0,1,0,0,63,118
124308,7,194,66,0,0,0,0,88,154
27499,7,864,2,0,0,0,0,3,5
168446,10,111,47,0,0,0,1,72,120
163905,9,302,61,0,1,0,0,82,144
96966,10,111,20,0,0,0,0,35,55
102224,10,111,8,0,0,0,0,16,24
107733,6,785,17,3,0,0,0,26,46
129630,6,209,16,0,0,0,0,33,49
160245,9,910,1,0,0,0,0,2,3
59268,9,910,6,0,0,0,0,4,10
146290,9,842,156,3,2,1,0,945,1107
84588,6,232,127,4,2,1,0,173,307
42821,9,828,4,0,0,0,0,4,8
70813,9,828,2,0,0,0,0,2,4
37351,10,903,88,2,2,0,0,171,263
95136,6,78,95,0,0,0,0,114,209
113915,6,785,31,1,1,0,0,67,100
63138,9,589,25,0,0,0,0,54,79
56187,9,589,28,0,0,0,0,43,71
160004,9,589,52,0,0,0,0,141,193
4256,10,104,40,1,0,0,0,65,106
31656,5,78,2,0,0,0,0,3,5
62334,5,570,18,0,0,0,0,27,45
663,5,200,124,5,2,0,0,189,320
75739,8,214,113,0,0,0,0,179,292
114790,6,124,36,0,0,0,0,67,103
53689,4,36,121,1,1,0,0,191,314
151711,9,630,210,3,0,0,1,295,509
58959,8,622,158,1,1,0,2,302,464
23541,4,691,3,0,0,0,0,2,5
155074,8,812,100,0,0,0,0,170,270
24044,10,716,50,0,0,1,0,71,122
43690,7,648,59,1,0,0,0,173,233
92114,10,722,160,4,0,0,0,229,393
144504,9,158,27,3,1,0,0,147,178
48695,9,819,55,0,0,0,0,90,145
65421,9,800,4,0,0,0,0,9,13
57302,7,861,35,0,0,0,0,120,155
35287,8,124,54,0,0,0,0,82,136
90191,7,484,12,0,0,0,0,11,23
125113,7,484,12,0,0,0,0,21,33
12371,8,800,348,3,2,1,1,512,867
112034,7,744,9,0,0,0,0,5,14
421,9,800,150,3,2,0,0,197,352
17917,6,404,25,0,0,0,0,58,83
42039,6,269,22,0,0,0,0,45,67
170394,6,404,142,0,0,0,2,255,399
42534,6,404,2,0,0,0,0,4,6
117641,8,800,246,9,0,2,2,440,699
85795,10,474,73,0,0,0,0,98,171
103369,9,301,13,0,0,0,0,17,30
59908,5,200,99,2,1,0,0,140,242
110752,7,484,2,0,0,0,0,9,11
22367,7,484,10,0,0,0,0,30,40
153881,9,86,36,0,0,0,0,59,95
95404,7,641,23,0,0,0,0,62,85
67287,4,36,112,6,2,0,0,263,383
170000,5,479,4,0,0,0,0,5,9
151469,9,314,53,0,0,0,1,95,149
126005,5,489,10,0,0,0,1,15,26
58258,9,483,12,0,0,0,1,17,30
104473,7,641,14,0,0,0,0,26,40
8580,7,641,4,0,0,0,0,6,10
105583,7,641,6,0,0,0,0,8,14
78158,9,314,34,0,0,0,2,37,73
6633,10,799,2,0,0,0,0,2,4
62577,11,306,14,0,0,0,0,19,33
81399,11,306,18,0,0,0,0,24,42
4758,5,66,5,0,0,0,0,21,26
163153,8,214,39,0,0,0,0,66,105
120662,10,617,68,0,0,0,0,116,184
141577,9,741,204,0,0,0,0,291,495
77751,10,576,33,0,0,0,0,69,102
8396,10,617,16,0,0,0,0,29,45
89025,7,484,28,0,0,0,1,46,75
164411,7,648,16,0,1,0,0,41,58
103487,10,722,32,0,0,0,0,50,82
98890,10,355,9,0,0,0,0,19,28
123124,10,66,2,0,0,0,0,3,5
159284,10,799,2,0,0,0,0,3,5
102241,10,66,10,0,0,0,0,29,39
19833,10,66,8,0,0,0,0,8,16
12180,9,489,134,3,1,0,0,154,292
62025,8,403,120,1,0,0,0,212,333
155856,8,214,53,0,0,0,1,67,121
97663,10,66,60,0,0,0,0,91,151
111082,11,800,55,0,0,0,0,61,116
30163,7,741,180,4,4,0,1,315,504
90209,7,484,30,0,0,0,0,54,84
43107,9,487,17,0,0,0,0,30,47
88174,9,489,139,6,2,0,0,189,336
60896,9,487,5,0,0,0,0,10,15
71767,7,484,4,0,0,0,0,10,14
83530,9,487,1,0,0,0,0,6,7
164602,7,484,62,0,0,0,0,87,149
130646,9,487,3,3,1,0,0,31,38
44716,10,917,2,0,0,0,0,7,9
83009,6,165,161,15,7,0,2,331,516
152679,10,105,88,1,2,0,0,143,234
155188,7,228,39,2,1,0,0,70,112
34828,4,200,1,0,0,0,0,1,2
26980,7,762,183,13,6,2,0,329,533
47497,7,367,63,0,0,0,0,107,170
44802,9,597,73,0,0,0,0,110,183
125730,8,489,383,6,4,0,2,635,1030
63693,5,693,72,0,0,0,1,105,178
98822,5,570,47,0,1,0,0,84,132
113851,7,658,77,1,0,0,0,126,204
121069,9,306,397,1,1,0,3,772,1174
150799,4,159,63,0,0,0,0,83,146
36546,7,563,9,0,0,0,0,12,21
142692,5,235,20,0,0,0,0,29,49
56142,8,489,24,0,0,0,0,23,47
110772,7,126,38,1,1,0,0,60,100
48649,9,842,55,0,0,0,0,85,140
61966,7,669,14,0,0,0,0,17,31
111619,6,200,4,0,0,0,0,5,9
63973,8,885,2,0,0,0,0,3,5
155999,9,158,13,0,0,0,0,29,42
93617,6,263,38,0,0,0,0,60,98
161761,9,597,6,0,2,0,0,13,21
144031,11,677,4,0,0,0,0,4,8
30689,6,78,102,1,0,0,0,155,258
18885,6,800,26,0,0,0,1,47,74
155714,6,800,437,28,11,3,0,750,1229
142296,8,403,84,0,0,0,0,130,214
122934,8,562,440,7,4,0,3,622,1076
21882,8,484,87,0,0,0,0,122,209
113328,6,209,74,1,1,0,0,97,173
52756,8,812,40,0,0,0,0,75,115
163389,7,214,144,0,0,0,0,232,376
130636,5,479,29,0,0,0,0,54,83
60491,7,214,32,0,0,0,1,61,94
67814,10,29,28,0,0,0,0,44,72
153128,9,741,6,0,0,0,0,28,34
142911,6,537,27,0,0,0,1,53,81
53881,6,785,9,0,0,0,0,25,34
88303,11,30,57,0,0,0,0,64,121
65559,6,235,119,3,2,0,0,202,326
5568,9,741,7,0,0,0,0,17,24
153929,7,741,28,0,0,0,0,53,81
166065,10,355,8,0,0,0,0,9,17
165347,6,785,10,0,0,0,0,29,39
35399,6,785,24,1,0,0,0,36,61
159746,10,289,4,0,0,0,0,10,14
162072,10,289,4,0,0,0,0,9,13
10667,10,413,2,0,0,0,0,2,4
147407,7,100,172,1,0,1,0,237,411
98847,10,289,3,0,0,0,0,7,10
32444,6,124,65,0,0,1,0,140,206
71870,9,741,12,0,0,0,0,17,29
149424,6,489,123,1,2,0,1,174,301
92771,5,159,80,3,3,0,0,109,195
57919,6,106,34,7,2,0,0,77,120
54529,7,484,56,0,0,0,1,84,141
38629,8,800,2,0,0,0,0,2,4
19338,7,492,2,0,0,0,0,5,7
11004,6,514,30,1,0,0,0,41,72
56632,8,812,48,1,2,0,0,102,153
141568,10,87,4,0,0,0,0,3,7
164225,10,87,10,1,0,0,0,17,28
148342,10,87,4,0,0,0,0,5,9
57812,10,87,3,0,0,0,0,3,6
87046,10,87,6,0,0,0,0,3,9
8791,10,743,8,0,0,0,0,13,21
168434,6,885,1369,83,23,12,6,2227,3720
20873,5,479,9,0,0,0,0,11,20
87692,5,124,2,0,0,0,0,2,4
107357,5,124,11,0,0,0,0,14,25
138735,5,124,15,0,0,0,0,23,38
100489,5,124,5,0,0,0,0,6,11
112984,5,124,9,0,0,0,0,20,29
94585,5,124,25,0,0,0,0,31,56
55212,5,124,14,0,0,0,0,15,29
13016,7,552,25,0,0,0,0,35,60
132619,7,552,43,0,1,0,0,79,123
91132,4,270,29,1,0,0,0,47,77
80809,4,270,10,0,0,0,0,19,29
23583,7,842,3,0,0,0,0,0,3
53332,9,100,2,0,0,0,0,2,4
85549,7,842,106,1,1,0,0,148,256
101503,7,484,16,0,0,0,1,20,37
74024,7,484,32,0,0,0,0,33,65
67638,7,118,5,0,0,0,0,4,9
157667,9,640,71,1,0,0,0,91,163
162174,10,525,13,0,0,0,0,21,34
28672,4,200,102,0,0,0,0,141,243
121193,6,78,60,0,0,0,1,76,137
141382,10,322,2,0,0,0,0,2,4
155112,8,812,25,1,1,0,0,44,71
3334,5,159,8,0,0,0,0,17,25
152268,7,861,67,0,0,0,1,117,185
163675,7,861,15,0,0,0,0,34,49
11133,7,861,8,1,0,0,0,14,23
67955,7,587,38,1,1,0,0,33,73
161783,7,587,111,1,0,0,0,155,267
73445,7,713,81,0,0,0,0,152,233
139660,7,713,82,0,0,0,0,137,219
160382,10,653,112,4,3,0,0,147,266
130233,10,474,10,0,0,0,0,15,25
11699,11,124,69,0,0,0,0,91,160
146066,9,828,4,0,0,0,0,10,14
19999,10,831,72,0,0,1,1,153,227
38692,4,800,114,0,0,0,1,216,331
736,9,640,252,8,1,0,1,375,637
168672,10,63,35,3,1,0,1,83,123
25221,7,508,6,0,0,0,0,9,15
133184,5,200,14,0,0,0,0,33,47
94510,7,508,6,0,0,0,0,6,12
151004,7,508,11,0,0,0,0,13,24
159218,7,521,7,0,0,0,0,6,13
154311,10,781,11,0,0,0,0,14,25
10074,6,135,4,0,0,0,0,4,8
159768,7,521,28,0,0,0,0,17,45
33075,7,521,163,7,0,0,1,223,394
157993,7,404,62,0,0,0,1,86,149
130984,11,306,19,0,0,0,0,21,40
55732,7,861,26,0,0,0,0,38,64
139384,10,474,68,1,1,0,2,105,177
127408,6,489,34,0,0,0,0,41,75
96915,5,585,17,0,0,0,0,22,39
39539,7,489,24,0,0,0,0,36,60
74305,8,545,147,0,0,0,0,215,362
13087,6,800,9,0,0,0,0,9,18
81968,6,693,14,0,0,0,0,21,35
105167,8,545,39,0,0,0,0,66,105
149622,7,126,40,1,0,0,0,63,104
114574,6,901,26,0,0,0,0,53,79
7548,8,214,119,0,0,0,0,176,295
32163,8,214,99,1,1,0,0,159,260
39962,8,214,92,0,0,0,1,133,226
41811,7,387,10,0,0,0,0,11,21
86064,6,232,24,0,0,0,0,45,69
62292,4,200,8,0,0,0,0,15,23
14763,4,519,2,0,0,0,0,2,4
79923,5,200,8,0,0,0,0,6,14
77085,10,200,7,0,0,0,0,6,13
62234,6,200,6,0,0,0,0,4,10
112474,6,159,10,0,0,0,0,9,19
151233,8,812,45,1,0,0,1,59,106
103775,4,752,19,0,0,0,0,29,48
147688,9,497,6,2,0,0,0,11,19
161433,10,413,4,0,0,0,0,3,7
167445,10,413,6,0,0,0,0,9,15
110859,10,774,2,0,0,0,0,3,5
20066,11,306,79,1,0,0,0,82,162
42725,11,214,104,4,0,0,0,107,215
155010,10,413,4,0,0,0,0,5,9
161489,10,413,15,0,0,0,0,26,41
57289,10,413,1,0,0,0,0,5,6
42259,10,743,4,0,0,0,0,12,16
52409,6,366,71,3,1,0,0,94,169
127146,10,111,89,2,2,0,0,124,217
18047,7,157,2,2,0,0,0,0,4
48442,6,489,50,1,0,0,0,75,126
62376,9,341,17,0,0,0,0,32,49
45501,9,341,7,0,0,0,0,13,20
107564,4,658,431,29,12,1,1,888,1362
77443,9,873,2,0,0,0,0,3,5
162673,8,214,30,0,0,0,0,55,85
162543,10,200,6,0,0,0,0,8,14
74860,10,63,29,0,0,0,0,42,71
43473,6,221,68,0,0,0,0,86,154
8043,10,917,14,2,0,0,0,45,61
63729,10,917,3,0,0,0,0,14,17
59228,4,658,4,0,0,0,0,10,14
144377,5,78,298,9,4,1,3,476,791
80926,7,575,26,1,1,0,0,59,87
16874,9,575,17,0,0,0,0,55,72
147103,9,575,4,0,0,0,0,7,11
135601,9,575,15,1,1,0,0,34,51
75532,9,575,8,0,0,0,0,8,16
109625,9,575,150,4,2,0,1,219,376
1811,9,575,219,9,3,2,0,335,568
14701,7,575,3,0,0,0,0,11,14
44742,10,653,22,2,2,0,0,71,97
166695,10,653,41,2,0,0,0,53,96
56427,8,214,39,1,1,0,0,52,93
89943,6,78,27,0,0,0,0,31,58
72421,5,545,132,5,3,0,3,190,333
84438,8,693,202,1,1,0,1,293,498
109109,9,575,185,3,4,0,0,202,394
14973,9,575,8,0,0,0,0,10,18
66202,9,575,15,1,1,0,0,41,58
158058,9,575,21,0,0,0,0,33,54
148551,9,575,36,3,2,0,0,57,98
69353,9,575,56,5,1,0,0,66,128
94624,9,575,34,0,0,0,0,50,84
52652,9,575,36,3,1,0,0,74,114
73273,7,741,32,1,0,0,0,44,77
120539,7,578,16,1,1,0,0,35,53
136065,7,373,34,0,0,0,0,44,78
134037,10,701,120,5,2,1,0,224,352
5135,10,701,18,1,2,0,0,102,123
87266,7,74,10,0,0,0,0,10,20
4929,7,175,19,0,0,0,0,36,55
9282,9,469,2,0,1,0,0,2,5
103086,9,469,7,1,2,0,0,8,18
3701,9,469,107,2,1,0,1,172,283
49708,9,607,435,22,10,1,4,738,1210
67975,4,752,52,0,0,0,1,64,117
36873,11,812,2,0,0,0,0,1,3
35893,5,699,118,8,2,0,0,200,328
129150,9,538,143,2,1,1,3,228,378
160657,9,538,69,2,0,0,0,121,192
39885,6,200,216,8,5,0,1,294,524
59639,6,200,181,5,1,0,0,274,461
37337,9,429,239,2,0,1,0,342,584
12848,7,472,58,1,0,1,0,77,137
44030,6,235,6,0,0,0,0,11,17
129442,6,235,77,0,0,0,0,120,197
32047,7,207,4,1,0,0,0,10,15
146389,7,587,20,0,0,0,0,41,61
98124,7,484,44,1,1,0,0,62,108
139309,7,589,11,0,0,0,1,27,39
24914,7,214,76,0,0,0,0,104,180
85719,8,800,2601,101,58,6,21,4622,7409
165792,10,653,4,0,0,0,0,9,13
117871,9,842,2,1,0,0,0,0,3
94488,7,658,13,0,0,0,0,21,34
168157,10,256,11,0,0,0,1,28,40
17524,10,653,57,3,3,1,0,110,174
100040,5,655,135,2,1,0,1,232,371
80866,7,118,2,0,0,0,0,3,5
128169,11,214,63,5,0,0,0,59,127
86897,5,821,22,0,0,0,0,32,54
136069,9,301,11,0,0,0,0,19,30
64742,9,42,4,0,0,0,0,9,13
133139,7,157,30,0,0,0,0,33,63
126224,9,489,427,0,0,0,4,1710,2141
115732,6,785,53,4,1,0,0,74,132
100851,4,174,20,0,0,0,0,14,34
8819,6,263,30,0,0,0,0,55,85
66524,7,379,25,1,1,0,0,41,68
113798,9,379,367,11,3,2,2,579,964
14773,9,367,16,0,0,0,0,15,31
120057,4,581,57,1,1,0,0,98,157
98466,9,575,35,0,0,10,0,47,92
152666,4,200,53,0,0,0,0,72,125
7473,9,589,357,15,13,0,0,530,915
58887,9,589,45,2,2,0,0,75,124
24503,5,118,83,4,4,0,1,157,249
4440,5,479,57,0,0,0,2,75,134
118777,9,374,0,0,0,0,0,4,4
160749,9,367,209,6,5,0,0,352,572
96492,6,106,117,10,3,1,3,260,394
30316,4,752,26,0,0,0,0,28,54
75860,9,532,46,4,1,0,0,109,160
128665,9,367,65,0,0,0,0,135,200
28166,9,910,17,0,0,0,0,31,48
58825,9,374,2,0,0,0,0,4,6
1398,6,106,6,0,0,0,0,8,14
121438,9,374,4,0,0,0,0,6,10
83510,9,374,5,1,1,0,0,7,14
88974,9,842,75,6,4,0,0,120,205
139818,6,159,111,0,1,0,1,148,261
53854,9,842,312,10,3,1,2,589,917
83376,5,800,36,1,1,0,0,55,93
82466,7,657,24,3,0,0,1,49,77
32193,5,479,184,2,0,0,0,277,463
135012,7,657,20,0,0,0,0,53,73
91800,9,314,13,0,0,0,0,16,29
19839,7,30,59,4,2,0,0,146,211
74432,5,408,112,1,0,0,1,207,321
170114,5,800,47,1,2,0,0,85,135
85537,5,427,28,2,2,0,1,49,82
141064,9,800,56,3,1,0,0,76,136
84599,9,202,0,2,1,0,0,0,3
149876,10,111,30,0,0,0,0,46,76
47792,10,653,32,1,0,0,0,44,77
143080,5,306,1,0,0,0,0,0,1
42769,10,653,477,13,6,1,5,896,1398
135425,9,306,2,0,0,0,0,3,5
119529,9,405,2,0,0,0,0,14,16
87757,4,200,4,0,0,0,0,4,8
33318,4,200,7,0,0,0,0,9,16
132651,10,914,0,0,0,0,0,5,5
104573,8,800,143,5,5,0,0,181,334
73879,8,623,51,0,0,0,0,91,142
76162,8,623,14,0,0,0,0,25,39
75889,10,200,2,0,0,0,0,3,5
92480,9,65,185,7,2,0,0,317,511
98118,9,65,3,0,0,0,0,15,18
169699,9,65,527,5,4,0,3,814,1353
7534,9,65,1,0,0,0,0,3,4
158225,6,159,255,1,0,0,0,380,636
25277,9,842,200,6,6,0,1,315,528
100633,9,65,11,0,0,0,0,41,52
114895,9,65,1,0,0,0,0,2,3
27381,9,65,1,0,0,0,0,1,2
135484,9,145,6,0,0,0,0,18,24
110586,10,550,18,0,0,0,0,28,46
59583,9,538,54,0,0,0,0,90,144
131592,4,923,30,0,0,0,0,65,95
142686,9,489,37,0,0,0,0,75,112
157675,7,648,3,1,0,0,0,1,5
145370,7,657,28,0,0,0,3,45,76
111801,9,800,18,0,0,0,0,33,51
111416,11,677,2,0,0,0,0,1,3
77467,5,453,19,0,0,0,0,35,54
161743,6,140,12,0,0,0,0,36,48
111589,5,381,83,1,0,0,0,110,194
115598,5,479,33,0,0,0,0,63,96
46000,9,341,4,0,0,0,0,10,14
93874,10,289,2,0,0,0,0,3,5
99937,9,483,30,2,0,0,0,47,79
68968,9,379,65,3,1,0,1,97,167
43625,9,4,150,3,0,0,0,174,327
48106,6,58,139,2,1,0,0,221,363
31152,4,200,4,0,0,0,0,4,8
7633,7,457,7,0,0,0,0,12,19
169011,7,457,1,0,0,0,0,0,1
15461,6,159,73,0,1,0,0,118,192
46786,4,200,165,4,1,0,0,244,414
85073,8,489,289,0,0,0,2,457,748
134488,7,861,21,0,0,0,0,49,70
40900,6,78,5,0,0,0,0,6,11
33385,4,658,29,0,0,0,1,54,84
14888,10,63,31,0,0,0,0,78,109
53907,10,63,20,1,0,0,0,71,92
95642,10,63,43,0,0,0,0,137,180
105052,8,812,60,4,0,0,0,79,143
156494,10,172,1,0,0,0,0,18,19
27739,10,172,3,0,0,0,0,24,27
75219,5,225,171,3,2,0,1,262,439
44120,9,374,65,1,1,0,0,90,157
82066,9,589,179,4,2,0,1,206,392
82733,9,306,106,0,0,0,0,224,330
19503,7,24,4,0,0,0,0,4,8
123705,7,521,128,2,1,1,1,189,322
42451,7,587,323,6,5,0,4,503,841
24023,9,158,298,4,1,1,1,411,716
18950,9,158,88,2,0,0,0,154,244
1234,10,66,134,3,2,0,0,216,355
81457,7,824,30,0,0,0,0,45,75
141259,9,800,31,1,1,0,0,36,69
119991,9,800,67,1,3,0,1,78,150
151120,8,214,187,1,1,0,0,274,463
25827,6,103,19,0,0,0,0,40,59
27039,9,6,53,7,7,0,0,101,168
151841,9,4,6,0,1,0,0,13,20
68855,6,366,27,0,0,0,0,53,80
113502,9,4,12,0,1,0,0,13,26
59433,9,800,2,0,1,0,0,8,11
30025,7,521,56,1,1,0,0,83,141
74613,7,496,1,0,0,0,0,1,2
149289,7,492,12,0,0,0,0,10,22
57989,6,200,188,7,7,0,0,314,516
103863,4,725,56,2,0,0,1,104,163
127373,6,821,28,0,0,0,0,41,69
160416,4,725,15,0,0,0,0,21,36
132773,6,885,91,1,1,0,0,149,242
43767,10,256,92,0,1,0,1,149,243
158994,10,66,6,0,0,0,0,8,14
109235,10,66,14,0,0,0,0,23,37
163483,10,911,20,0,0,0,0,34,54
137133,9,158,70,2,2,0,0,115,189
10301,9,367,197,2,1,1,2,201,404
11412,8,124,101,0,0,0,0,189,290
38359,5,655,250,7,2,0,1,404,664
117825,8,124,18,0,0,0,0,29,47
63411,10,355,7,0,0,0,0,23,30
168562,10,898,4,0,1,0,0,6,11
83444,7,861,66,0,0,0,0,128,194
48292,10,355,11,0,0,0,0,19,30
143763,8,885,162,2,2,0,3,262,431
19096,9,607,133,2,1,1,1,210,348
56180,9,314,4,1,1,0,0,8,14
38971,9,909,4,1,0,0,0,9,14
79723,9,30,52,3,3,0,0,124,182
116067,9,202,59,2,1,0,0,102,164
169023,8,124,67,0,0,0,0,113,180
104492,7,748,25,0,0,0,0,67,92
144219,9,570,2,0,0,0,0,2,4
22468,6,209,9,0,0,0,0,14,23
83521,8,800,4,1,0,0,0,8,13
87969,9,374,77,3,1,0,1,98,180
8405,9,399,91,1,0,0,1,141,234
3831,9,341,4,0,0,0,0,7,11
24584,9,828,36,1,1,0,0,84,122
164066,9,341,120,2,1,0,1,186,310
29533,9,469,25,0,0,0,0,33,58
121372,10,355,9,0,0,0,0,9,18
99795,8,214,579,5,1,0,4,879,1468
87708,9,640,59,0,0,0,0,84,143
170202,8,623,64,0,0,0,0,94,158
169871,9,131,42,1,1,0,0,61,105
83642,9,684,2,0,0,0,0,2,4
133159,9,341,5,0,0,0,0,7,12
67736,9,874,10,0,0,0,0,13,23
110806,9,341,10,0,0,0,0,24,34
68047,9,245,2,0,0,0,0,4,6
116104,9,575,40,4,0,0,0,54,98
103278,8,489,190,2,0,0,0,324,516
90780,4,678,1,0,0,0,0,1,2
107241,9,399,86,2,1,0,0,119,208
112494,9,399,4,0,0,0,0,6,10
120605,7,741,314,6,3,0,1,463,787
128733,5,176,41,0,1,0,0,43,85
52675,11,812,9,0,0,0,0,12,21
5406,4,923,12,0,0,0,0,13,25
168275,4,678,49,1,2,0,0,74,126
152509,4,923,47,1,1,0,0,30,79
129059,7,157,11,0,0,0,0,21,32
32865,8,214,607,10,4,0,3,939,1563
119124,5,293,4,0,0,0,0,8,12
66045,9,202,496,19,7,0,1,788,1311
67340,7,587,88,3,3,1,0,119,214
48336,7,521,26,1,1,0,0,38,66
105177,7,669,4,0,0,0,0,6,10
163886,7,295,4,0,0,0,0,5,9
56523,7,391,22,0,0,0,0,31,53
74899,7,126,7,0,0,0,0,12,19
93229,8,885,14,0,0,0,0,18,32
152857,7,492,2,0,0,0,0,3,5
163797,5,821,32,1,1,0,1,49,84
135737,7,211,2,0,0,0,0,3,5
68127,6,427,98,3,2,0,0,145,248
83525,6,827,34,0,0,0,0,55,89
87934,4,752,29,0,0,0,0,36,65
17324,4,375,19,0,0,0,0,34,53
115603,9,117,40,1,0,0,1,50,92
90807,6,124,12,0,0,0,0,13,25
49774,7,496,11,0,0,0,0,14,25
144363,9,117,5,0,0,0,0,7,12
65121,9,243,9,0,0,0,0,8,17
4336,9,570,501,0,0,0,2,836,1339
170113,9,535,8,0,0,0,0,11,19
95004,9,243,11,0,0,0,0,10,21
78824,9,243,71,1,1,0,0,118,191
94284,9,302,10,1,0,0,0,20,31
2190,4,212,2,0,0,0,0,3,5
53789,4,800,19,0,0,0,0,31,50
167466,5,381,91,1,0,0,0,115,207
56145,8,801,86,2,1,0,0,125,214
52494,4,200,74,0,0,0,0,104,178
2515,7,658,22,0,0,0,0,34,56
75177,9,374,62,1,0,1,0,97,161
88771,9,306,132,0,0,0,1,285,418
117634,9,306,155,0,0,0,0,325,480
40997,5,200,64,0,0,0,0,74,138
158305,5,200,33,0,0,0,0,33,66
49947,8,214,43,0,0,0,1,66,110
150543,9,842,34,0,0,0,0,64,98
104770,8,214,134,5,1,0,0,217,357
1748,9,842,58,0,1,0,0,145,204
73904,9,489,89,1,0,0,0,119,209
84285,7,861,3,0,0,0,0,12,15
10747,7,861,51,0,0,0,0,51,102
163517,8,124,38,0,0,0,0,62,100
167619,10,555,99,0,0,0,0,170,269
126939,10,355,2,0,0,0,0,2,4
61514,10,743,3,0,0,0,0,32,35
164316,10,66,10,0,0,0,0,20,30
58432,9,693,2,0,0,0,0,9,11
90417,6,885,65,1,1,0,0,105,172
38373,4,581,3,0,0,0,0,8,11
119039,10,743,6,0,0,0,0,15,21
39407,10,743,10,0,0,0,0,15,25
74636,11,214,146,12,0,0,0,146,304
74969,11,214,2,0,0,0,0,2,4
168461,6,269,8,0,0,0,0,6,14
47702,7,589,69,1,1,0,0,111,182
62814,9,353,68,1,2,0,0,116,187
77682,10,474,36,0,0,0,1,51,88
403,10,903,20,0,0,0,1,32,53
49899,8,124,102,0,0,0,0,149,251
136559,9,175,9,0,0,0,0,23,32
95357,10,66,1398,13,6,1,15,1931,3364
66150,9,575,111,6,1,0,1,185,304
107125,9,353,10,0,0,0,0,12,22
89258,6,251,4,0,0,0,0,7,11
71205,7,741,433,3,4,0,2,591,1033
21332,9,630,147,1,1,0,0,245,394
122084,9,575,8,0,0,0,0,14,22
132953,9,575,41,0,0,0,0,66,107
25821,9,589,151,2,1,0,0,217,371
135667,9,589,6,0,0,0,0,9,15
63193,9,589,3,0,0,0,0,5,8
106881,9,589,14,0,0,0,0,22,36
87930,4,174,20,0,0,0,0,27,47
148046,9,380,23,1,1,0,0,45,70
77972,9,380,11,0,0,0,0,12,23
92719,8,214,81,3,1,0,0,235,320
170856,7,575,9,0,0,0,0,16,25
58776,7,575,12,3,0,0,0,10,25
139836,4,453,2,0,0,0,0,2,4
10024,7,207,41,0,0,0,0,65,106
118792,8,658,123,6,1,0,2,168,300
5989,8,622,174,2,1,1,0,265,443
48529,4,200,2,0,0,0,0,2,4
106396,10,841,34,0,0,0,0,64,98
136433,10,797,95,1,1,0,1,176,274
136598,9,597,81,4,2,1,0,130,218
16817,9,640,33,2,1,0,0,51,87
98545,9,158,380,15,4,1,6,645,1051
154304,9,158,80,2,0,0,0,162,244
39434,9,842,422,11,6,2,0,646,1087
16696,9,203,37,2,1,0,0,67,107
108348,6,78,104,1,2,0,0,122,229
115144,9,302,56,0,0,0,1,138,195
108489,9,302,2,0,0,0,0,4,6
43211,9,302,13,1,0,0,0,25,39
106434,9,302,2,0,0,0,0,4,6
155374,8,214,375,1,1,0,3,620,1000
122694,10,63,21,0,0,0,0,37,58
127434,7,74,12,0,0,0,0,36,48
161211,9,302,55,1,1,0,0,89,146
134839,10,692,109,0,0,0,0,166,275
160719,9,302,5,0,0,0,0,14,19
38718,9,302,8,0,0,0,0,13,21
118419,9,302,4,0,0,0,0,11,15
171184,9,302,61,1,1,0,0,94,157
42877,9,302,4,0,0,0,0,8,12
79977,7,484,10,1,1,0,1,16,29
31013,10,841,143,1,1,0,0,186,331
137070,6,232,16,0,0,0,0,24,40
54632,9,693,23,0,0,0,0,68,91
77637,8,800,101,6,3,0,0,171,281
72486,7,861,18,0,0,0,0,27,45
65778,7,611,2,0,0,0,0,3,5
93775,4,115,31,0,0,0,0,42,73
152727,10,807,8,0,0,0,0,29,37
128638,10,807,5,0,0,0,0,37,42
12018,10,743,6,0,0,0,0,15,21
147587,10,743,0,0,0,0,0,4,4
44392,10,289,20,1,1,0,0,28,50
162520,10,66,10,0,0,0,0,7,17
96277,5,200,14,0,1,0,0,21,36
51986,7,578,18,2,0,0,0,33,53
45574,9,100,14,0,0,0,0,20,34
30601,9,545,4,0,0,0,0,6,10
68315,9,243,27,0,0,0,0,43,70
135378,9,374,29,0,0,9,0,45,83
45287,7,175,11,0,0,0,0,26,37
18451,9,657,119,0,0,0,1,215,335
29739,9,640,18,1,1,0,0,21,41
82759,10,914,0,0,0,1,0,138,139
85249,8,766,130,2,1,0,1,200,334
81287,8,214,855,26,10,2,3,1473,2369
3217,7,489,31,0,0,0,0,44,75
163168,8,623,86,0,0,0,0,116,202
135639,6,453,2,0,0,0,0,3,5
6887,6,51,118,6,2,1,0,196,323
135789,8,623,148,0,0,0,0,206,354
113077,9,158,50,8,0,0,0,109,167
3393,9,457,1,0,0,0,0,2,3
169227,9,483,21,1,0,0,0,42,64
44557,9,374,24,0,0,0,0,49,73
88620,9,842,9,0,0,0,0,7,16
144679,7,713,21,0,0,0,0,33,54
74436,5,58,56,0,0,0,1,92,149
66010,8,214,29,0,0,0,0,43,72
60963,7,521,116,1,0,0,2,188,307
46585,6,235,7,1,0,0,0,9,17
151124,10,200,47,0,0,0,0,83,130
133036,9,842,58,2,1,0,0,113,174
127993,9,842,18,0,0,0,0,30,48
114921,9,741,21,0,0,0,0,43,64
93997,9,842,15,0,0,0,0,21,36
49833,7,713,43,0,0,0,0,110,153
7708,7,367,41,1,1,0,1,76,120
60217,5,306,1,0,0,0,0,1,2
94935,8,214,2,0,0,0,0,3,5
108077,7,660,7,0,0,0,0,11,18
54841,5,489,59,0,0,0,0,86,145
36473,9,535,4,0,0,0,0,6,10
138474,7,163,15,1,1,0,0,28,45
50686,8,812,119,2,0,0,1,191,313
92040,4,519,308,5,1,0,1,574,889
85790,8,812,27,2,0,0,0,52,81
15106,8,693,1019,22,3,3,5,1658,2710
79612,6,124,32,0,0,0,0,43,75
53331,9,380,2,0,0,0,0,7,9
1980,10,628,9,0,0,0,0,20,29
19918,10,790,65,1,2,0,0,172,240
39721,8,214,630,15,6,0,3,1042,1696
97290,9,640,194,8,2,0,2,350,556
126500,9,640,13,0,0,0,0,21,34
105551,5,773,47,1,1,0,0,75,124
48609,5,306,110,0,0,0,1,151,262
89763,8,427,27,0,0,0,0,32,59
140995,5,200,16,0,0,0,0,17,33
4505,7,496,173,4,4,0,1,304,486
39166,10,104,12,0,0,0,0,4,16
40588,4,923,48,2,2,0,0,63,115
206,8,812,263,10,5,0,2,459,739
161240,5,159,66,1,0,0,0,110,177
87092,9,489,119,5,4,0,1,164,293
84044,11,306,133,7,0,0,0,156,296
49246,7,587,286,11,5,1,0,457,760
7856,10,807,19,1,1,0,0,75,96
139603,10,807,23,1,0,1,0,68,93
161880,7,641,159,1,1,0,0,228,389
33263,8,800,47,0,0,0,2,84,133
20752,8,800,49,1,0,0,0,88,138
122035,7,157,142,3,1,0,0,192,338
9683,10,322,14,0,0,0,0,24,38
13384,10,322,14,0,0,0,0,19,33
128305,7,175,38,1,0,1,0,78,118
22953,6,901,93,7,1,0,1,132,234
147069,9,630,387,0,0,0,3,649,1039
15084,9,131,68,0,0,0,0,64,132
9936,11,214,24,0,0,0,0,35,59
39993,9,6,4,0,0,0,0,4,8
60300,9,89,22,0,0,0,0,24,46
119206,10,807,1,0,0,0,0,2,3
158099,11,214,23,0,0,0,0,36,59
158073,6,200,99,0,0,0,2,139,240
133617,7,521,33,0,0,0,0,56,89
170162,4,174,82,3,3,0,1,122,211
110662,9,719,5,0,0,0,0,4,9
120490,9,622,11,0,0,0,0,12,23
98583,9,158,6,0,0,0,0,10,16
70117,9,492,2,0,0,0,0,2,4
110231,8,812,32,0,0,0,0,52,84
86013,6,263,30,0,0,0,0,47,77
91615,9,151,6,0,0,0,0,5,11
19045,10,289,3,0,0,0,0,3,6
111052,8,800,27,0,0,0,0,36,63
149028,11,214,9,2,0,0,0,13,24
33787,7,429,5,0,0,0,0,14,19
27135,9,489,32,4,0,0,1,62,99
25324,8,306,6,0,0,0,0,8,14
86072,6,800,8,0,0,0,0,19,27
148624,10,831,30,0,0,0,0,29,59
18829,10,917,9,0,0,0,0,26,35
116059,10,917,14,2,1,0,0,26,43
40404,9,741,121,4,2,0,1,220,348
139831,11,124,18,0,0,0,0,19,37
57867,6,59,86,1,1,0,0,147,235
138064,10,790,25,1,0,0,0,74,100
165281,10,790,19,1,1,0,0,52,73
55064,9,640,117,0,0,0,0,197,314
59849,8,658,193,6,3,0,0,406,608
124267,10,36,31,0,0,0,0,64,95
133370,6,366,51,1,0,0,1,67,120
58934,9,607,295,8,5,1,2,426,737
131598,6,366,102,2,1,0,2,231,338
62099,4,375,131,0,0,0,1,252,384
39736,10,797,23,0,0,0,0,39,62
59143,11,812,7,0,0,0,0,0,7
43253,7,462,2,0,0,0,0,2,4
160544,11,489,2,0,0,0,0,1,3
55282,9,535,2,0,1,0,0,4,7
48425,7,24,2,0,0,0,0,3,5
86179,4,885,8,0,0,0,0,7,15
14838,9,157,64,0,1,0,1,116,182
49953,8,214,28,0,0,0,1,37,66
77806,9,302,66,1,0,0,0,122,189
106389,9,489,6,1,1,0,0,11,19
24831,8,306,76,0,0,0,1,118,195
122561,5,444,12,0,0,0,0,13,25
165407,7,157,9,0,0,0,0,14,23
126760,9,483,14,1,0,0,0,28,43
6318,9,909,51,3,2,0,0,92,148
157201,9,145,14,1,0,0,0,39,54
128941,9,145,0,0,0,0,0,4,4
129302,9,145,4,0,0,0,0,17,21
46060,9,145,10,1,0,0,0,47,58
56526,9,374,6,0,0,0,0,17,23
97569,9,145,25,1,0,0,0,99,125
114829,4,200,44,0,0,0,0,53,97
53625,7,741,9,0,0,0,0,12,21
157237,7,741,10,0,0,0,0,16,26
11658,9,693,133,0,0,0,4,191,328
151206,9,570,82,0,0,0,1,170,253
144763,9,693,18,0,0,0,1,49,68
76446,9,693,1,0,0,0,0,1,2
103136,9,693,2,0,0,0,0,1,3
61068,9,589,8,0,0,0,0,21,29
109897,5,218,61,0,0,0,0,83,144
52662,10,63,14,0,0,0,0,25,39
75456,9,909,33,0,0,0,0,47,80
162782,5,200,133,0,0,0,2,202,337
2815,6,453,5,0,0,0,0,15,20
7677,6,232,63,1,1,0,0,86,151
87213,5,176,29,0,0,0,0,47,76
55137,5,366,25,0,0,0,0,39,64
70369,7,254,51,1,0,0,0,70,122
101099,5,366,32,0,0,0,0,46,78
18508,6,366,19,0,1,0,0,26,46
156307,8,214,38,0,0,0,0,81,119
71544,9,315,2,1,0,0,0,2,5
140043,9,538,54,0,0,0,0,82,136
88327,4,115,66,0,0,0,0,100,166
64306,5,225,197,2,3,0,1,278,481
8893,6,821,181,5,4,0,1,280,471
119754,9,367,20,0,0,0,0,34,54
129913,8,403,22,0,0,0,0,17,39
67688,9,367,292,10,6,1,1,505,815
161377,9,367,130,3,4,0,0,217,354
54575,9,367,1,0,0,0,0,1,2
21842,5,355,24,0,0,0,0,40,64
10207,9,367,19,0,0,0,0,28,47
27208,6,821,67,0,0,0,2,98,167
70496,4,923,33,0,1,0,0,58,92
134821,9,640,82,2,2,0,0,107,193
36143,9,631,105,5,2,1,3,157,273
78254,9,315,369,10,5,0,2,606,992
161935,6,232,38,1,1,1,0,64,105
157184,9,100,135,9,2,1,2,266,415
14344,4,800,2,0,0,0,0,3,5
135178,4,159,3,0,0,0,0,3,6
42852,9,100,30,0,0,0,0,58,88
90305,7,535,36,1,1,0,0,71,109
143365,9,100,10,0,0,0,0,19,29
65618,10,820,115,3,0,0,0,143,261
23105,9,100,8,1,0,0,0,28,37
73888,9,302,34,0,0,0,1,42,77
48247,9,813,61,8,2,0,0,108,179
133222,9,909,31,0,1,0,0,58,90
6971,7,587,17,0,0,0,0,21,38
75728,7,909,47,2,1,0,1,87,138
154082,9,575,110,2,2,0,1,268,383
112729,9,78,74,1,1,0,0,94,170
42666,4,174,4,0,0,0,0,5,9
87597,9,570,114,0,0,0,1,278,393
45161,7,374,2,0,0,0,0,2,4
107951,9,374,1,0,0,0,0,3,4
138091,8,306,24,0,0,0,0,27,51
168376,7,641,16,0,0,0,0,18,34
169924,7,748,12,0,0,0,0,39,51
1950,9,216,24,0,0,0,1,40,65
72032,9,456,1,0,0,0,0,1,2
48201,8,489,1,0,0,0,0,0,1
59271,9,684,2,0,0,0,0,2,4
84155,5,306,152,1,3,0,0,222,378
165182,7,748,93,4,2,0,1,162,262
161853,10,917,8,0,0,0,0,16,24
79271,8,800,72,0,0,0,1,99,172
158391,10,111,48,0,0,0,0,27,75
104617,10,111,16,0,0,0,0,26,42
98201,7,489,36,0,0,0,1,53,90
58655,10,111,14,1,0,0,0,21,36
84604,10,111,6,0,0,0,0,11,17
132653,8,124,70,0,0,0,0,90,160
89759,10,111,13,0,0,0,0,21,34
163444,7,429,16,0,2,0,1,23,42
91151,7,429,0,0,0,0,0,9,9
104724,5,159,11,0,0,0,0,23,34
149702,10,111,14,0,0,0,0,28,42
22998,8,623,227,0,0,0,1,466,694
84008,10,111,12,0,0,0,0,9,21
115473,10,111,12,0,0,0,0,9,21
35259,10,519,60,1,1,0,2,123,187
1241,10,111,5,1,0,0,0,25,31
145264,10,111,24,0,0,0,0,28,52
124572,8,812,72,5,4,0,0,106,187
42211,10,111,35,0,0,0,1,58,94
90706,9,589,65,1,1,0,0,98,165
53981,4,159,3,0,0,0,0,0,3
37177,4,159,5,0,0,0,0,3,8
27179,10,111,6,0,0,0,0,15,21
168396,10,111,2,0,0,0,0,4,6
58274,11,244,18,1,0,0,0,28,47
138334,7,100,51,0,0,0,0,95,146
124565,9,483,3,0,0,0,0,6,9
20122,11,545,1,0,0,0,0,2,3
169362,10,111,13,0,0,0,0,23,36
77963,10,798,9,0,0,0,0,12,21
22508,4,115,14,0,0,0,0,19,33
161244,5,124,72,3,0,0,2,126,203
123488,9,631,16,0,0,0,0,26,42
80250,9,489,13,0,0,0,0,21,34
96602,7,660,6,2,1,0,0,16,25
112075,9,314,45,0,0,0,0,43,88
75702,9,483,2,0,0,0,0,3,5
170378,4,188,6,0,0,0,0,6,12
149010,9,575,61,0,1,0,0,119,181
109856,9,630,14,0,0,0,0,22,36
120679,9,909,34,0,0,0,0,43,77
163682,9,570,18,0,0,0,0,34,52
24982,9,489,84,1,1,0,1,126,213
139340,4,800,54,0,0,0,0,80,134
152277,8,800,37,0,0,0,0,63,100
89729,9,589,61,0,0,0,0,111,172
93534,4,885,2,0,0,0,0,3,5
136879,4,200,38,0,0,0,0,59,97
79240,5,159,18,0,0,0,0,27,45
22078,8,484,207,0,0,0,0,239,446
50648,6,78,9,0,0,0,0,10,19
68071,7,611,2,0,0,0,0,2,4
48728,7,295,4,0,0,0,0,9,13
133913,9,873,60,3,1,0,0,89,153
111866,7,100,584,14,8,1,0,1065,1672
152879,9,8,52,1,0,0,0,90,143
37192,9,632,28,0,0,0,0,52,80
2433,5,238,10,0,0,0,0,13,23
4906,9,632,12,0,0,0,0,24,36
131737,10,790,30,0,0,0,0,83,113
46027,7,648,18,0,0,0,0,138,156
62782,9,131,16,0,0,0,1,16,33
55237,9,107,41,1,0,1,0,51,94
85554,10,692,165,5,1,0,1,274,446
57914,4,36,56,0,0,0,0,91,147
84449,9,131,17,0,0,0,1,22,40
161256,9,131,16,1,0,0,0,38,55
82462,11,214,22,0,0,0,0,24,46
164335,9,483,2,0,0,0,0,2,4
14328,6,221,42,0,0,0,0,62,104
135513,8,209,5,0,0,0,0,6,11
83750,7,521,14,0,0,0,0,25,39
116877,7,521,83,1,1,0,0,113,198
91156,9,405,95,2,0,1,0,203,301
71682,10,81,52,0,0,0,0,80,132
165661,9,306,90,0,0,0,2,207,299
95945,7,552,189,1,0,0,1,266,457
30467,4,678,11,0,0,0,0,11,22
110332,7,232,11,0,0,0,0,16,27
57499,9,158,134,8,5,0,2,246,395
98804,8,812,103,1,0,0,2,168,274
21175,9,158,42,1,1,0,0,79,123
166183,10,29,6,0,0,0,0,10,16
73124,10,29,9,0,0,0,0,10,19
9765,8,214,153,0,0,0,1,218,372
59210,7,100,9,0,0,0,0,16,25
160483,5,489,2,0,0,0,0,5,7
39171,6,124,52,2,1,0,0,128,183
77803,9,469,75,1,1,0,0,114,191
55083,6,124,73,0,0,0,1,130,204
83147,9,469,17,1,0,1,0,38,57
125669,7,78,13,0,0,0,0,14,27
46256,9,658,1,0,0,0,0,2,3
22805,9,640,146,4,2,0,1,220,373
63405,4,800,12,0,0,0,0,16,28
111783,9,367,55,8,2,0,0,91,156
69681,5,263,45,0,0,0,0,55,100
138815,9,131,131,3,0,1,0,98,233
157350,10,617,1,0,0,0,0,0,1
164443,4,124,609,13,7,0,1,952,1582
5455,8,214,239,0,0,0,1,372,612
128864,5,200,5,0,0,0,0,12,17
7246,5,124,8,0,0,0,0,12,20
120517,10,820,1,0,0,0,0,12,13
148855,7,748,33,0,0,0,0,62,95
119119,9,472,22,0,0,0,0,29,51
57378,4,36,156,2,1,0,0,252,411
103741,7,484,40,0,1,0,1,57,99
129446,7,484,13,0,0,0,0,19,32
27027,7,216,118,0,0,0,0,192,310
89566,7,202,2,0,0,0,0,2,4
86660,7,693,93,2,1,0,0,125,221
106712,7,521,29,1,0,0,0,53,83
143944,9,374,10,0,0,0,1,38,49
135511,11,214,5,1,0,0,0,5,11
170279,4,174,26,0,1,0,0,42,69
95249,9,658,8,0,0,0,1,17,26
46183,4,159,12,0,0,0,0,25,37
95854,6,556,29,3,2,0,0,55,89
92549,4,270,51,0,0,0,0,63,114
94347,9,538,96,4,1,0,1,148,250
142880,10,917,36,3,0,1,0,81,121
61391,7,214,137,0,0,0,0,219,356
3054,10,576,16,0,0,0,0,27,43
49925,10,111,12,0,0,0,0,26,38
161582,7,842,104,5,3,0,2,185,299
18931,10,841,60,0,0,0,0,96,156
152245,9,556,2,0,0,0,0,3,5
157854,7,648,34,5,2,0,0,67,108
5868,9,367,22,0,0,0,0,47,69
11818,9,367,15,1,1,0,0,25,42
93084,7,367,30,2,0,1,0,47,80
8190,4,159,8,0,0,0,0,9,17
11972,10,413,2,2,1,0,0,9,14
84266,10,413,2,2,1,0,0,13,18
110612,10,798,1,0,0,0,0,2,3
116944,9,828,42,1,1,0,0,61,105
92439,9,78,285,8,3,0,1,597,894
133939,9,4,27,0,0,0,0,30,57
70392,9,4,26,2,2,0,0,26,56
168511,9,4,1,0,0,0,0,5,6
142982,9,4,10,0,0,0,0,9,19
17375,9,4,19,0,0,0,0,23,42
150696,9,314,5,0,0,0,0,10,15
148510,10,797,14,1,1,0,0,19,35
170622,9,100,25,0,0,0,0,36,61
22759,9,489,2,0,0,0,0,4,6
120560,9,489,96,3,2,1,1,174,277
30936,8,885,26,0,0,0,0,27,53
87629,5,232,13,2,1,0,1,18,35
96937,5,140,19,0,0,0,1,63,83
82999,7,74,68,2,3,0,1,135,209
144256,7,744,22,3,1,0,0,54,80
107823,7,61,134,5,2,1,0,151,293
30591,5,181,75,0,0,0,1,119,195
96038,5,200,33,0,0,0,0,50,83
53398,9,842,72,3,2,0,0,133,210
83790,10,820,7,0,0,0,0,17,24
68042,9,6,35,1,1,0,0,38,75
104663,9,6,3,0,0,0,0,7,10
129017,9,6,7,0,0,0,0,12,19
10239,8,489,17,0,0,0,0,30,47
107217,6,296,18,1,1,0,0,23,43
117350,6,800,13,0,0,0,0,23,36
97606,8,623,40,2,1,0,0,67,110
102057,5,570,7,0,0,0,0,8,15
168099,7,74,383,5,0,1,1,731,1121
50795,10,820,19,0,0,0,0,23,42
109694,10,820,3,0,0,0,0,7,10
108529,10,807,8,0,0,0,0,8,16
51139,6,537,4,0,0,0,0,4,8
140277,10,807,6,0,0,0,0,4,10
23150,4,159,53,0,0,0,0,87,140
38872,7,194,13,0,0,0,0,20,33
118793,7,194,5,0,0,0,0,15,20
127225,10,820,12,0,0,0,0,13,25
149948,10,820,33,0,0,0,0,46,79
83692,7,367,5,0,0,0,0,3,8
1225,9,842,3,0,0,0,0,4,7
96196,9,538,172,0,0,0,3,310,485
5441,4,800,56,0,0,0,0,93,149
67508,7,429,101,11,4,0,1,394,511
13626,5,479,59,1,0,0,0,84,144
123775,9,828,2,0,0,0,0,2,4
125846,9,828,6,0,0,0,0,9,15
25755,11,800,16,1,0,0,0,15,32
161444,6,263,7,0,0,0,0,14,21
134451,5,885,12,0,0,0,0,9,21
54449,11,800,81,6,0,0,0,95,182
86583,4,519,4,0,0,0,0,4,8
44606,5,106,9,0,0,0,0,7,16
29820,11,244,2,1,0,0,0,3,6
3998,9,693,14,0,0,0,0,31,45
117205,5,489,44,0,0,0,0,59,103
134259,9,575,28,0,0,0,0,31,59
12340,5,773,62,0,1,0,0,88,151
142155,9,469,40,4,2,0,0,111,157
89011,9,469,19,1,8,0,0,41,69
42761,10,743,14,0,0,0,0,18,32
131611,11,214,64,0,0,0,0,84,148
128511,9,374,16,1,0,0,2,31,50
168547,11,214,6,0,0,0,0,5,11
16843,10,701,1,0,0,0,0,0,1
131764,11,489,13,0,0,0,0,10,23
53089,6,124,17,0,0,0,1,40,58
69527,6,124,30,0,0,0,0,46,76
136679,11,885,2,2,0,0,0,2,6
144617,4,658,16,1,0,0,0,18,35
160115,9,800,6,0,0,0,0,32,38
88505,6,355,2,0,0,0,0,4,6
35222,4,200,14,0,0,0,0,18,32
141102,9,399,11,0,0,0,0,14,25
148671,9,216,102,4,1,1,0,153,261
94738,8,658,41,0,0,0,0,83,124
25448,8,623,131,0,0,0,1,192,324
23394,8,623,110,1,1,0,1,156,269
40579,10,289,28,0,0,0,0,42,70
85233,9,462,4,0,0,0,0,8,12
150964,9,714,5,0,0,0,0,7,12
135372,8,800,8,0,0,0,0,17,25
110979,5,306,246,3,2,0,1,334,586
23789,11,244,88,1,0,0,0,101,190
79566,9,379,179,7,2,0,0,230,418
79462,9,380,5,0,0,0,0,7,12
165901,9,741,13,0,0,0,0,13,26
43519,6,209,8,0,0,0,0,12,20
97613,5,355,110,3,2,0,0,150,265
111555,4,36,4,0,0,0,0,7,11
97252,8,812,76,1,0,0,0,120,197
152180,8,812,52,1,0,0,0,91,144
26541,8,812,180,17,2,0,3,333,535
23361,9,800,3,0,0,0,0,7,10
124648,9,302,46,0,0,0,0,62,108
47221,9,658,62,1,1,0,1,88,153
58630,9,640,54,5,1,0,0,94,154
137380,9,538,13,0,0,0,0,23,36
18480,5,381,68,1,1,0,0,109,179
31770,9,589,1,0,0,0,0,1,2
48588,9,589,36,2,1,0,0,58,97
103246,9,367,11,0,0,0,0,23,34
73874,10,628,203,0,0,0,0,303,506
1048,10,104,0,0,0,0,0,5,5
120199,7,824,6,0,0,0,0,8,14
63629,9,741,30,1,0,0,0,50,81
55490,10,256,5,0,0,0,0,9,14
53587,8,623,64,0,0,0,0,92,156
93822,10,917,24,0,0,0,0,37,61
11570,9,202,60,1,1,0,0,70,132
132860,4,658,34,0,0,0,0,71,105
123961,9,158,68,1,0,0,0,208,277
161267,9,8,14,0,0,0,0,18,32
120715,9,8,6,0,0,0,0,13,19
141075,4,375,40,0,0,0,0,80,120
85837,9,912,83,2,1,0,0,131,217
61555,4,124,3,0,0,0,0,2,5
22349,7,872,26,0,0,0,0,35,61
130919,7,496,16,0,0,0,0,16,32
135181,7,496,7,0,0,0,0,5,12
146909,7,496,92,0,0,0,0,142,234
5386,7,78,73,2,5,0,1,128,209
153278,9,489,18,1,1,0,0,36,56
91445,9,266,14,0,0,0,0,19,33
145573,11,812,4,0,0,0,0,3,7
134623,9,8,8,0,0,0,0,12,20
170261,7,315,8,1,0,0,0,21,30
28880,7,315,14,0,0,0,0,21,35
137413,9,630,33,0,0,0,0,54,87
133341,4,800,65,0,0,0,0,111,176
113251,8,214,203,1,1,0,0,298,503
147768,7,312,1,0,0,0,0,1,2
119483,7,312,11,0,0,0,0,23,34
29061,7,312,20,0,0,0,0,29,49
156013,7,312,7,0,0,0,0,6,13
104121,7,484,185,2,3,3,1,253,447
92586,7,737,8,0,0,0,0,15,23
160327,7,800,40,0,1,0,0,75,116
96503,7,56,24,1,1,0,0,44,70
98154,7,822,5,0,0,0,0,9,14
159974,7,484,1,0,0,0,0,4,5
55517,7,484,6,0,0,0,0,11,17
10116,7,822,22,0,0,0,0,35,57
70707,6,514,7,0,0,0,0,13,20
155152,5,479,54,0,0,0,0,77,131
152917,10,903,4,0,0,0,0,11,15
100474,9,405,2,0,0,0,0,4,6
30393,9,405,2,0,0,0,0,3,5
169574,8,124,0,1,0,0,0,0,1
133314,11,124,0,1,0,0,0,0,1
34036,11,124,0,1,0,0,0,0,1
118494,11,30,32,2,0,0,0,49,83
164118,7,157,6,1,0,0,0,6,13
8555,11,214,68,5,0,0,0,70,143
26893,8,800,6,0,0,0,0,7,13
94289,9,842,82,1,1,0,1,119,204
87250,9,469,47,2,0,0,0,70,119
61590,9,456,4,0,0,0,0,3,7
158545,10,903,2,0,0,0,0,4,6
42003,10,903,0,0,0,0,0,2,2
162909,10,903,3,0,0,0,0,5,8
27930,10,903,17,1,0,0,1,34,53
16261,10,903,2,0,0,0,0,10,12
149220,5,561,7,0,0,0,0,7,14
44835,8,403,15,0,0,0,0,21,36
16682,11,214,4,0,0,0,0,5,9
160011,4,375,2,0,0,0,0,3,5
148129,10,820,1,0,0,0,0,3,4
123957,9,489,112,5,4,0,1,165,287
124057,8,489,2,0,0,0,0,2,4
19385,6,402,7,0,0,0,0,28,35
111088,9,489,88,1,1,0,0,149,239
69509,7,74,16,0,0,0,0,39,55
59379,7,74,8,0,0,0,0,28,36
131294,5,479,54,0,0,0,0,89,143
135453,7,74,4,0,0,0,0,22,26
164933,10,781,60,0,0,0,0,85,145
108573,10,549,9,0,0,0,0,18,27
95526,9,710,167,4,2,1,2,257,433
75408,10,790,4,0,0,0,0,0,4
74263,10,66,7,0,0,0,0,10,17
106568,7,521,8,0,0,0,0,10,18
128942,7,521,32,0,0,0,0,49,81
126621,9,589,593,17,6,0,3,864,1483
159711,6,821,71,0,0,0,1,110,182
140357,10,743,8,0,0,0,0,7,15
5189,10,743,2,0,0,0,0,2,4
137138,7,748,30,0,0,0,0,32,62
141843,6,922,21,1,1,0,0,30,53
102191,10,549,8,0,0,0,0,6,14
24040,5,124,17,0,0,0,0,28,45
4901,8,623,79,0,0,0,2,115,196
150077,7,535,63,0,0,0,0,71,134
150669,6,106,36,0,0,0,0,86,122
110622,8,484,76,0,0,0,0,117,193
70658,10,81,2,0,0,0,0,0,2
20381,10,289,8,0,0,0,0,6,14
159254,10,81,2,0,0,0,0,0,2
81906,7,641,9,0,0,0,0,12,21
15004,7,641,23,0,0,0,1,46,70
45288,7,496,7,0,0,0,0,18,25
97138,7,563,5,0,0,0,0,5,10
36622,7,861,50,1,0,0,2,91,144
100473,10,66,22,0,0,0,1,34,57
55406,7,175,37,4,0,0,0,193,234
89988,5,159,27,0,0,0,0,46,73
40626,5,159,9,1,1,0,0,19,30
139779,5,159,21,0,0,0,0,33,54
130160,5,159,2,0,0,0,0,2,4
133988,4,174,26,0,0,0,0,55,81
101161,9,556,17,0,0,0,0,21,38
111243,8,658,15,0,0,0,0,26,41
91889,6,658,10,0,1,0,0,22,33
29104,10,797,20,0,0,0,0,38,58
48674,6,827,3,0,0,0,0,16,19
58357,8,545,19,0,0,0,0,30,49
26223,8,214,8,0,0,0,0,2,10
162074,9,4,20,0,0,0,0,30,50
171013,4,159,1,0,0,0,0,0,1
106616,4,159,135,2,1,0,3,229,370
169192,4,159,12,0,0,0,0,1,13
16329,4,188,25,0,0,0,0,29,54
92027,8,427,19,2,1,1,1,32,56
71134,9,483,6,0,1,0,0,13,20
169367,9,483,4,0,0,0,0,14,18
151767,5,479,56,0,0,0,0,59,115
121674,7,496,7,0,0,0,0,9,16
34757,10,355,63,3,3,0,1,77,147
125752,8,214,49,0,0,0,0,57,106
10040,4,658,52,0,0,0,1,81,134
158404,10,781,4,0,0,0,0,4,8
33450,8,214,17,0,0,0,0,20,37
166916,7,254,92,4,2,0,0,139,237
21844,9,6,6,0,0,0,0,5,11
98593,9,741,72,0,0,0,1,78,151
115516,9,117,11,0,0,0,0,16,27
21615,9,117,2,0,0,0,0,6,8
8177,6,140,23,1,0,1,0,50,75
83259,9,741,51,0,0,0,0,75,126
52730,9,828,2,0,0,0,0,3,5
102923,4,375,2,0,0,0,0,3,5
150130,9,216,282,4,1,0,1,410,698
163340,9,302,100,1,1,0,0,162,264
61493,9,741,28,0,0,0,0,47,75
52949,6,78,26,0,0,0,0,64,90
59048,7,587,144,7,2,0,1,221,375
168357,7,872,44,1,1,0,1,60,107
93587,7,263,1,0,0,0,0,2,3
16593,9,657,126,6,3,1,0,224,360
165927,5,893,7,0,0,0,0,10,17
10734,6,827,83,3,2,0,0,161,249
16504,6,827,15,0,0,0,0,30,45
46274,9,374,11,0,0,0,0,11,22
71960,10,799,126,1,0,0,0,216,343
103318,9,640,435,16,4,1,2,632,1090
95469,4,658,6,0,0,0,0,12,18
68204,9,489,26,0,0,0,0,33,59
171186,11,306,15,2,0,0,0,15,32
39818,8,812,43,0,0,0,0,74,117
55154,8,812,58,2,1,0,2,92,155
96430,6,885,28,0,0,0,0,48,76
30076,6,209,9,0,0,0,0,10,19
56074,7,194,12,0,0,0,0,13,25
100978,11,214,12,0,0,0,0,18,30
85550,7,552,40,2,1,0,2,72,117
82802,10,797,29,0,0,0,0,54,83
44786,5,263,13,0,0,0,0,22,35
89843,7,658,303,6,3,0,1,540,853
40628,9,589,23,0,0,0,0,34,57
1987,8,214,7,0,0,0,0,10,17
61647,5,489,203,3,1,1,0,297,505
10334,7,312,14,2,0,1,0,20,37
162790,7,312,2,0,0,0,0,4,6
102870,6,124,132,2,1,0,1,162,298
160141,4,159,4,0,0,0,0,6,10
170918,9,216,213,4,3,0,1,337,558
98494,7,312,2,0,0,0,0,3,5
130734,8,800,9,0,0,0,0,10,19
118654,6,514,7,0,0,0,0,11,18
23588,7,489,166,1,1,0,0,275,443
167324,8,214,14,0,0,0,0,13,27
64579,5,263,20,0,0,0,0,26,46
106056,5,263,49,0,0,0,1,70,120
169194,9,374,119,6,3,0,1,199,328
25013,9,589,28,0,0,0,0,46,74
13063,9,380,64,0,0,0,0,53,117
47594,6,453,8,0,0,0,0,5,13
95291,9,607,30,4,3,0,1,46,84
7321,9,607,42,4,3,0,0,72,121
39277,4,800,2,0,0,0,0,0,2
89849,10,111,35,0,1,0,0,51,87
161883,9,575,7,0,0,0,0,19,26
24907,9,405,53,0,0,0,0,81,134
78442,8,403,727,25,6,0,2,1295,2055
79744,9,405,5,0,0,2,0,5,12
67665,7,489,482,14,4,0,2,782,1284
77491,10,104,42,0,0,0,0,43,85
18813,8,214,16,0,0,0,0,46,62
106003,9,489,60,7,2,0,0,88,157
36868,5,200,17,0,0,0,0,25,42
60482,9,216,110,2,1,0,0,203,316
57068,8,489,4,0,0,0,0,3,7
130600,8,214,6,0,0,0,0,9,15
83534,10,355,6,0,0,0,0,12,18
137785,10,799,5,0,0,0,0,10,15
134576,10,63,67,0,0,0,0,131,198
51835,10,798,2,0,0,0,0,8,10
4576,9,607,75,0,0,0,0,105,180
114225,9,607,22,0,0,0,0,24,46
115690,9,487,15,0,0,0,0,21,36
114503,9,487,18,0,0,0,0,16,34
87236,7,489,3,0,0,0,0,3,6
118110,8,800,86,1,0,0,0,146,233
107687,5,821,23,0,0,0,0,36,59
53357,7,157,37,0,0,0,0,49,86
140736,7,669,34,0,0,0,0,62,96
15068,9,89,6,0,0,0,0,9,15
11632,7,587,81,1,1,0,0,111,194
47388,8,812,77,0,1,0,0,150,228
124722,4,200,25,0,0,0,0,41,66
153523,8,623,145,6,2,0,2,281,436
134992,6,729,7,0,0,0,0,10,17
24837,7,157,12,0,0,0,0,21,33
50728,4,923,11,0,0,0,0,21,32
30377,9,607,205,8,8,1,1,447,670
112272,7,157,52,1,1,0,0,80,134
168622,6,200,229,5,3,0,1,336,574
97482,6,489,4,0,0,0,0,4,8
145734,4,174,32,0,0,0,0,46,78
81316,7,570,204,4,0,0,0,263,471
55047,10,40,4,0,0,0,0,6,10
152627,8,124,26,0,0,0,1,26,53
59727,8,800,168,6,4,0,1,270,449
144302,9,78,43,0,0,0,0,76,119
116785,5,489,74,1,1,0,0,102,178
159505,9,483,1,0,0,0,0,4,5
92033,8,800,14,0,0,0,0,20,34
14021,8,885,2,0,0,0,0,4,6
63090,7,508,2,0,0,0,0,3,5
98518,8,885,14,0,0,0,0,18,32
120006,7,748,4,0,0,0,0,11,15
7629,7,492,2,1,0,0,0,2,5
105493,7,563,7,0,0,0,0,17,24
143064,7,508,82,5,2,0,0,161,250
31880,10,917,19,0,0,0,0,58,77
24363,10,917,41,2,2,0,0,79,124
16104,5,200,8,0,0,0,0,19,27
31697,9,30,3,0,0,0,0,3,6
118813,7,909,145,2,0,1,1,246,395
73742,7,909,62,1,0,0,0,84,147
113448,6,296,16,2,1,0,0,23,42
69741,4,890,100,2,2,0,0,153,257
84431,4,596,4,0,0,0,0,6,10
19593,10,798,4,0,0,0,0,9,13
77434,10,722,21,0,0,0,0,19,40
101242,10,722,7,0,0,0,0,10,17
79020,10,322,2,0,0,0,0,3,5
158472,10,790,17,1,1,0,0,28,47
50836,7,353,8,0,0,0,0,13,21
158434,7,748,7,0,0,0,0,9,16
121906,5,225,66,0,0,0,0,96,162
152019,7,254,121,13,2,0,0,168,304
51080,8,515,28,0,0,0,0,44,72
119630,9,353,32,1,1,0,0,34,68
34310,9,353,75,3,1,1,1,96,177
117189,8,562,227,1,1,0,2,395,626
77133,9,100,38,1,1,0,0,93,133
22220,4,453,1,0,0,0,0,0,1
66132,9,4,91,4,2,0,1,88,186
171008,9,85,25,1,1,0,0,31,58
100772,9,714,1,0,0,0,0,0,1
164037,9,4,28,1,1,0,0,38,68
133031,7,741,42,0,0,0,0,63,105
11888,9,6,10,3,0,0,0,15,28
80325,6,537,18,0,0,0,0,35,53
169517,5,225,87,5,2,0,1,134,229
14868,10,111,48,0,0,0,0,57,105
105426,9,640,45,3,2,0,0,63,113
82441,10,798,4,0,0,0,0,4,8
168041,10,798,2,0,0,0,0,3,5
124210,10,798,2,0,0,0,0,3,5
33960,4,658,59,0,0,0,1,104,164
99029,7,484,29,0,0,0,0,31,60
71838,5,78,26,0,0,0,0,40,66
143635,5,140,15,0,0,0,0,17,32
58526,5,140,11,0,0,0,0,13,24
80427,5,140,21,0,0,0,0,24,45
80991,8,800,69,0,0,0,0,121,190
119272,10,831,79,0,0,0,1,28,108
2754,7,521,44,0,0,0,0,67,111
87212,7,864,14,0,0,0,0,29,43
9052,7,367,108,4,1,0,1,209,323
28848,7,367,1,0,0,0,0,2,3
96026,6,296,7,0,0,0,0,7,14
2919,6,209,2,0,0,0,0,2,4
42071,6,453,3,0,0,0,0,4,7
90948,9,367,148,5,5,0,1,199,358
141445,9,367,16,3,2,0,0,38,59
69040,9,367,8,0,0,0,0,14,22
144934,7,254,15,0,0,0,0,19,34
91703,7,254,14,0,0,0,0,11,25
160620,7,542,10,0,0,0,0,12,22
13578,7,660,2,0,0,0,0,3,5
166293,7,254,70,3,1,0,0,109,183
80281,5,238,6,0,0,0,0,10,16
30815,7,508,7,1,1,0,0,13,22
20126,6,263,69,3,2,0,0,89,163
112546,8,812,28,0,0,0,0,40,68
137268,5,78,124,1,0,0,0,200,325
51496,7,157,6,0,0,0,0,15,21
161413,9,216,66,0,0,0,0,101,167
42966,9,315,1,0,0,0,0,2,3
110773,5,225,21,0,0,0,0,25,46
18009,7,254,71,1,1,0,0,103,176
164036,7,254,4,1,1,0,0,4,10
134138,4,453,3,0,0,0,0,2,5
120348,9,306,1,0,0,0,0,1,2
125527,6,601,16,0,0,0,0,18,34
168953,8,800,80,5,0,0,2,142,229
4423,7,710,2,0,0,0,0,3,5
37905,10,322,16,0,0,0,0,17,33
120061,9,909,14,0,0,0,0,17,31
30616,9,367,52,2,3,0,0,66,123
130162,9,54,3,0,0,0,0,5,8
129022,9,607,69,1,1,0,0,81,152
127563,9,489,28,2,0,0,0,28,58
47648,4,752,1,0,0,0,0,0,1
103155,10,752,31,1,0,0,0,55,87
157343,7,909,40,1,1,0,0,51,93
151904,7,601,5,0,0,0,0,11,16
41908,9,483,8,0,0,0,0,11,19
155359,10,66,1,0,0,0,0,2,3
131896,9,484,74,5,0,0,0,270,349
108634,7,216,63,1,0,0,0,83,147
84927,9,484,3,0,0,0,0,15,18
55447,11,30,159,8,0,0,0,160,327
165057,11,623,2,0,0,0,0,3,5
147629,7,741,74,2,3,0,0,142,221
140318,8,623,16,0,0,0,1,24,41
58248,9,6,213,8,3,1,0,332,557
38022,5,159,73,0,0,0,0,122,195
153431,9,6,6,1,1,0,0,26,34
33968,9,6,12,0,0,0,0,37,49
122102,9,6,8,0,0,0,0,18,26
4970,9,6,4,0,0,0,0,8,12
118327,9,706,18,0,0,0,0,28,46
46527,9,706,30,0,0,0,0,69,99
144951,9,203,31,2,1,0,0,62,96
16126,11,812,8,0,0,0,0,8,16
83458,7,492,1,0,0,0,0,6,7
117178,7,521,29,0,0,0,0,61,90
103363,4,752,140,3,1,0,0,218,362
114389,9,842,127,0,0,0,0,228,355
37940,5,783,29,0,0,0,0,46,75
170431,9,157,62,2,0,0,0,105,169
135869,9,657,127,4,2,0,0,282,415
5127,6,800,18,0,0,0,0,25,43
138470,9,640,11,0,0,0,0,19,30
65845,4,375,45,1,1,0,0,58,105
121158,9,570,20,0,0,0,0,33,53
120579,9,909,13,0,0,0,1,29,43
163810,10,200,181,4,1,0,1,293,480
97898,10,474,19,0,0,0,0,28,47
28873,10,208,36,0,0,0,0,45,81
72861,11,693,60,3,0,0,0,54,117
131601,10,208,12,0,0,0,0,21,33
81918,7,126,6,1,1,0,0,6,14
157647,9,607,30,1,1,0,0,69,101
58136,9,30,38,1,0,0,1,88,128
104412,9,607,332,5,1,1,3,471,813
163694,9,607,30,1,1,0,0,56,88
34400,6,251,4,0,0,0,0,6,10
81962,5,693,75,2,2,0,0,157,236
67706,8,812,48,1,1,0,0,60,110
80938,9,741,19,0,0,0,0,40,59
110888,9,86,67,1,1,0,2,120,191
136350,5,209,68,1,0,0,0,84,153
117136,10,40,28,0,0,0,0,56,84
134508,9,630,8,0,0,0,0,5,13
64597,4,675,35,0,0,0,1,50,86
38983,9,630,133,7,9,2,2,211,364
56549,4,885,8,0,0,0,0,12,20
164267,9,693,15,0,0,0,0,31,46
63592,9,469,15,0,0,0,0,19,34
168422,9,741,44,0,0,0,0,76,120
155323,4,596,81,0,0,0,0,96,177
165069,5,78,3,0,0,0,0,6,9
42252,9,301,81,2,0,1,0,132,216
92887,8,214,2,0,0,0,0,2,4
151357,4,453,2,0,0,0,0,5,7
131899,4,658,12,0,0,0,0,19,31
116631,9,535,18,0,0,0,0,18,36
148913,9,306,2,0,0,0,0,3,5
122866,9,157,2,0,0,0,0,3,5
9489,6,420,9,0,0,0,0,17,26
81328,7,30,9,0,0,0,0,10,19
107286,7,741,18,0,0,0,0,30,48
35492,9,885,26,0,0,0,0,46,72
168856,9,202,8,0,0,0,0,19,27
55433,9,4,12,0,0,0,0,24,36
122395,9,202,4,0,0,0,0,4,8
116931,9,367,55,0,0,0,0,102,157
144178,10,820,16,0,0,0,0,21,37
108436,5,124,30,0,0,0,0,57,87
123968,5,381,60,2,2,0,0,82,146
65822,8,214,444,6,5,1,2,715,1173
159815,8,812,54,0,0,0,0,84,138
37751,9,78,89,0,0,0,0,119,208
166793,9,607,29,1,1,0,0,40,71
64648,6,306,21,0,0,0,0,27,48
61078,9,607,115,10,4,0,0,204,333
151346,10,474,32,0,0,0,0,145,177
97832,4,658,1,0,0,0,0,0,1
152537,6,789,21,1,1,0,0,29,52
106735,6,789,27,1,1,0,0,42,71
66682,6,789,26,0,0,0,0,40,66
96739,6,789,21,0,0,0,0,32,53
152862,5,200,7,0,0,0,0,13,20
147105,9,367,146,8,1,0,0,223,378
141834,9,489,229,10,6,0,1,370,616
132730,9,630,7,0,0,0,0,8,15
9074,5,444,6,0,0,0,0,12,18
9266,9,630,20,0,0,0,0,26,46
157152,5,159,8,0,0,0,0,2,10
103919,5,159,4,0,0,0,0,0,4
21852,5,306,110,0,0,0,1,172,283
169881,7,427,31,0,0,0,0,33,64
161944,10,81,29,1,0,0,0,37,67
75691,9,538,38,1,1,0,1,53,94
166025,10,917,1,0,0,0,0,1,2
13996,9,483,6,0,0,0,0,4,10
158519,10,917,1,0,0,0,0,1,2
119680,6,200,29,0,0,0,0,45,74
163766,6,200,20,0,0,0,0,21,41
139531,6,200,83,0,0,0,0,131,214
3208,4,519,234,0,0,0,1,433,668
170490,5,489,53,0,0,0,0,69,122
90501,5,489,34,0,0,0,0,77,111
90926,6,518,95,4,3,0,0,186,288
105109,8,800,163,0,0,0,0,267,430
107485,7,611,160,3,1,0,0,202,366
167957,7,611,85,1,1,0,0,157,244
136434,7,611,95,0,0,0,0,128,223
140626,6,800,2,2,0,0,0,3,7
45461,7,563,2,0,0,0,0,4,6
12028,10,104,341,9,5,0,2,696,1053
120320,10,63,24,0,0,0,0,42,66
36515,7,741,67,2,1,0,1,121,192
115094,4,200,4,0,0,0,0,4,8
91152,5,118,141,1,2,0,1,266,411
130166,10,807,6,0,0,0,0,15,21
104899,7,157,4,0,0,0,0,5,9
49504,7,589,145,7,4,1,0,281,438
87840,10,752,2,0,0,0,0,3,5
6250,6,103,84,4,1,0,1,142,232
140168,9,800,132,8,3,0,3,192,338
30548,8,214,4,0,0,0,0,4,8
62666,6,885,11,0,0,0,0,10,21
104262,9,657,46,0,0,0,0,80,126
107578,8,403,108,4,1,0,0,212,325
30620,7,387,2,0,0,0,0,3,5
5808,7,535,20,0,0,0,0,29,49
89737,7,535,16,0,0,0,0,31,47
156840,7,535,66,1,1,0,0,109,177
38145,7,535,17,0,0,0,1,32,50
35751,6,78,34,0,0,0,0,34,68
161459,7,535,79,3,1,0,0,98,181
153815,7,535,64,1,0,0,0,81,146
106917,5,585,24,0,0,0,0,37,61
46045,9,597,3,0,0,0,0,5,8
17108,9,89,33,2,1,0,1,62,99
105701,9,828,8,1,1,0,0,15,25
37373,8,693,4,0,0,0,0,6,10
66663,7,175,44,1,2,0,0,54,101
42123,4,174,27,0,0,0,0,23,50
3745,7,214,7,0,0,0,0,16,23
49502,4,36,91,0,0,0,0,150,241
122199,9,640,146,5,4,0,4,253,412
124717,4,375,30,0,0,0,0,58,88
66437,5,124,6,0,0,0,0,8,14
57435,8,800,45,1,0,0,0,59,105
116908,8,214,170,1,0,0,1,332,504
74439,11,693,0,1,0,0,0,0,1
5094,10,790,9,0,0,0,0,34,43
119745,6,200,55,1,2,0,1,97,156
29456,7,100,252,14,8,1,0,430,705
109604,10,111,27,2,1,0,0,55,85
123102,7,216,34,0,0,0,0,41,75
59634,5,821,37,0,0,0,0,45,82
123649,4,36,2,0,0,0,0,3,5
96446,9,658,576,9,6,3,4,783,1381
143916,9,658,24,0,0,0,0,39,63
69376,8,545,15,0,0,0,0,21,36
21208,8,623,272,6,2,0,2,515,797
49245,8,489,329,0,0,0,2,473,804
2326,5,893,8,1,0,0,0,5,14
34890,7,601,40,1,0,10,0,56,107
14959,8,800,73,2,0,0,0,120,195
158729,11,885,5,0,0,0,0,2,7
112590,7,748,11,0,0,0,0,25,36
170116,7,748,8,0,0,0,0,9,17
29351,9,341,25,2,0,0,0,63,90
18023,5,140,28,0,0,0,0,43,71
65270,10,793,10,0,0,0,0,17,27
147212,9,489,28,0,0,0,0,35,63
54896,9,367,6,0,0,0,0,6,12
169550,10,807,9,0,0,0,0,26,35
155027,8,800,12,1,0,0,0,8,21
24528,7,552,56,1,1,0,1,93,152
94552,10,797,68,0,0,0,0,155,223
119389,4,923,5,0,0,0,0,5,10
62392,5,78,13,0,0,0,0,16,29
8127,4,752,5,0,0,0,0,11,16
127033,5,181,4,0,0,0,0,4,8
24864,8,214,3,0,0,0,0,5,8
10783,7,587,31,2,0,0,0,50,83
65892,9,741,192,0,0,0,1,493,686
55779,4,923,27,3,2,0,0,47,79
107325,4,923,20,0,0,0,0,29,49
150903,9,367,29,0,0,0,0,64,93
116129,7,484,27,3,3,0,0,42,75
132185,6,514,109,2,0,1,1,189,302
78291,5,238,4,0,0,0,0,4,8
165338,4,581,9,0,0,0,0,12,21
2128,9,6,3,0,0,0,0,2,5
162144,9,8,6,0,0,0,0,9,15
155200,7,658,166,4,0,2,1,336,509
70011,7,658,88,2,3,0,0,213,306
137898,9,819,9,0,0,0,0,15,24
87332,9,380,14,0,0,0,0,29,43
97604,4,375,157,6,2,0,0,242,407
3708,10,63,48,0,0,0,0,85,133
34041,7,24,146,5,3,1,0,224,379
70582,9,302,10,0,0,0,0,9,19
69844,9,302,49,1,0,0,0,49,99
105147,9,302,47,0,0,0,0,56,103
106928,9,95,17,0,0,0,0,65,82
56287,9,216,122,0,1,0,0,185,308
10898,9,216,91,1,1,0,1,167,261
88085,9,216,47,1,1,0,0,74,123
79432,9,95,3,0,0,0,0,5,8
129839,9,874,116,6,3,0,0,166,291
156148,10,322,1,0,0,0,0,2,3
92801,4,890,105,0,0,0,0,184,289
74153,9,216,459,15,3,0,2,683,1162
86585,9,489,87,0,0,0,1,121,209
15670,10,29,10,0,0,0,0,23,33
88245,9,77,51,1,1,0,0,69,122
45368,10,29,21,0,0,0,0,36,57
7679,10,29,32,0,0,0,0,60,92
114341,9,427,22,0,0,0,0,97,119
104674,8,124,54,0,0,0,1,89,144
33523,10,550,15,0,0,0,0,20,35
9444,10,40,31,0,0,0,0,49,80
107853,10,272,2,0,0,0,0,2,4
146370,6,124,37,0,0,0,0,57,94
137766,8,214,1,0,0,0,0,3,4
1598,9,302,2,0,0,0,0,0,2
58334,4,124,4,0,0,0,0,5,9
155831,4,800,2,0,0,0,0,2,4
90153,6,290,6,0,0,0,0,8,14
24727,11,812,4,0,0,0,0,4,8
141982,10,200,3,0,0,0,0,3,6
53367,7,56,15,4,1,0,0,27,47
19199,9,570,4,0,0,0,0,10,14
1146,9,570,3,0,0,0,0,7,10
101819,6,296,12,0,0,0,0,16,28
4345,7,56,21,0,1,0,0,38,60
124511,9,607,25,0,0,0,0,32,57
137835,9,607,9,0,0,0,0,18,27
34917,9,658,1,0,0,0,0,0,1
67134,9,575,65,2,2,0,0,78,147
70236,9,597,6,0,0,0,0,6,12
110822,9,597,4,0,0,0,0,7,11
82202,6,366,73,0,0,0,0,105,178
141567,6,368,54,0,0,0,0,88,142
54855,9,693,8,0,0,0,0,14,22
32559,9,538,8,0,0,0,0,15,23
79013,9,489,150,3,3,0,0,230,386
71415,9,243,11,0,0,0,0,17,28
132254,6,200,28,0,0,0,0,41,69
37403,7,822,52,1,1,0,0,95,149
129503,10,111,36,1,0,0,0,61,98
74010,9,630,14,0,0,0,0,14,28
12709,11,214,6,1,0,0,0,4,11
55712,6,827,43,0,0,0,0,83,126
125252,7,77,34,0,0,0,0,46,80
66766,7,77,17,0,0,0,0,27,44
147725,9,302,14,0,0,0,1,25,40
163369,8,545,104,0,0,0,0,147,251
23700,9,800,18,0,0,0,0,24,42
32798,9,483,4,0,0,0,0,4,8
4962,9,657,11,0,0,0,0,15,26
81282,10,200,2,0,0,0,0,3,5
27952,9,243,16,1,1,0,0,31,49
118604,6,174,300,3,1,1,3,513,821
64188,10,820,8,0,0,0,0,38,46
87941,9,800,8,0,0,0,1,16,25
125421,7,100,271,11,4,1,0,516,803
108598,10,820,28,4,0,0,0,35,67
41526,7,74,2,0,0,0,1,9,12
101870,10,820,6,0,0,0,0,6,12
28812,10,820,3,0,0,0,0,3,6
68830,9,622,6,0,0,0,0,14,20
37058,11,214,31,0,0,0,0,35,66
69790,9,117,38,0,0,0,0,52,90
107998,9,457,2,0,0,0,0,4,6
5209,7,693,15,1,1,0,0,35,52
112985,7,263,45,3,3,0,0,51,102
113220,7,693,19,0,0,0,0,35,54
39568,8,214,92,0,0,0,0,131,223
76756,7,669,47,0,0,0,0,72,119
13809,9,693,8,0,0,0,0,19,27
132964,9,589,64,0,0,0,0,86,150
22431,7,367,5,0,0,0,0,4,9
19768,9,607,32,0,0,0,0,37,69
116167,11,30,39,0,0,0,0,37,76
19740,5,200,8,0,0,0,0,12,20
91011,5,200,13,2,1,0,0,22,38
54049,6,103,20,0,0,0,0,28,48
40070,10,628,6,0,0,0,0,9,15
53917,9,117,63,1,1,0,0,112,177
78730,4,200,24,0,0,0,1,49,74
135507,10,474,75,1,1,0,1,114,192
129036,6,489,89,0,0,0,0,106,195
119519,9,800,18,1,1,0,0,36,56
7074,5,200,75,2,1,0,0,126,204
121348,7,508,2,0,0,0,0,3,5
49574,10,576,13,0,0,0,0,19,32
27483,9,607,80,3,1,0,0,111,195
113298,8,489,178,2,2,0,0,284,466
39428,10,903,2,0,0,0,0,3,5
94221,9,800,7,0,0,0,0,15,22
7556,9,800,34,1,1,0,1,51,88
52584,10,474,17,0,0,0,0,33,50
105237,7,100,9,0,0,0,0,31,40
23371,8,693,3,0,0,0,0,4,7
29524,9,630,9,0,0,0,0,24,33
109363,9,800,34,0,0,0,0,43,77
110582,10,474,35,5,1,0,0,53,94
68709,8,214,28,0,0,0,0,43,71
62182,9,800,16,0,0,0,0,22,38
123145,4,658,25,0,0,0,1,39,65
37583,10,474,35,1,1,0,0,52,89
78343,9,367,27,0,0,0,0,40,67
96811,9,800,12,1,1,0,0,21,35
43039,9,538,19,0,0,0,0,22,41
49402,9,489,19,0,0,0,0,54,73
4126,5,200,492,8,3,1,4,600,1108
50046,5,821,36,0,0,0,0,57,93
164665,5,821,7,0,0,0,0,9,16
162911,9,314,15,0,0,0,0,10,25
90766,5,783,83,1,1,0,0,162,247
82001,11,214,20,0,0,0,0,23,43
98408,4,800,52,1,0,0,1,77,131
6474,5,893,44,2,0,0,0,80,126
109703,9,828,6,0,0,0,0,6,12
112981,9,607,88,5,2,1,0,135,231
93421,5,821,6,0,0,0,0,6,12
43601,9,874,22,0,0,0,0,30,52
160116,11,545,22,0,0,0,0,35,57
28758,9,302,10,1,1,0,0,14,26
84452,5,381,126,1,1,0,0,150,278
161715,9,131,34,1,1,0,1,63,100
97234,9,704,17,0,0,0,0,26,43
38072,9,367,45,0,0,0,0,51,96
8335,5,78,185,9,3,0,2,278,477
65737,10,355,8,0,0,0,0,12,20
46092,6,269,51,0,0,0,0,72,123
157107,6,269,21,0,0,0,0,24,45
141737,8,800,48,0,0,0,0,89,137
111918,7,741,116,3,2,0,0,191,312
77796,7,741,42,0,0,0,0,75,117
124263,11,214,36,0,0,0,0,39,75
127700,5,453,16,0,1,0,0,28,45
2906,9,800,30,0,0,0,0,49,79
56160,9,800,6,0,0,0,0,12,18
158833,9,800,12,0,0,0,0,19,31
44160,10,322,12,0,0,0,0,12,24
92074,10,798,6,0,0,0,0,5,11
147778,7,496,87,0,0,0,1,123,211
138509,9,489,234,7,3,0,5,460,709
129481,7,744,91,2,2,0,0,86,181
152437,6,827,22,2,1,0,1,46,72
65621,9,64,4,0,0,0,0,7,11
22406,9,800,3,0,0,0,0,5,8
114304,9,560,47,2,0,0,0,78,127
31474,9,489,8,0,0,0,0,17,25
34224,10,66,1,0,0,0,0,0,1
88684,10,66,1,0,0,0,0,0,1
141731,11,693,15,1,0,0,0,14,30
147596,6,263,131,2,0,0,1,205,339
93149,10,66,5,0,0,0,0,7,12
35560,10,172,3,0,0,0,0,26,29
92476,9,800,25,1,0,0,0,32,58
114267,5,306,23,0,0,0,0,48,71
132350,6,58,46,1,2,0,1,79,129
113723,6,556,129,1,0,0,1,198,329
126088,6,209,47,3,2,0,1,83,136
148652,6,263,40,0,0,0,1,50,91
128592,7,228,88,3,2,0,1,194,288
128186,7,448,227,5,0,0,1,438,671
103352,7,232,19,0,0,0,0,27,46
47982,7,232,10,0,0,0,0,8,18
148852,6,209,37,0,0,0,0,39,76
127059,5,885,11,0,0,0,0,21,32
105501,7,157,6,0,0,0,0,11,17
74486,6,235,252,9,5,1,3,441,711
33160,9,462,11,0,0,0,1,21,33
69577,6,366,10,0,0,0,1,15,26
113441,9,100,2,0,0,0,0,4,6
10849,8,214,119,0,0,0,1,204,324
123111,6,296,1276,28,14,3,9,2027,3357
164467,6,103,33,0,0,0,0,41,74
90694,10,550,149,1,1,1,0,191,343
150785,11,677,14,1,0,0,0,21,36
130348,9,367,21,0,0,0,0,30,51
77531,9,302,177,0,0,0,3,240,420
84060,9,607,28,1,1,0,1,47,78
90394,9,589,39,0,0,0,0,54,93
68144,9,489,49,0,0,0,0,78,127
46562,7,226,27,0,1,0,0,61,89
55653,7,61,22,0,0,0,0,31,53
25807,7,175,40,0,0,1,0,64,105
160456,7,641,17,1,0,0,0,34,52
132446,7,641,65,1,1,0,0,116,183
91562,7,641,12,1,0,0,0,28,41
68030,10,917,14,0,1,0,0,17,32
37963,8,800,26,0,0,0,0,40,66
89508,10,256,23,0,0,0,0,35,58
54000,10,111,56,4,0,1,0,101,162
105330,10,523,3,0,0,0,0,5,8
145298,6,78,5,0,0,0,0,5,10
33555,10,81,47,1,1,0,0,93,142
7178,10,917,16,0,0,0,0,16,32
89343,7,448,36,2,0,0,1,61,100
165368,8,545,8,0,0,0,0,8,16
143914,9,489,166,5,2,1,1,217,392
26166,4,174,51,0,0,0,0,68,119
31788,4,174,51,0,0,0,0,59,110
27982,9,909,72,2,0,0,0,112,186
43273,11,214,9,0,0,0,0,8,17
162147,9,909,58,2,1,1,0,119,181
30018,7,149,21,0,0,0,0,31,52
167256,9,302,32,1,1,0,0,53,87
43162,9,302,23,0,0,0,0,97,120
115469,9,457,1,0,0,0,0,2,3
149296,9,452,4,0,0,0,0,6,10
101050,10,355,0,0,0,0,0,32,32
51094,10,355,0,0,0,0,0,48,48
91914,10,355,0,0,0,0,0,38,38
133411,9,86,7,0,0,0,0,13,20
54635,7,748,7,1,0,1,1,21,31
110923,9,469,7,0,0,0,0,12,19
122682,9,630,4,0,0,0,0,3,7
145811,9,145,32,1,1,0,0,70,104
122134,7,762,505,17,9,4,0,789,1324
46956,11,885,63,3,0,1,0,67,134
159256,8,489,153,0,0,0,1,320,474
100315,9,78,144,0,0,0,1,200,345
127274,9,684,2,0,0,0,0,2,4
34035,9,874,2,0,0,0,0,3,5
115269,10,743,14,0,0,0,0,29,43
121649,10,743,4,0,0,0,0,15,19
170729,10,743,0,0,0,0,0,18,18
19437,5,78,2,0,0,0,0,2,4
116029,6,251,6,0,0,0,0,5,11
71576,9,693,10,0,0,0,0,6,16
20504,9,341,166,3,2,0,1,377,549
101441,10,355,8,0,0,0,0,15,23
119169,9,429,33,0,0,0,0,40,73
77057,9,714,1,0,0,0,0,0,1
9231,9,714,1,0,0,0,0,0,1
50447,6,885,1,0,0,0,0,0,1
156390,9,556,4,0,0,0,0,8,12
120558,9,151,18,0,0,0,0,20,38
59925,9,374,24,0,0,0,0,34,58
150182,9,86,126,3,2,1,0,177,309
59523,7,163,1,0,0,0,0,7,8
122307,7,535,226,2,0,1,1,348,578
103181,7,163,0,0,0,0,0,3,3
170416,9,909,17,0,0,0,0,31,48
1951,9,741,53,0,0,0,0,94,147
30990,9,6,8,0,0,0,0,14,22
161868,9,909,170,8,2,1,1,302,484
62672,7,126,98,0,0,0,0,122,220
161519,5,366,3,0,0,0,0,2,5
49792,10,111,5,0,0,0,0,7,12
111881,4,124,2,0,0,0,0,5,7
146958,9,306,82,0,0,0,0,117,199
73476,7,535,119,9,4,0,0,272,404
57565,7,118,28,2,1,0,0,49,80
157364,7,484,12,0,0,0,0,18,30
113641,5,489,7,0,0,0,0,3,10
76328,9,570,116,0,0,0,0,283,399
78720,8,545,147,0,0,0,1,235,383
131162,8,545,19,0,0,0,1,36,56
630,10,549,6,0,0,0,0,4,10
67564,5,200,2,0,0,0,0,2,4
19316,9,800,74,2,1,0,1,117,195
138042,10,63,65,0,0,0,0,131,196
107437,5,124,8,0,0,0,0,12,20
146458,6,556,26,2,1,0,0,43,72
49429,9,570,38,0,0,0,0,55,93
109332,10,841,25,0,0,0,0,59,84
97128,6,232,101,3,1,0,0,159,264
139930,4,36,5,0,0,0,0,4,9
315,8,812,220,8,3,0,1,395,627
104336,8,812,88,1,1,0,0,188,278
49347,8,812,146,1,1,0,0,250,398
116893,8,885,22,0,0,0,0,26,48
109698,8,812,157,2,0,1,1,212,373
5152,10,200,18,0,0,0,0,24,42
148874,7,214,33,0,0,0,0,52,85
28893,6,785,105,5,3,2,1,197,313
15474,5,106,1,0,0,0,0,1,2
27288,9,556,3,0,0,0,0,5,8
152977,4,638,2,0,0,0,0,4,6
122836,5,59,2,0,0,0,0,4,6
90520,8,214,4,0,0,0,0,4,8
68085,4,752,49,0,0,0,0,82,131
80674,6,263,28,0,0,0,0,32,60
94631,7,551,159,1,1,0,0,261,422
4500,5,235,58,1,1,0,1,85,146
134513,11,30,9,2,0,0,0,7,18
56283,8,124,101,0,0,0,1,152,254
35611,8,812,126,5,4,0,1,228,364
68155,9,575,0,0,1,0,0,0,1
59092,9,405,24,0,0,0,0,36,60
105278,5,444,41,1,1,0,1,52,96
34494,7,741,14,0,0,0,0,16,30
56726,7,457,2,0,0,0,0,3,5
48543,7,310,5,0,0,0,0,6,11
121689,7,310,13,0,0,0,0,31,44
46951,7,310,5,0,0,0,0,13,18
132419,7,310,7,0,0,0,0,17,24
145962,7,310,3,0,0,0,0,10,13
81888,8,484,133,4,1,0,0,246,384
130140,9,315,33,0,0,0,1,54,88
107408,9,315,13,0,0,0,1,30,44
18072,6,366,9,0,0,0,0,14,23
77714,10,256,12,0,0,0,0,28,40
113720,10,256,1,0,0,0,0,2,3
62789,10,256,3,0,0,0,0,5,8
104534,10,256,37,0,0,0,0,41,78
41119,8,124,89,0,0,0,0,147,236
130977,9,483,59,2,1,0,0,127,189
151253,4,890,12,0,0,0,1,18,31
62940,11,306,9,1,0,0,0,7,17
16672,5,821,187,4,1,0,0,232,424
75791,9,842,100,0,0,0,0,168,268
98053,10,790,120,3,0,0,0,181,304
64562,7,587,57,0,0,0,0,104,161
117526,9,630,1,0,0,0,0,0,1
30349,9,630,2,0,0,0,0,1,3
8420,7,312,10,0,0,0,0,18,28
52095,5,489,24,0,0,1,0,29,54
138884,5,556,12,0,2,0,0,18,32
94256,6,556,34,0,0,0,0,70,104
28086,5,556,43,0,0,0,0,58,101
156779,10,22,19,0,1,0,0,18,38
144631,4,159,58,3,1,0,0,89,151
170054,4,159,44,1,0,0,0,81,126
127855,7,885,4,0,0,0,0,13,17
42388,7,885,6,0,0,0,0,8,14
70425,7,885,3,0,0,0,0,15,18
98169,7,669,2,0,1,0,0,4,7
14598,4,658,50,0,0,0,0,50,100
46451,5,200,39,1,1,0,0,86,127
13722,8,885,146,1,1,0,1,186,335
133536,7,496,6,0,0,0,0,16,22
151245,9,489,0,0,0,0,0,1,1
104077,10,817,4,0,0,0,0,4,8
95165,9,489,49,0,0,0,0,84,133
121931,4,159,8,0,0,0,0,17,25
169751,5,159,14,0,0,0,0,17,31
55909,7,484,2,0,0,0,0,3,5
107177,7,61,34,0,0,0,0,48,82
43113,7,484,20,0,0,0,0,45,65
66618,7,563,2,0,0,0,0,3,5
119384,7,484,16,0,0,0,0,22,38
152301,5,585,10,0,0,0,0,17,27
13464,6,124,57,4,1,0,0,82,144
102706,9,469,16,0,0,0,0,36,52
147885,10,917,58,1,1,0,0,82,142
27677,9,306,2,0,0,0,0,5,7
141654,10,841,34,0,0,0,0,80,114
58551,7,861,62,0,0,0,0,87,149
4957,9,538,151,1,1,0,1,316,470
72452,6,693,36,0,0,0,0,74,110
9018,9,560,4,0,0,0,0,4,8
89910,5,821,55,0,0,0,1,85,141
9407,8,812,23,0,0,0,0,38,61
61922,9,78,65,6,5,0,1,93,170
44777,10,550,22,0,0,0,0,28,50
79651,4,174,102,0,0,0,1,155,258
142478,10,289,8,0,0,0,0,0,8
124024,6,78,78,1,2,0,1,126,208
71813,6,800,14,0,0,0,0,6,20
108055,7,489,23,1,0,0,1,77,102
2690,8,812,23,0,0,0,1,35,59
88757,7,232,80,0,0,0,2,132,214
158824,7,79,32,0,0,1,0,56,89
132726,6,693,9,0,0,0,0,12,21
106356,11,693,79,4,0,0,0,84,167
80364,8,214,4,0,0,0,0,8,12
166363,10,289,16,0,0,0,0,12,28
133634,9,492,30,1,0,0,0,62,93
117567,9,607,99,2,2,1,0,142,246
44323,9,607,28,0,0,0,0,50,78
76265,4,800,80,0,0,0,0,119,199
124570,11,214,1,0,0,0,0,0,1
19735,9,570,83,0,0,0,0,227,310
103002,5,159,4,0,0,0,0,5,9
23877,5,78,193,2,1,0,0,288,484
1152,10,798,6,0,0,0,0,29,35
50580,10,322,1,0,0,0,0,1,2
64914,10,81,5,0,0,0,0,10,15
22174,10,66,13,2,2,0,0,46,63
118127,10,917,8,0,0,0,0,16,24
89404,9,367,107,0,0,0,0,131,238
35470,9,545,8,0,0,0,0,26,34
132166,9,545,5,0,0,0,0,8,13
22227,4,200,5,0,0,0,0,9,14
146091,9,741,59,0,0,0,0,82,141
151733,6,78,23,1,1,0,0,23,48
58989,5,200,219,5,3,0,1,305,533
54726,7,100,74,1,0,0,0,123,198
502,8,622,43,0,0,0,0,62,105
141320,6,693,30,0,0,0,0,52,82
77598,6,140,30,0,0,0,0,100,130
148182,5,140,23,1,0,0,0,36,60
29013,9,367,5,0,0,0,0,10,15
147303,9,367,14,0,0,0,0,37,51
138683,11,214,22,2,0,0,0,19,43
93044,7,194,21,0,0,0,0,21,42
121510,7,872,28,0,0,0,0,39,67
89619,7,630,6,0,0,0,0,8,14
30636,7,630,8,0,0,0,0,16,24
124160,9,657,110,0,0,0,1,220,331
171014,5,306,2,0,0,0,0,1,3
33581,9,630,35,0,0,0,0,49,84
157661,9,589,21,0,0,0,0,17,38
67443,9,175,56,2,2,0,0,113,173
53342,8,124,1,0,0,0,0,0,1
147480,11,214,9,0,0,0,0,8,17
145453,10,642,2,0,0,0,0,3,5
41789,10,29,18,0,0,0,0,16,34
150021,5,893,3,0,0,0,0,2,5
121730,10,29,40,0,0,0,0,80,120
159236,4,593,58,1,0,0,0,93,152
110544,9,842,6,0,0,0,0,12,18
126967,7,79,70,1,0,0,0,110,181
121235,6,78,94,0,0,0,1,142,237
27896,9,873,707,16,9,1,2,979,1714
14260,10,81,4,0,0,0,0,18,22
5776,9,656,0,0,0,0,0,35,35
49219,5,296,5,0,0,0,0,9,14
36738,10,617,1,0,0,0,0,1,2
40523,9,489,35,1,0,0,0,30,66
110234,6,693,59,3,3,0,0,88,153
64359,9,597,4,0,0,0,0,7,11
103474,7,118,8,0,0,0,0,12,20
135028,7,896,2,0,0,0,0,9,11
38656,9,489,44,0,0,0,0,54,98
67582,4,306,22,0,0,0,0,26,48
72477,9,489,37,0,0,0,1,52,90
62933,10,781,2,0,0,0,0,4,6
34499,10,781,37,0,1,0,1,62,101
49956,8,427,32,0,1,0,0,51,84
149956,10,781,2,0,0,0,0,3,5
134761,4,365,8,0,0,0,0,8,16
6111,10,781,4,0,0,0,0,11,15
122901,10,322,3,0,0,0,0,2,5
102341,9,489,33,0,0,0,0,54,87
83913,6,200,25,0,0,0,0,42,67
58785,10,111,9,0,0,0,0,27,36
49714,8,214,545,4,1,0,2,901,1453
85462,9,367,16,0,0,0,0,15,31
50457,9,302,40,0,0,0,0,62,102
45300,9,570,32,0,0,0,0,39,71
53812,9,353,1,0,0,0,0,2,3
113219,8,306,27,0,0,0,0,38,65
160258,5,453,15,4,1,1,0,37,58
150054,9,469,0,0,0,0,0,182,182
123888,9,375,6,0,0,0,0,9,15
94051,7,462,62,5,2,0,0,111,180
14798,6,821,41,1,0,0,0,69,111
141827,8,562,408,10,4,1,3,744,1170
8265,7,151,26,0,0,0,0,66,92
86614,6,140,32,1,1,0,0,54,88
121585,9,30,55,3,4,0,0,90,152
149314,5,124,35,2,2,0,0,51,90
146839,9,575,4,0,0,0,0,6,10
81311,5,821,3,0,0,0,0,3,6
127968,9,597,47,2,0,0,0,64,113
15152,9,597,5,0,0,0,0,5,10
98706,7,77,168,2,1,0,1,259,431
107829,9,538,8,0,0,0,0,13,21
120405,5,570,3,0,0,0,0,15,18
16304,6,59,4,0,0,0,0,2,6
85528,7,61,14,0,0,0,0,25,39
13992,7,61,9,0,0,0,0,12,21
33306,7,457,2,0,0,0,0,9,11
93692,11,214,2,0,0,0,0,2,4
40937,7,824,9,0,0,0,0,14,23
153409,7,149,16,0,0,0,0,27,43
29203,7,611,4,0,0,0,0,6,10
164507,7,157,9,0,0,0,0,10,19
96422,8,403,9,0,0,0,0,4,13
97856,7,864,29,1,1,0,0,41,72
83789,7,353,32,0,0,0,0,42,74
128214,9,374,12,1,1,0,0,19,33
45327,7,741,17,0,0,0,0,28,45
1097,9,607,22,1,1,0,1,48,73
166276,5,453,10,0,0,0,0,18,28
93542,6,235,10,0,0,0,0,15,25
136676,7,744,9,0,0,0,0,14,23
6089,9,873,28,0,0,0,0,38,66
85621,9,873,1,0,0,0,0,0,1
133450,9,873,3,0,0,0,0,4,7
164599,9,484,3,0,0,0,0,16,19
107103,10,355,0,0,0,0,0,81,81
1911,5,78,95,1,0,0,0,141,237
118031,9,873,183,2,2,1,2,315,505
108136,7,648,2,0,0,0,0,2,4
170680,9,842,35,1,1,0,0,53,90
78966,9,630,28,0,0,0,0,41,69
17318,9,374,1,0,0,0,0,3,4
6687,9,630,26,0,0,0,1,48,75
13113,11,812,17,0,0,0,0,14,31
103479,11,812,14,1,0,0,0,18,33
156382,10,36,5,0,0,0,0,6,11
63434,8,489,598,10,6,1,3,1005,1623
28694,8,489,9,0,0,0,0,2,11
97113,9,630,20,0,0,0,0,30,50
49907,10,820,5,0,0,0,0,3,8
18870,10,820,4,0,0,0,0,3,7
13614,10,820,4,0,0,0,0,3,7
103799,10,820,3,0,0,0,0,3,6
144205,6,200,191,6,5,1,2,289,494
124107,9,873,32,0,1,0,0,41,74
76588,7,587,8,0,0,0,0,5,13
95288,9,325,4,0,0,0,0,5,9
52292,9,325,2,0,0,0,0,2,4
157534,8,214,53,0,0,0,0,75,128
89979,9,842,90,1,1,0,1,150,243
123270,7,8,1,0,0,0,0,1,2
22581,8,489,1,0,0,0,0,0,1
70957,7,755,6,0,0,0,0,12,18
162145,9,489,136,10,2,0,1,222,371
137360,7,535,27,1,1,0,0,48,77
103826,9,483,1,0,0,0,0,2,3
131059,9,483,1,0,0,0,0,2,3
170043,11,545,25,1,0,0,0,23,49
56003,7,207,22,2,0,0,0,55,79
100957,9,80,102,2,0,1,0,171,276
37446,9,405,2,0,0,0,0,5,7
153253,9,306,70,0,0,0,0,119,189
118831,6,159,22,0,0,0,0,29,51
49851,7,589,15,0,0,0,0,27,42
86341,9,306,242,0,0,0,3,401,646
81382,7,641,52,0,0,0,0,76,128
22340,9,306,120,0,0,0,2,225,347
86102,9,306,44,0,0,0,0,89,133
76907,5,263,44,2,0,0,0,71,117
117439,9,570,21,0,0,0,0,67,88
76928,11,214,3,0,0,0,1,3,7
113580,9,570,51,0,0,0,0,113,164
131484,9,693,10,0,0,0,1,46,57
32401,9,693,21,0,0,0,0,58,79
122716,10,355,0,0,0,0,0,57,57
168192,9,589,20,0,0,0,0,11,31
153331,4,200,60,0,0,0,0,89,149
38621,9,538,42,1,1,0,1,56,101
159169,9,800,47,0,0,0,2,85,134
98951,9,380,4,3,2,0,2,7,18
38484,7,601,0,0,0,0,0,4,4
138125,9,100,57,1,1,0,0,79,138
25316,7,374,4,0,0,0,0,3,7
13843,8,801,111,5,2,0,2,184,304
151699,7,508,8,0,0,0,0,16,24
156327,9,819,41,0,0,3,0,59,103
53762,5,800,3,0,0,0,0,10,13
127595,4,174,40,0,0,0,1,61,102
37072,9,782,1,0,0,0,0,1,2
41246,10,820,22,0,0,0,0,22,44
78262,11,658,2,1,0,0,0,2,5
166142,10,820,2,0,0,0,0,15,17
25373,10,820,3,0,0,0,0,11,14
99483,10,820,0,0,0,0,0,8,8
40568,10,820,7,0,0,0,0,13,20
55067,10,820,25,1,1,0,0,32,59
72136,10,820,38,2,1,0,0,58,99
90911,10,111,31,0,0,0,0,73,104
155299,10,820,5,0,0,0,0,14,19
42784,10,550,10,0,0,0,0,25,35
119741,10,550,15,0,0,0,0,57,72
125637,6,785,24,0,0,0,0,45,69
73656,10,322,2,0,0,0,0,3,5
92759,6,785,51,1,0,0,0,125,177
60541,6,785,13,0,0,0,0,25,38
144329,7,79,29,0,0,0,0,51,80
153784,7,748,22,1,1,0,0,75,99
95075,7,748,42,6,0,0,0,102,150
47609,11,885,42,0,0,0,0,53,95
12913,9,367,50,2,1,0,1,87,141
94572,9,151,5,0,0,0,0,9,14
28553,9,367,13,0,0,0,0,19,32
52489,5,209,17,0,0,0,0,30,47
3250,9,4,25,3,1,1,0,51,81
35913,7,575,32,4,2,0,0,68,106
42680,7,126,4,0,0,0,0,5,9
167053,5,4,1,0,0,0,0,1,2
77283,9,800,8,0,0,0,0,13,21
74841,9,800,4,0,0,0,0,6,10
157929,9,800,4,0,0,0,0,8,12
164656,9,800,51,1,1,0,0,67,120
92403,7,126,35,5,1,0,1,73,115
87492,9,78,111,4,2,0,0,161,278
71738,7,228,22,2,1,0,0,46,71
133064,7,126,10,0,0,0,1,23,34
26022,8,658,49,0,0,0,0,61,110
130699,7,126,2,0,0,0,0,3,5
134833,7,126,3,0,0,0,0,7,10
62551,7,755,18,0,0,0,0,41,59
115580,9,800,19,1,1,0,0,30,51
36697,9,693,2,0,0,0,0,4,6
53238,5,489,38,1,0,0,0,59,98
26315,7,77,26,0,0,0,0,30,56
101414,7,310,15,0,0,0,0,39,54
14034,4,658,11,0,0,0,0,14,25
19917,4,658,2,0,0,0,0,6,8
96845,7,310,0,0,0,0,0,29,29
145747,7,310,2,0,0,0,0,19,21
108371,7,563,2,0,0,0,0,7,9
153573,7,46,34,1,1,0,1,39,76
26612,7,100,52,1,1,0,0,79,133
158922,7,175,9,0,0,0,0,12,21
48144,11,214,19,0,0,0,0,20,39
83295,8,545,52,0,0,0,0,90,142
62167,9,456,3,0,0,0,0,7,10
107164,9,456,80,0,0,1,0,158,239
165967,9,456,2,0,0,0,0,2,4
137019,9,456,2,0,0,0,0,2,4
111189,8,214,24,0,0,0,0,33,57
69058,7,373,131,1,1,0,1,213,347
109401,9,570,115,1,0,0,3,155,274
148737,7,77,52,0,0,0,0,96,148
154393,10,617,17,0,0,0,0,10,27
119201,5,118,2,0,0,0,0,3,5
108695,4,923,55,0,0,0,0,102,157
118120,6,232,16,0,0,0,0,26,42
14662,7,77,2,0,0,0,0,2,4
45192,7,77,41,1,0,0,0,71,113
65943,8,214,4,0,0,0,0,4,8
10752,7,77,24,1,1,0,0,49,75
66605,5,263,33,0,0,0,1,42,76
31227,9,570,46,1,0,0,0,69,116
41862,8,489,23,0,0,0,0,15,38
117702,7,496,8,0,0,0,0,15,23
130257,9,640,2,0,0,0,0,2,4
102403,8,214,588,2,0,0,2,900,1492
31927,6,132,6,0,0,0,0,8,14
111190,9,640,159,6,3,0,1,250,419
86337,9,607,4,0,0,0,0,7,11
23503,6,165,370,11,1,2,2,705,1091
4708,11,30,122,0,0,0,0,118,240
113010,9,657,5,0,0,0,0,13,18
52905,11,658,3,0,0,0,0,4,7
74807,7,175,21,0,0,0,0,42,63
123353,10,653,11,0,0,0,0,29,40
140014,9,630,1,0,0,0,0,0,1
6185,4,453,21,0,0,0,0,20,41
94768,5,693,32,0,0,0,0,36,68
17632,9,367,148,1,1,0,0,208,358
83569,10,917,1,0,0,0,0,1,2
51735,10,917,24,0,0,0,0,41,65
127194,10,917,24,3,0,1,0,52,80
30781,10,917,3,0,0,0,0,5,8
167927,10,917,2,0,0,0,0,19,21
67520,7,46,50,1,1,0,0,65,117
52084,8,658,78,1,0,0,0,135,214
107218,5,59,59,2,1,0,0,95,157
134697,4,923,1,0,0,0,0,1,2
16854,7,56,2,0,0,0,0,0,2
52605,9,607,130,4,1,1,0,144,280
144211,9,367,3,1,0,0,0,5,9
123382,11,885,106,1,0,0,0,124,231
46517,7,669,1,0,1,0,0,2,4
93111,7,669,0,0,1,0,0,0,1
50540,10,355,0,0,0,0,0,36,36
26204,5,773,3,0,0,0,0,7,10
95495,5,176,71,3,2,0,2,105,183
158944,9,630,15,0,0,0,0,17,32
18535,6,489,112,0,0,0,0,203,315
13694,9,597,2,0,0,0,0,2,4
170254,9,78,12,0,0,0,0,232,244
53761,9,100,6,2,1,0,0,6,15
89021,9,78,15,0,0,0,0,10,25
74664,7,741,52,1,1,0,0,87,141
104700,7,741,46,0,0,0,0,82,128
38755,8,214,223,11,4,0,0,335,573
12895,9,8,5,0,0,0,0,8,13
44471,9,367,197,6,5,0,0,219,427
65060,9,8,4,0,0,0,0,7,11
71743,8,124,1,0,0,0,0,0,1
43593,9,489,1,0,0,0,0,1,2
86419,4,365,11,0,0,0,0,16,27
169436,9,538,152,0,0,0,0,184,336
139418,4,200,61,1,1,0,1,102,166
77117,4,923,37,1,1,0,0,73,112
63702,9,329,1,0,0,0,0,1,2
102848,9,657,158,8,6,0,0,275,447
164572,4,752,1,0,0,0,0,6,7
33313,9,842,86,1,0,0,0,124,211
165354,7,578,2,0,0,0,0,6,8
138621,11,545,3,0,0,0,0,2,5
94063,7,578,35,2,0,0,0,56,93
162957,7,578,2,0,0,0,0,5,7
84955,7,578,16,0,0,0,0,26,42
119142,4,658,1,0,0,0,0,1,2
129821,6,165,6,0,0,0,0,7,13
47856,7,100,11,0,0,0,0,12,23
102451,4,36,3,0,0,0,0,2,5
125984,9,842,7,0,0,0,0,7,14
74284,9,497,0,0,0,0,0,10,10
89583,5,200,8,0,0,0,0,14,22
71114,7,118,121,5,3,1,1,203,334
93873,8,124,1,0,0,0,0,6,7
123206,8,403,245,10,3,1,0,398,657
100714,9,630,2,0,0,0,0,0,2
15928,9,487,23,0,0,0,0,38,61
26283,5,78,7,0,0,0,0,34,41
37687,9,489,82,0,0,0,0,164,246
170370,9,489,90,4,3,0,1,188,286
151961,4,36,1,0,0,0,0,2,3
84133,7,484,3,0,0,0,0,5,8
53650,7,578,10,0,0,0,0,30,40
47380,10,29,32,0,1,0,0,52,85
18583,10,29,6,0,0,0,0,8,14
26567,11,693,29,0,0,0,0,22,51
115510,7,484,12,2,1,0,0,23,38
110910,7,484,16,0,0,0,0,20,36
114544,9,367,49,2,2,0,1,89,143
77269,7,429,32,4,0,1,0,40,77
161300,7,429,20,0,0,0,0,30,50
91811,7,748,30,0,0,0,0,41,71
76275,5,106,17,0,0,0,1,24,42
69908,7,126,7,0,0,0,0,9,16
6897,11,800,5,0,0,0,0,4,9
140272,5,893,12,0,0,0,0,10,22
143570,7,587,121,4,2,0,0,208,335
21949,9,78,87,1,1,0,0,132,221
83071,8,545,2,0,0,0,0,1,3
21211,8,489,340,1,0,0,0,488,829
152918,6,263,6,0,0,0,0,11,17
10177,7,641,59,2,2,0,1,116,180
54210,9,842,101,0,0,0,1,269,371
79147,8,545,175,0,0,0,0,233,408
80603,4,375,2,0,0,0,0,2,4
15554,4,885,4,0,0,0,0,4,8
84065,5,773,24,1,1,0,0,33,59
93523,4,519,1,0,0,0,0,1,2
34811,7,216,52,2,0,0,0,88,142
78144,9,885,18,0,0,0,0,35,53
120356,9,575,64,3,4,0,0,74,145
161317,4,427,91,1,0,1,3,156,252
81088,4,375,16,0,0,0,0,25,41
104112,9,469,95,10,3,0,0,129,237
141715,7,353,8,0,0,0,0,12,20
85974,4,200,34,0,0,0,0,70,104
101747,5,381,88,2,1,0,0,119,210
17796,7,126,4,0,0,0,0,6,10
118299,7,755,15,0,0,0,0,56,71
39213,11,214,12,1,0,0,0,13,26
33493,7,157,41,1,1,0,0,56,99
81355,5,479,13,0,0,0,0,15,28
163831,8,489,11,0,0,0,0,3,14
113479,8,489,5,0,0,0,0,1,6
89679,8,623,108,0,1,0,1,143,253
36192,7,24,6,0,0,0,0,3,9
120152,8,214,1,0,0,0,0,0,1
127672,5,106,6,0,0,0,0,10,16
82116,11,545,109,5,0,0,0,131,245
95612,10,474,14,0,0,0,0,24,38
8515,8,214,275,4,1,0,1,443,724
30024,9,202,42,1,0,0,0,59,102
4642,5,479,35,0,0,0,0,66,101
48430,11,214,9,0,0,0,0,7,16
22462,9,202,8,0,0,0,1,13,22
154784,9,202,19,1,1,0,0,26,47
380,7,822,44,1,0,0,1,67,113
71475,7,126,1,0,0,0,0,1,2
145668,8,214,1,0,0,0,0,1,2
121368,9,658,63,1,1,0,1,70,136
107435,11,677,12,1,0,0,0,11,24
26257,4,885,64,0,0,0,0,56,120
72217,9,658,69,1,0,1,0,122,193
4670,8,124,80,0,0,0,0,112,192
31167,7,285,41,1,0,0,0,69,111
168455,9,658,14,0,0,0,0,28,42
96397,9,658,5,0,0,0,0,11,16
83637,7,563,5,0,0,0,0,6,11
147411,9,30,47,5,2,0,0,72,126
147576,9,658,28,0,0,0,0,50,78
68175,9,658,86,2,1,1,2,142,234
83907,9,380,10,2,1,0,0,13,26
15107,9,658,4,0,0,0,0,16,20
143134,9,658,4,0,0,0,0,3,7
97963,4,159,1,0,0,0,0,5,6
42353,7,61,19,1,1,0,0,26,47
19658,7,126,7,0,0,0,0,19,26
25829,9,741,60,0,0,0,0,70,130
14840,7,578,51,1,2,0,0,88,142
121402,11,244,26,0,0,0,1,28,55
2329,7,575,72,3,2,0,0,181,258
83600,11,214,17,0,0,0,0,26,43
137362,6,901,37,2,2,0,0,75,116
1196,5,225,115,0,0,0,1,158,274
48256,9,78,104,2,0,0,0,185,291
123634,8,812,94,2,3,0,0,193,292
113621,8,812,48,0,0,0,0,122,170
126685,7,100,17,0,0,0,0,24,41
137357,9,100,4,0,0,0,0,3,7
4822,9,341,16,0,0,0,0,39,55
141705,4,174,90,0,0,0,0,109,199
12066,7,563,7,0,1,0,0,16,24
109903,9,489,46,3,1,0,0,103,153
60065,6,159,120,1,1,0,1,207,330
44859,9,489,1,0,0,0,0,0,1
95194,7,157,34,0,0,0,0,37,71
131454,7,157,17,0,0,0,0,19,36
73246,5,176,27,0,0,0,0,48,75
60349,6,643,60,4,1,0,0,91,156
28627,10,917,5,0,0,0,0,9,14
36180,6,200,15,0,0,0,1,21,37
59253,9,147,9,1,0,0,0,34,44
3498,9,54,2,0,0,0,0,2,4
73691,9,54,2,0,0,0,0,2,4
37572,9,630,3,0,0,0,0,1,4
121268,5,124,59,0,0,0,0,102,161
45898,11,812,6,0,0,0,0,5,11
101173,6,124,177,4,3,0,4,298,486
149098,4,581,28,0,0,0,0,22,50
102499,8,214,6,0,0,0,0,8,14
50354,9,469,34,0,0,0,1,69,104
148552,4,200,53,1,1,0,1,88,144
181,6,827,40,0,0,0,0,59,99
1135,7,429,8,2,2,0,0,11,23
28449,9,78,3,0,0,0,0,1,4
21223,4,159,3,0,0,0,0,3,6
156649,11,812,10,0,0,0,0,11,21
18674,9,158,29,1,2,0,0,136,168
151700,9,657,73,2,2,0,0,93,170
264,6,537,29,0,0,0,0,32,61
162353,4,36,2,0,0,0,0,4,6
53962,7,755,8,0,0,0,0,16,24
7969,7,472,9,0,0,0,0,14,23
50583,7,472,6,0,0,0,0,7,13
48475,8,214,262,1,0,0,0,373,636
7370,10,917,16,0,0,0,0,35,51
161051,9,89,2,0,0,0,0,1,3
5388,8,403,10,0,0,0,0,0,10
128584,4,174,9,0,0,0,0,9,18
146220,6,106,117,3,1,0,2,236,359
84128,6,827,32,1,1,0,1,50,85
54895,9,158,20,0,0,0,0,78,98
113386,9,912,8,0,0,0,0,12,20
104773,4,375,10,0,0,0,0,15,25
144886,7,79,184,3,2,0,0,214,403
18654,7,611,13,0,0,0,0,18,31
83572,7,748,11,0,1,0,0,19,31
57670,5,78,214,3,1,0,1,309,528
41187,9,6,17,1,1,0,0,36,55
100551,9,6,65,1,0,1,0,52,119
150525,9,632,8,2,0,0,0,10,20
69927,9,6,19,1,1,0,0,21,42
133957,8,800,11,0,0,0,0,20,31
32858,9,6,34,0,0,0,1,83,118
72497,5,296,145,4,1,1,1,195,347
33001,7,146,36,1,0,1,0,63,101
91138,9,341,22,0,0,0,0,26,48
164022,9,341,55,1,1,0,0,74,131
163985,9,538,17,0,1,0,0,36,54
16896,6,922,4,0,0,0,0,6,10
53086,7,587,82,1,1,1,0,110,195
113901,9,487,20,0,0,0,0,43,63
24798,9,30,10,0,0,0,0,11,21
37251,7,56,36,1,1,0,0,102,140
36340,9,483,28,0,0,0,0,27,55
69073,7,194,103,2,1,1,1,165,273
62850,9,341,5,0,0,0,0,7,12
107445,9,4,10,0,0,0,0,15,25
83833,10,917,0,0,0,0,1,19,20
52572,8,812,60,6,3,0,1,82,152
147546,8,812,67,1,1,0,0,93,162
140064,8,812,7,0,0,0,0,16,23
11707,9,8,49,0,0,0,0,81,130
148703,9,8,1,0,0,0,0,0,1
27784,8,812,6,0,0,0,0,12,18
93153,10,555,2,0,0,0,0,2,4
97441,11,214,2,0,0,0,0,2,4
26725,9,640,315,0,0,0,2,435,752
111758,9,640,746,0,0,0,4,1063,1813
20572,5,59,45,2,0,1,0,85,133
148178,5,176,15,1,1,0,1,24,42
117494,10,917,4,1,1,0,0,4,10
150703,5,218,21,0,0,0,0,27,48
143590,10,820,32,1,1,0,0,40,74
132198,9,575,72,3,2,0,0,108,185
5641,10,917,3,1,0,0,0,8,12
86697,6,209,18,1,1,0,0,37,57
17994,9,483,16,1,0,0,0,14,31
147283,7,861,4,0,0,0,0,7,11
113707,7,748,20,0,0,0,0,35,55
138570,7,375,4,0,0,0,0,8,12
164232,7,375,5,0,0,0,0,7,12
18868,7,375,16,0,0,0,0,19,35
88352,7,375,16,0,0,0,0,24,40
85491,7,157,40,0,0,0,0,79,119
132760,5,293,29,2,0,0,0,50,81
155411,7,824,18,0,0,0,0,28,46
39140,8,658,58,0,0,0,0,89,147
44364,7,645,7,0,0,0,0,7,14
13536,9,510,15,1,1,0,0,23,40
24855,4,752,6,2,0,0,0,6,14
94933,11,214,47,2,0,0,0,41,90
70669,10,917,2,0,0,0,0,5,7
34511,5,209,31,2,0,0,0,46,79
46726,10,917,16,2,2,0,0,19,39
6464,10,917,2,0,0,0,0,3,5
141021,10,66,121,0,0,0,0,203,324
88082,8,306,7,0,0,0,0,7,14
27205,5,306,2,0,0,0,0,3,5
43706,5,124,25,0,0,0,0,33,58
73324,5,124,18,0,0,0,0,32,50
61421,5,78,137,1,1,0,1,215,355
32678,6,140,114,12,3,0,0,187,316
131405,7,100,7,0,0,0,0,10,17
106681,7,100,655,24,15,2,2,1125,1823
53619,6,901,20,0,0,0,0,45,65
29650,6,922,10,0,0,0,0,10,20
78374,9,158,20,0,0,0,0,37,57
161583,9,157,6,0,0,0,0,6,12
86269,9,657,12,0,0,0,1,30,43
61980,9,657,5,0,0,0,0,12,17
30348,9,89,13,0,0,0,0,24,37
135617,9,158,3,0,0,0,0,12,15
82873,6,263,6,0,0,0,0,8,14
9546,9,456,2,0,0,0,0,2,4
154139,4,270,55,2,0,0,0,78,135
157536,5,200,13,0,0,0,0,17,30
110114,7,521,97,3,2,0,1,173,276
64154,7,496,67,0,0,0,0,131,198
142728,10,217,23,0,0,0,0,43,66
17639,11,214,36,0,0,0,0,39,75
6002,10,355,4,0,0,0,0,10,14
89393,9,4,43,2,2,0,0,48,95
141178,9,380,27,0,0,0,0,37,64
34331,9,800,27,0,1,0,0,68,96
139588,7,4,25,0,0,0,0,43,68
351,7,487,5,1,0,0,0,11,17
37156,9,367,126,8,3,2,1,182,322
138616,9,570,13,0,0,0,0,16,29
78238,9,380,19,1,0,0,0,39,59
8093,9,380,28,0,0,0,0,50,78
159466,7,861,18,0,0,0,0,31,49
69059,8,800,9,0,0,0,0,7,16
166250,9,380,10,0,0,0,0,11,21
84219,9,640,40,3,1,0,0,52,96
112271,7,79,3,0,0,0,0,14,17
104876,7,126,21,0,0,0,0,39,60
48172,10,525,29,1,1,0,0,43,74
18926,7,353,10,0,0,0,1,27,38
37442,10,208,2,0,0,0,0,1,3
131434,6,200,2,0,0,0,0,2,4
49096,4,658,2,0,0,0,0,14,16
64611,5,124,20,0,0,0,0,31,51
141986,10,66,14,0,0,0,0,6,20
65661,10,917,4,0,0,0,0,6,10
163672,9,380,18,1,1,0,0,21,41
9829,9,640,35,1,1,0,0,49,86
30497,5,489,2,0,0,0,0,3,5
103853,9,640,112,0,0,0,1,193,306
49975,7,484,7,0,0,0,1,18,26
119363,10,525,29,0,0,0,0,47,76
77173,10,525,9,0,0,0,0,10,19
102820,10,322,4,0,0,0,0,10,14
22029,10,322,2,0,0,0,0,2,4
144532,10,781,32,0,0,0,0,42,74
4419,9,380,26,0,0,0,0,42,68
149151,10,519,77,4,1,0,1,292,375
74800,10,618,2,0,0,0,0,4,6
30409,10,618,0,1,1,0,0,6,8
914,7,226,5,0,0,0,0,28,33
127055,11,214,14,0,0,0,0,17,31
142780,9,570,8,0,0,0,0,13,21
4088,10,618,2,0,0,0,0,2,4
159631,7,657,15,0,0,0,0,29,44
15608,10,807,4,0,0,0,0,8,12
163481,10,807,19,0,0,0,0,23,42
74188,7,226,2,1,0,0,0,27,30
56568,7,762,111,4,4,0,0,171,290
154242,10,81,0,0,0,0,0,3,3
99221,7,79,20,1,0,0,0,36,57
107770,10,618,4,0,0,0,0,3,7
70358,10,355,4,0,0,0,0,6,10
66587,5,885,37,0,0,0,1,62,100
162570,7,658,12,1,1,0,0,28,42
68265,4,200,1,0,0,0,0,0,1
9653,7,484,82,2,2,0,1,111,198
12219,6,518,17,0,0,0,0,20,37
8100,7,56,11,0,0,0,0,58,69
23302,5,200,45,0,0,0,0,67,112
24896,8,885,272,7,4,0,3,696,982
152858,10,322,6,0,0,0,0,10,16
55820,7,741,2,0,0,0,0,3,5
95394,9,489,51,0,0,0,0,212,263
124280,7,56,22,0,0,0,0,28,50
28429,6,159,3,0,0,0,0,4,7
77247,7,492,3,0,0,0,1,7,11
104464,9,399,23,0,0,0,1,27,51
52503,9,78,70,0,1,0,1,103,175
57279,7,56,6,0,0,0,0,15,21
101472,10,653,280,1,0,0,2,487,770
159365,11,427,21,0,0,0,0,16,37
81989,7,864,74,0,0,0,0,106,180
39675,5,106,31,0,1,0,0,43,75
80960,7,521,19,0,0,0,0,33,52
93496,7,79,40,3,0,0,0,95,138
101210,9,306,124,0,0,0,0,253,377
158886,10,752,12,0,0,0,0,25,37
101523,9,575,17,0,0,0,0,19,36
103174,9,575,4,0,0,0,0,6,10
168930,11,214,61,1,0,0,0,78,140
65609,7,741,12,0,0,0,0,20,32
167880,9,607,86,0,1,0,1,96,184
44215,7,100,5,0,0,0,0,16,21
34257,7,30,41,3,3,1,0,113,161
108868,9,341,9,0,0,0,0,13,22
169116,9,341,9,0,0,0,0,11,20
67861,9,607,58,0,0,0,0,96,154
125983,9,912,12,1,1,0,0,27,41
35039,9,658,27,0,0,0,0,39,66
48194,6,78,2,0,0,0,0,1,3
152736,4,678,0,1,0,0,0,0,1
43838,9,145,35,2,0,1,1,79,118
6332,6,78,10,0,0,0,0,12,22
91628,9,380,2,0,0,0,0,3,5
40531,4,365,5,0,0,0,0,9,14
114260,9,873,26,0,0,0,0,48,74
128302,9,873,10,1,1,0,0,16,28
8682,9,302,13,0,0,0,0,15,28
138591,9,483,18,0,0,0,0,41,59
67222,9,302,36,0,0,0,0,66,102
159561,11,214,1,0,0,0,0,0,1
97056,9,158,84,3,1,0,0,168,256
95786,9,158,68,0,1,0,0,34,103
39654,7,429,21,0,1,0,0,222,244
102329,7,587,167,2,1,1,1,297,469
62724,6,296,20,0,0,0,0,20,40
133164,9,796,3,0,0,0,0,4,7
76232,9,302,159,5,1,1,0,227,393
169722,9,399,7,0,0,0,0,10,17
23807,7,254,8,0,0,0,0,11,19
77362,7,755,199,8,4,0,1,416,628
8235,8,623,4,0,0,0,0,3,7
130316,7,56,2,0,0,0,0,6,8
129899,9,842,185,3,2,0,1,265,456
118366,6,453,1,0,0,0,0,1,2
58239,9,302,63,0,0,0,1,138,202
115402,9,489,32,0,0,0,0,32,64
121374,8,693,6,0,0,0,0,7,13
18842,9,489,252,0,0,0,1,359,612
55711,7,492,1,1,1,0,0,0,3
102434,7,872,39,0,0,0,0,62,101
154660,5,570,53,1,0,0,0,99,153
106772,11,489,15,3,0,0,0,12,30
101298,5,800,8,0,0,0,0,8,16
733,7,744,21,1,0,0,1,25,48
141350,9,100,56,3,0,1,0,108,168
134319,9,487,72,2,3,0,0,100,177
91991,6,785,22,0,0,0,0,24,46
112096,6,103,6,0,0,0,0,6,12
101986,6,103,6,0,0,0,0,9,15
38674,9,302,14,0,0,0,0,20,34
64923,6,789,32,0,0,0,0,43,75
40157,8,214,124,0,0,0,0,210,334
153821,10,917,44,4,4,0,0,45,97
160318,9,462,15,0,0,0,0,20,35
39805,5,200,10,0,0,0,0,14,24
123386,5,200,14,0,0,0,0,24,38
46736,9,302,17,0,0,0,0,29,46
49328,10,820,23,0,0,0,1,45,69
91175,10,208,48,1,0,0,0,93,142
167872,10,208,23,0,0,0,0,25,48
139906,9,380,3,0,0,0,0,10,13
90516,10,898,7,0,0,0,0,12,19
137677,10,29,2,0,0,0,0,4,6
131613,9,65,49,2,1,0,1,111,164
4332,9,341,19,0,0,0,0,55,74
93618,9,380,5,1,1,0,0,9,16
95470,9,380,11,0,0,0,0,11,22
93099,9,589,10,0,0,0,0,18,28
75564,9,65,7,0,0,0,0,14,21
42582,9,380,18,0,0,0,0,26,44
100487,6,785,248,9,5,3,2,386,653
31289,9,158,19,1,1,0,0,30,51
71671,9,489,35,0,0,0,0,27,62
7079,9,100,18,0,0,0,0,27,45
64594,10,29,27,0,0,0,0,26,53
51419,7,232,2,0,0,0,0,4,6
121323,10,523,4,0,0,0,0,28,32
51619,6,785,4,0,0,0,0,21,25
26470,10,868,6,0,0,0,0,3,9
75737,10,868,12,1,0,1,2,32,48
123137,10,66,6,0,0,0,0,7,13
107059,10,66,6,0,0,0,0,3,9
28725,10,66,8,0,0,0,0,6,14
48815,10,29,16,0,0,0,0,11,27
126064,9,145,134,0,0,0,0,221,355
95197,10,29,8,0,0,0,0,13,21
22034,10,44,28,2,1,0,1,49,81
96552,10,917,6,0,0,0,0,7,13
141846,5,124,4,0,0,0,0,10,14
104090,4,159,7,0,0,0,0,12,19
109475,7,429,27,0,1,0,0,50,78
17709,5,200,69,0,0,0,0,111,180
116223,5,585,51,0,1,0,0,98,150
134759,9,8,11,0,0,0,0,20,31
144686,7,8,1,0,0,0,0,2,3
157763,6,78,10,0,0,0,0,15,25
108721,7,521,39,1,0,0,1,63,104
114285,7,314,19,1,0,0,0,37,57
106018,7,429,6,0,0,0,0,19,25
116378,7,578,6,0,0,0,0,11,17
82865,10,917,2,0,0,0,0,3,5
108808,10,525,14,0,0,0,0,17,31
36620,11,306,6,0,0,0,0,5,11
128046,9,367,39,0,0,0,0,65,104
122002,11,214,22,0,0,0,0,29,51
21588,9,367,91,3,0,1,1,125,221
43124,9,100,16,0,0,0,0,25,41
146579,6,601,243,6,2,0,2,413,666
12387,9,100,5,0,0,0,0,13,18
54669,9,100,12,0,0,0,0,11,23
160566,7,429,46,1,1,0,0,81,129
99213,9,563,2,0,0,0,0,2,4
23922,9,6,17,0,0,0,0,21,38
23373,5,655,41,1,1,0,0,73,116
149043,9,427,23,0,0,0,0,113,136
110237,8,489,248,6,3,0,5,427,689
26777,5,585,22,0,0,0,0,36,58
17303,7,373,21,0,0,0,0,35,56
34634,7,373,42,3,0,0,0,107,152
105657,9,630,10,0,0,0,0,14,24
89824,9,842,48,1,1,0,0,80,130
58379,6,453,6,0,0,0,0,8,14
113702,8,790,14,0,0,0,0,31,45
42810,8,790,57,1,0,0,0,80,138
8860,4,752,28,0,0,0,0,43,71
152595,6,556,3,0,0,0,0,6,9
111782,7,521,10,0,0,0,0,11,21
102994,9,77,1,0,0,0,0,0,1
109729,9,86,51,0,0,5,0,63,119
96825,9,640,184,1,1,0,0,314,500
84237,7,641,1,0,0,0,0,0,1
101154,7,484,26,0,0,0,0,49,75
64884,6,296,99,4,2,0,2,177,284
99834,4,658,29,0,0,0,1,58,88
164434,9,86,205,9,2,2,0,322,540
83422,9,575,53,1,1,0,1,91,147
67117,7,254,8,6,0,0,0,11,25
14684,4,159,21,0,0,0,0,37,58
103137,10,752,3,0,0,0,0,0,3
170844,11,214,58,1,0,0,0,71,130
108836,7,126,9,0,0,0,0,17,26
149085,11,214,8,0,0,0,0,7,15
74470,5,556,1,0,0,0,0,1,2
131549,9,589,22,0,0,0,0,35,57
133042,9,589,41,0,0,0,0,74,115
102246,9,589,127,1,1,0,1,201,331
51302,4,365,13,0,0,0,0,14,27
149398,4,124,420,28,16,0,1,648,1113
152681,6,585,1,0,0,0,0,2,3
163283,9,202,32,1,1,0,0,40,74
33269,11,489,2,0,0,0,0,2,4
168197,7,56,14,0,0,0,0,23,37
59005,9,378,19,0,0,0,0,24,43
50027,6,585,3,0,0,0,0,8,11
23391,6,261,2,0,0,0,0,3,5
148454,5,263,1,0,0,0,0,2,3
59474,11,244,18,0,0,0,0,15,33
94617,9,457,2,0,0,0,0,3,5
110028,7,741,1,0,0,0,0,0,1
16103,11,214,113,11,0,0,0,102,226
10722,8,622,52,1,1,0,0,73,127
8903,7,79,10,0,0,0,0,25,35
112506,10,917,2,0,0,0,0,4,6
98695,8,214,11,0,0,0,0,10,21
71887,11,623,0,0,0,0,0,2,2
20919,9,842,398,15,9,0,4,676,1102
29753,9,462,44,0,0,9,0,52,105
137285,9,462,0,0,0,0,0,70,70
84037,7,462,40,0,0,11,0,60,111
138472,6,200,14,0,0,0,0,22,36
68367,5,699,2,0,0,0,0,2,4
170302,5,78,263,0,0,0,0,405,668
94211,8,885,6,0,0,0,0,4,10
69850,10,474,41,2,0,0,0,121,164
82704,5,124,43,0,0,0,0,61,104
34739,9,657,12,1,1,0,0,16,30
128696,9,657,7,0,0,0,0,11,18
99897,9,657,1,0,0,0,0,0,1
160291,9,657,83,3,1,0,1,133,221
66335,11,244,6,0,0,0,0,6,12
126016,4,658,75,3,2,0,0,130,210
7119,5,78,20,0,0,0,0,23,43
54703,4,270,6,0,0,0,0,13,19
126913,9,42,5,0,0,0,0,7,12
167850,8,214,9,0,0,0,0,18,27
54797,6,124,10,0,0,0,0,14,24
127442,7,551,30,2,2,0,0,49,83
72806,6,789,66,6,0,0,0,133,205
5089,9,469,12,0,0,0,0,21,33
94803,8,124,43,0,0,0,0,61,104
34205,8,812,1,0,0,0,0,2,3
124412,7,864,9,0,0,0,0,11,20
70810,9,374,13,0,0,0,0,60,73
13638,8,885,11,0,0,0,0,15,26
96539,7,551,10,0,0,0,0,17,27
94852,9,842,1,0,0,0,0,0,1
168132,7,551,18,0,0,0,0,17,35
54236,6,159,5,0,0,0,0,13,18
99014,9,469,6,0,0,0,0,8,14
10621,7,30,1,0,0,0,0,1,2
100696,5,570,14,1,0,0,0,22,37
143312,9,640,225,0,0,0,4,347,576
26284,6,235,69,0,0,0,0,93,162
104210,5,570,11,0,0,0,0,20,31
152522,9,800,33,1,2,0,0,35,71
38391,10,22,28,1,1,0,1,41,72
72993,9,177,7,5,0,0,0,26,38
42240,10,817,4,0,0,0,0,9,13
117779,6,117,3,0,0,0,0,3,6
121686,6,232,15,0,0,0,0,23,38
170021,6,103,17,0,0,0,0,25,42
158390,7,492,20,0,0,0,1,29,50
50521,6,159,20,0,0,0,0,15,35
55353,9,630,75,0,0,0,0,102,177
141516,11,427,40,6,0,0,0,45,91
106626,9,78,231,8,4,0,1,346,590
561,9,632,1,0,0,0,0,2,3
36072,9,632,2,0,0,0,0,4,6
106845,9,632,5,0,0,0,0,10,15
14596,9,632,12,1,1,0,0,25,39
142392,9,632,2,0,0,0,0,2,4
45753,9,632,2,0,0,0,0,2,4
12344,4,306,9,0,0,0,0,10,19
160962,4,306,30,0,0,0,0,38,68
129541,7,295,3,0,0,0,0,9,12
113647,8,800,15,0,0,0,0,9,24
688,9,589,14,0,0,0,0,28,42
120327,10,413,12,0,0,0,0,11,23
102190,6,789,13,0,0,0,0,18,31
132990,10,653,1,0,0,0,0,0,1
41371,6,78,711,14,8,0,3,1051,1787
71371,9,607,136,1,0,0,0,179,316
99183,9,796,2,0,0,0,0,2,4
126740,9,782,14,0,1,0,0,43,58
27479,7,822,11,0,0,0,1,16,28
64707,5,124,38,0,0,0,0,54,92
44651,8,214,16,0,0,0,0,25,41
74314,4,453,2,0,0,0,0,2,4
124979,9,657,11,1,1,0,0,13,26
87020,4,36,88,6,4,0,0,121,219
47644,9,842,218,7,3,0,4,358,590
87407,9,842,44,1,1,0,0,57,103
85478,8,800,34,0,1,0,0,41,76
53137,7,214,44,0,0,0,0,82,126
129118,9,796,2,0,0,0,0,2,4
13641,8,545,6,0,0,0,0,8,14
151918,4,36,1,0,0,0,0,0,1
83795,7,496,92,1,1,0,1,134,229
57553,8,211,12,0,0,0,0,15,27
91953,9,145,68,0,1,0,1,128,198
42848,9,145,1,0,0,0,0,16,17
69711,9,145,1,0,0,0,0,10,11
92536,10,781,1,0,0,0,0,2,3
169494,9,145,79,2,0,0,0,69,150
147239,4,199,1,0,0,0,0,1,2
165894,7,748,45,0,0,0,0,92,137
79682,9,158,40,2,0,1,0,74,117
169386,4,36,85,1,0,0,1,191,278
31355,9,842,171,10,5,1,0,320,507
134179,10,87,17,1,0,0,0,21,39
96144,9,243,12,2,0,0,0,28,42
73660,7,741,4,0,0,0,0,4,8
3702,10,798,1,0,0,0,0,3,4
110351,10,798,1,0,0,0,0,0,1
4936,7,748,4,0,0,0,0,8,12
13013,10,413,3,0,0,0,0,7,10
27074,10,798,5,0,0,0,0,5,10
13006,8,800,37,2,0,0,0,57,96
130074,10,322,5,0,0,0,0,12,17
7701,10,322,1,0,0,0,0,0,1
131351,10,322,6,0,0,0,0,9,15
8028,10,618,2,0,0,0,0,2,4
72950,7,508,3,0,0,0,0,5,8
26542,7,4,17,0,0,0,0,38,55
153868,7,842,26,1,1,0,0,55,83
73647,7,295,10,0,0,0,0,15,25
43698,9,630,24,0,0,0,0,18,42
155829,7,196,9,1,1,0,0,7,18
92327,6,514,135,3,1,0,0,281,420
71182,9,630,15,0,0,0,0,25,40
134382,6,453,59,0,0,0,1,80,140
99358,4,36,174,2,0,0,0,349,525
29518,6,729,36,0,0,0,0,57,93
6073,7,373,78,2,1,0,1,112,194
50778,10,820,10,0,1,0,0,23,34
58638,9,607,46,3,2,0,0,98,149
150708,10,820,9,1,0,0,0,6,16
54567,10,289,19,0,0,0,0,18,37
142249,10,820,4,0,0,0,0,3,7
73674,9,838,24,0,0,0,0,29,53
37958,10,820,3,0,0,0,0,3,6
117281,10,555,1,0,0,0,0,2,3
53175,7,56,12,0,0,0,0,22,34
80789,7,56,6,0,0,0,0,4,10
74355,5,159,1,0,0,0,0,0,1
32457,9,706,8,1,1,0,0,30,40
58,7,861,60,2,0,0,0,95,157
51876,8,214,4,0,0,0,0,2,6
137904,9,640,73,2,3,0,0,113,191
8704,9,762,29,2,2,0,1,40,74
101661,9,762,12,0,0,0,0,18,30
28008,8,812,8,1,1,0,0,19,29
102417,9,762,20,0,0,0,0,46,66
72605,9,762,25,0,0,0,0,59,84
27103,10,555,1,0,0,0,0,17,18
39782,7,741,1,0,0,0,0,1,2
167592,7,741,12,0,0,0,0,20,32
77717,6,453,66,1,0,0,0,115,182
110680,9,842,208,5,3,0,0,330,546
97759,9,657,28,2,0,0,1,46,77
158112,5,800,8,0,0,0,0,11,19
140842,9,800,177,2,0,6,1,253,439
52787,9,710,2,0,0,0,0,3,5
35733,9,819,13,0,1,0,0,11,25
33878,9,538,40,0,0,0,0,63,103
25160,9,43,2,0,0,0,0,2,4
163107,9,589,21,0,0,0,0,19,40
104949,9,885,4,0,0,0,0,16,20
40605,5,821,26,0,0,0,1,33,60
167549,9,800,144,1,0,0,1,198,344
38520,9,570,22,0,0,0,0,38,60
81104,4,923,3,0,0,0,0,2,5
12656,8,800,28,1,1,0,0,52,82
158863,8,812,89,3,1,0,1,142,236
63480,11,124,26,1,0,0,0,28,55
39572,10,355,0,0,0,0,2,63,65
46277,9,4,10,2,4,0,0,31,47
54127,9,4,0,0,0,0,0,13,13
73171,7,741,8,0,0,0,0,9,17
42899,6,821,51,2,1,0,1,101,156
158271,10,523,30,0,0,0,0,38,68
31772,10,289,27,0,0,0,0,34,61
114536,6,785,245,4,3,0,0,341,593
91244,7,78,36,0,0,0,0,49,85
24617,9,657,743,23,10,5,2,1253,2036
101084,7,693,94,3,1,0,1,153,252
70480,7,232,23,0,0,0,0,36,59
19301,7,484,16,0,0,0,0,26,42
149386,7,484,7,0,0,0,0,6,13
151228,8,489,26,0,0,0,0,40,66
147712,9,800,36,0,0,0,0,103,139
59072,4,752,12,0,0,0,0,5,17
18153,6,885,16,0,0,0,0,22,38
89613,7,496,85,1,2,0,0,121,209
96049,5,225,68,2,1,0,1,103,175
114737,5,140,55,0,0,0,0,68,123
38789,5,306,267,6,5,0,0,431,709
88109,9,306,1,0,0,0,0,0,1
45930,7,404,17,0,0,0,0,32,49
79284,9,202,51,1,0,0,0,101,153
116739,9,202,47,0,0,0,0,42,89
2888,8,623,9,0,0,0,0,8,17
137935,9,202,8,0,0,0,0,13,21
45291,9,656,6,0,0,0,0,9,15
40207,5,375,1,0,0,0,0,0,1
132308,10,798,1,0,0,0,0,1,2
165175,8,214,147,6,2,0,2,206,363
105496,6,181,153,4,0,0,0,191,348
157319,9,375,26,1,1,0,0,68,96
72216,9,306,50,0,0,0,0,77,127
59552,6,290,4,0,0,0,0,3,7
55637,8,812,72,0,0,0,0,98,170
59013,10,820,30,1,1,0,0,33,65
149172,7,61,15,0,0,0,0,22,37
111647,9,216,22,0,0,0,0,40,62
70872,7,194,34,0,0,0,0,44,78
133063,5,570,15,0,0,0,0,20,35
67900,6,103,6,0,0,0,0,9,15
153710,11,214,4,0,0,0,0,2,6
132854,4,200,1,0,0,0,0,2,3
65168,5,263,133,4,2,0,0,195,334
96121,7,521,4,0,0,0,0,3,7
85152,4,752,25,0,1,0,0,34,60
121206,10,555,21,0,0,0,0,47,68
140278,9,873,21,0,0,0,0,44,65
105411,10,555,5,0,0,0,0,9,14
14769,7,521,20,1,1,0,0,30,52
55753,10,555,1,0,0,0,0,0,1
168362,4,199,16,0,0,0,0,19,35
20790,9,570,20,1,0,0,0,28,49
62113,11,214,12,0,0,0,0,12,24
135279,7,306,30,0,0,0,0,25,55
144264,7,755,58,0,0,0,0,76,134
46650,4,220,74,0,0,0,0,158,232
70933,7,521,23,0,0,0,0,23,46
26312,7,429,27,0,0,0,0,109,136
93991,6,296,197,1,2,0,2,517,719
70717,10,355,102,1,1,0,1,151,256
107587,7,100,73,0,0,3,0,117,193
165353,9,640,9,0,0,0,0,10,19
14936,10,743,13,0,0,0,0,37,50
66098,9,570,10,0,0,0,1,13,24
10397,9,489,12,0,0,0,0,19,31
68671,4,658,30,0,0,0,0,47,77
12059,9,483,1,0,0,0,0,1,2
84953,4,427,97,0,0,0,0,173,270
27450,7,214,11,0,0,0,0,15,26
143195,10,781,7,0,0,0,0,22,29
160937,10,781,4,0,0,0,0,11,15
21954,9,374,10,0,0,0,0,12,22
105420,10,917,44,0,0,0,0,45,89
55377,6,235,403,10,8,0,2,859,1282
41025,9,658,20,0,0,0,0,25,45
39503,7,196,9,0,0,0,0,9,18
40323,5,251,16,0,0,0,0,11,27
107420,4,658,7,0,0,0,0,6,13
58207,7,492,7,0,0,0,0,6,13
139756,9,577,3,0,0,0,0,8,11
1507,9,374,26,0,0,0,0,25,51
35667,9,489,19,0,0,0,0,16,35
67536,9,314,4,0,0,0,0,2,6
16765,7,78,32,1,0,0,0,43,76
57287,7,78,17,0,0,0,1,17,35
130191,9,489,62,1,1,0,0,70,134
5357,7,263,10,0,0,0,0,16,26
37432,9,630,23,0,0,0,0,19,42
90722,11,214,21,0,0,0,0,20,41
129386,9,374,8,0,0,1,0,14,23
121719,7,587,14,0,0,0,0,15,29
6957,10,917,2,0,0,0,0,6,8
122690,9,575,36,2,2,0,1,118,159
38479,11,812,8,0,0,0,0,7,15
11179,10,917,0,1,1,0,0,4,6
55333,10,917,0,0,0,0,0,5,5
28794,6,518,24,0,0,0,0,34,58
54659,7,521,67,1,1,0,0,100,169
37511,8,800,17,0,0,0,0,30,47
164352,7,429,4,0,0,0,0,3,7
10626,8,800,64,0,0,0,0,114,178
53056,7,521,114,2,1,0,0,149,266
74989,7,79,3,0,0,0,0,10,13
143379,7,157,127,0,0,0,1,192,320
25745,6,729,8,0,0,0,0,13,21
74378,9,575,10,0,0,0,0,11,21
36131,8,545,8,0,0,0,0,5,13
115369,11,306,8,0,0,0,0,3,11
118510,9,469,0,0,0,0,0,15,15
149309,10,36,16,0,0,0,0,13,29
146442,9,842,29,0,0,0,1,34,64
155103,7,648,4,0,0,0,0,5,9
66008,11,545,10,0,0,0,0,10,20
124860,9,556,20,0,0,0,0,25,45
87099,11,30,178,3,0,1,0,188,370
137136,8,545,2,0,0,0,0,3,5
43091,9,462,9,0,0,0,0,16,25
154528,7,587,106,2,1,0,0,176,285
43166,9,302,59,1,0,1,0,71,132
56627,9,570,12,0,0,0,0,14,26
46452,9,570,9,0,0,0,0,12,21
18589,4,923,10,1,1,0,0,9,21
79251,4,678,11,2,0,0,0,15,28
90787,9,314,11,0,0,0,0,12,23
79822,7,896,4,0,0,0,0,3,7
161774,5,176,19,0,0,0,0,32,51
74709,7,648,6,0,0,0,0,7,13
85756,8,800,16,1,1,0,0,23,41
58286,5,124,39,2,1,0,0,56,98
122961,9,86,58,1,1,0,0,85,145
155572,9,6,12,0,0,0,0,9,21
42791,8,623,17,0,0,0,0,10,27
65307,7,484,14,0,0,0,0,19,33
75224,6,235,199,12,8,0,0,291,510
53006,9,838,12,0,0,0,0,3,15
58040,9,838,4,0,0,0,0,2,6
75455,9,838,4,0,0,0,0,2,6
131664,9,838,4,0,0,0,0,2,6
2361,11,124,8,0,0,0,0,4,12
157890,9,302,6,0,0,0,0,24,30
36951,8,214,27,0,0,0,0,17,44
151649,9,630,52,0,0,0,0,74,126
110545,10,111,5,0,0,0,0,27,32
61413,10,413,3,0,0,0,0,6,9
28005,7,462,23,0,0,12,0,33,68
58428,7,295,26,1,1,0,1,38,67
138366,9,575,42,0,0,0,0,46,88
25336,9,341,23,0,0,0,0,27,50
13785,8,800,4831,242,86,19,39,8710,13927
63229,8,800,6566,269,89,19,31,11392,18366
79185,10,81,1,0,0,0,0,2,3
2838,7,228,22,0,0,0,0,34,56
55110,7,228,24,0,0,0,0,24,48
44669,9,640,0,0,0,0,0,14,14
73644,7,306,1,0,0,0,0,0,1
48622,10,413,8,0,0,0,0,8,16
132364,4,200,8,0,0,0,0,11,19
11121,8,790,29,0,0,0,0,42,71
129950,9,630,28,0,0,0,0,28,56
52396,9,630,25,0,0,0,0,31,56
13658,9,630,12,0,0,0,0,10,22
85013,10,322,6,0,0,0,0,6,12
30313,10,111,12,0,0,0,0,24,36
14207,10,111,16,1,1,0,0,30,48
32175,10,322,4,1,1,0,0,4,10
156988,9,632,8,0,0,0,0,5,13
140604,9,873,8,0,0,0,0,4,12
116174,4,174,33,0,0,0,0,61,94
53883,10,355,16,0,0,0,0,29,45
72679,10,355,30,3,0,0,0,44,77
134809,10,355,6,0,0,0,0,9,15
166902,9,158,7,0,0,0,0,45,52
25345,9,158,18,1,0,0,0,45,64
160691,9,158,14,0,0,0,0,48,62
35575,9,158,4,0,0,0,0,14,18
128983,9,800,8,1,1,0,0,103,113
112507,4,36,43,0,0,0,0,75,118
133482,9,158,1,0,0,0,0,0,1
118437,8,800,2,0,0,0,0,0,2
79005,8,403,1,0,0,0,0,0,1
106560,9,30,10,0,0,0,0,9,19
9866,4,890,11,0,0,0,0,14,25
62048,4,885,17,0,0,0,0,27,44
86174,9,684,4,0,0,0,0,3,7
107421,9,556,4,0,0,0,0,3,7
65478,4,658,18,0,0,0,0,19,37
36987,6,514,52,1,0,1,0,90,144
56616,9,640,25,0,0,0,0,28,53
110614,9,302,8,0,0,0,0,4,12
98661,9,306,1,0,0,0,0,1,2
1920,9,145,27,1,1,0,0,45,74
79679,4,124,399,4,2,0,2,679,1086
88355,11,427,12,0,0,0,0,9,21
124947,8,812,47,2,0,0,0,92,141
23266,8,812,80,5,2,0,0,132,219
153113,8,812,78,5,4,0,1,130,218
144954,7,741,79,4,3,0,0,182,268
114414,9,158,9,0,0,0,0,13,22
35439,9,158,3,0,0,0,0,5,8
159889,9,912,1,0,0,0,0,1,2
138805,4,174,5,0,0,0,0,9,14
66906,9,575,42,1,1,0,0,77,121
154814,9,575,29,2,1,0,0,60,92
170051,8,623,1,0,0,0,0,0,1
107295,8,800,68,1,0,0,1,145,215
167187,10,413,1,0,0,0,0,1,2
487,10,820,1,0,0,0,0,1,2
90537,11,306,43,3,0,0,0,37,83
71042,7,207,5,0,0,0,0,12,17
39435,4,453,4,0,0,0,0,2,6
59726,11,489,8,0,0,0,0,4,12
114999,9,575,32,2,1,0,0,32,67
52229,9,489,75,4,0,0,0,127,206
104007,6,785,69,0,0,0,0,91,160
61412,4,124,4,0,0,0,0,7,11
127546,4,592,41,0,0,0,0,98,139
12233,9,65,5,0,0,0,0,5,10
5934,9,302,8,0,0,0,0,4,12
69022,9,302,4,0,0,0,0,4,8
134383,5,821,4,0,0,0,0,7,11
31290,4,174,26,0,0,0,0,32,58
6037,8,623,57,0,0,0,0,73,130
160264,8,214,5,0,0,0,0,1,6
42893,9,86,51,0,0,5,0,82,138
135838,9,86,12,0,0,4,0,20,36
524,9,86,21,0,0,5,0,29,55
60831,9,538,50,3,0,0,0,52,105
30612,11,214,0,1,0,0,0,0,1
46253,4,200,1,0,0,0,0,4,5
157522,8,214,67,2,0,0,0,134,203
13519,9,78,1,0,0,0,0,0,1
89896,7,748,20,0,0,0,0,29,49
159985,8,693,3,0,0,0,0,9,12
138477,9,489,4,0,0,0,0,5,9
68258,7,578,8,0,0,0,0,11,19
126523,9,483,8,0,0,0,0,11,19
154664,9,30,9,1,1,0,0,9,20
43141,10,413,14,0,0,0,0,13,27
116777,4,124,554,22,15,0,5,862,1458
71014,8,124,7,0,0,0,0,4,11
123178,11,214,28,2,0,0,0,30,60
36226,9,175,4,0,0,0,0,5,9
116862,5,585,11,0,0,0,0,9,20
119116,8,800,17,0,0,0,0,18,35
24245,8,800,4,0,0,0,0,2,6
119090,10,111,28,0,0,0,0,62,90
103351,8,622,53,0,0,0,0,88,141
58155,4,800,32,0,0,0,0,43,75
52082,6,922,7,0,0,0,0,4,11
130409,8,623,3,0,0,0,0,4,7
6933,6,251,4,0,0,0,0,3,7
115845,7,570,0,0,0,0,0,147,147
18704,4,800,1,0,0,0,0,1,2
93737,7,74,17,1,1,0,0,28,47
56009,9,764,19,0,0,0,0,20,39
31488,5,479,35,0,0,0,0,59,94
21990,4,678,30,2,2,0,0,51,85
75729,9,117,14,0,0,0,0,10,24
107410,5,181,56,1,1,0,0,88,146
147487,6,489,11,0,0,0,0,14,25
29736,10,841,15,0,0,0,0,31,46
101180,7,693,19,0,0,0,0,36,55
123693,9,282,20,0,0,0,0,8,28
11975,6,821,12,0,0,0,0,10,22
142586,9,741,107,4,1,1,0,121,234
75775,9,489,63,2,2,0,0,107,174
87564,4,300,1,0,0,0,0,1,2
46879,4,200,5,0,0,0,0,5,10
51586,7,535,0,0,0,0,0,7,7
79850,11,214,20,0,0,0,0,20,40
146318,9,100,45,3,1,0,0,76,125
102981,9,380,22,0,0,0,0,7,29
79626,6,78,38,0,0,0,0,64,102
84003,4,752,2,0,0,0,0,5,7
70241,9,538,101,0,0,0,0,119,220
70186,7,100,0,1,0,0,0,0,1
113265,9,100,0,1,0,0,0,0,1
115114,8,484,30,0,0,0,0,50,80
144542,8,484,73,1,0,0,0,113,187
28601,9,243,293,3,2,1,1,340,640
4770,9,380,12,0,0,0,0,22,34
97142,9,607,99,2,1,0,1,169,272
3637,9,607,24,0,0,0,0,51,75
41907,9,380,10,1,1,0,0,17,29
65162,8,214,18,0,0,0,0,28,46
46051,9,483,4,0,0,0,0,2,6
170751,6,489,7,0,0,0,0,11,18
136168,9,4,14,0,0,0,0,28,42
118089,7,373,9,0,0,0,0,15,24
126561,7,373,17,0,0,0,0,45,62
26617,5,800,1,0,0,0,0,1,2
42589,7,521,28,0,0,0,0,44,72
164666,4,453,8,0,0,0,0,12,20
72185,7,157,1,0,0,0,0,0,1
61530,9,457,13,1,1,0,0,11,26
81999,9,374,36,0,0,0,0,40,76
126669,7,496,14,0,0,0,0,20,34
65581,9,456,6,0,0,0,0,10,16
73101,9,456,4,0,0,0,0,3,7
15181,9,560,3,0,0,0,0,6,9
43513,8,124,163,3,3,0,0,262,431
90291,6,78,5,0,0,0,0,8,13
60620,10,752,4,0,0,0,0,5,9
8264,4,752,4,0,0,0,0,6,10
102161,6,200,2,0,0,0,0,7,9
118702,11,693,17,3,0,0,0,34,54
13624,4,675,32,0,0,0,0,36,68
164862,8,124,18,0,0,0,0,34,52
23380,7,842,43,0,0,0,0,47,90
114870,7,741,1,0,0,0,0,0,1
71186,6,159,22,1,1,0,0,27,51
65673,11,214,2,0,0,0,0,0,2
158899,5,453,6,0,0,0,0,14,20
80612,7,484,7,1,0,0,0,8,16
58341,7,56,4,0,0,0,0,8,12
73411,7,484,4,0,0,0,0,3,7
52305,6,232,1,0,0,0,0,2,3
131985,9,800,1,1,0,0,0,2,4
111478,6,420,38,1,1,0,0,65,105
90179,9,842,3,0,0,0,0,3,6
61429,7,563,7,0,0,0,0,18,25
19967,7,521,12,0,0,0,0,16,28
37843,5,200,36,2,0,0,0,65,103
169836,7,521,5,0,0,0,0,12,17
161615,7,496,77,4,1,0,0,206,288
129526,9,575,3,0,0,0,0,3,6
168227,6,59,122,5,1,0,1,176,305
30399,9,380,14,0,0,0,0,18,32
111822,7,74,76,4,2,0,0,142,224
22476,7,521,2,0,0,0,0,3,5
135951,9,842,2,0,0,0,0,0,2
76123,9,380,95,3,1,1,0,116,216
6926,6,165,227,0,0,0,0,269,496
9642,9,380,5,0,0,0,0,14,19
99847,9,380,8,0,0,0,0,10,18
7680,7,157,18,0,0,0,0,28,46
121184,7,79,22,0,0,0,0,32,54
58484,5,489,1,0,0,0,0,0,1
116764,8,489,3,0,0,0,0,9,12
56405,10,322,3,0,0,0,0,1,4
139849,7,56,2,0,0,0,0,7,9
22740,7,587,797,30,13,5,2,1357,2204
11105,7,56,2,0,0,0,0,3,5
99509,10,820,3,0,0,0,0,6,9
99083,8,623,267,10,5,1,1,435,719
67441,6,479,501,12,1,2,2,884,1402
88368,7,216,82,3,0,0,0,123,208
86132,8,812,50,0,0,0,0,96,146
48506,10,917,9,0,0,0,0,23,32
47657,9,629,2,0,0,0,0,3,5
18192,8,693,2,0,0,0,0,0,2
145226,7,587,88,5,4,0,1,148,246
170690,4,908,5,0,0,0,0,8,13
94198,5,371,6,0,0,0,0,10,16
89814,5,181,106,5,3,0,2,197,313
159009,9,145,6,2,1,0,0,30,39
8002,4,200,89,0,0,0,0,131,220
103408,9,367,83,4,1,0,0,142,230
157274,10,523,18,1,0,0,0,26,45
38890,4,200,2,0,0,0,0,3,5
12490,8,885,2,0,0,0,0,3,5
167864,10,682,2,0,0,0,0,66,68
50744,9,302,51,3,1,0,0,82,137
152051,11,427,38,5,0,0,0,44,87
49619,7,100,22,3,1,0,0,33,59
143266,10,576,2,0,0,0,0,3,5
23539,4,678,1,0,0,0,0,1,2
11253,4,375,6,0,0,0,0,9,15
100599,9,6,4,0,0,0,0,6,10
125833,9,570,56,0,0,0,1,132,189
158654,4,200,16,0,0,0,0,27,43
170643,9,78,5,0,0,0,0,0,5
159708,6,232,18,0,0,0,0,22,40
109946,6,537,57,3,1,0,1,68,130
7149,6,290,32,0,0,0,0,48,80
114601,9,560,9,0,0,0,0,11,20
37414,4,36,6,0,0,0,0,6,12
127286,10,63,25,0,0,0,0,62,87
52463,10,63,50,0,0,0,0,88,138
45163,7,214,26,0,0,0,0,43,69
146592,8,403,970,26,11,0,9,3548,4564
12342,9,380,0,0,0,0,0,4,4
34061,9,380,3,1,1,0,0,9,14
7988,10,217,14,1,1,0,0,29,45
47509,7,216,9,0,0,0,0,3,12
41361,7,611,20,2,1,0,0,35,58
81721,5,225,3,0,0,0,0,1,4
29026,7,587,2,0,0,0,0,27,29
33438,10,653,4,1,0,0,0,7,12
52423,6,58,1,0,0,0,0,2,3
133853,4,200,8,0,0,0,0,16,24
56824,7,30,78,5,0,1,0,157,241
93478,7,157,1,0,0,0,0,3,4
132505,10,653,33,0,0,0,0,46,79
70170,10,653,394,5,2,0,3,685,1089
63827,7,741,32,1,1,0,0,43,77
129862,6,103,51,0,0,0,1,65,117
2683,4,890,4,0,0,0,0,6,10
95822,6,368,3,0,0,0,0,3,6
45998,9,301,9,0,0,0,0,16,25
129559,4,453,12,0,0,0,0,11,23
123609,4,658,3,0,0,0,0,4,7
38046,11,214,4,0,0,0,0,4,8
69053,6,103,8,0,0,0,0,13,21
108999,8,214,8,0,0,0,0,6,14
82569,11,489,6,0,0,0,0,6,12
54404,7,508,4,0,0,0,0,6,10
40308,8,812,11,0,0,0,0,13,24
82762,4,200,49,0,0,0,0,68,117
64733,7,587,48,0,0,0,0,51,99
18482,7,587,16,0,0,0,0,37,53
51838,9,575,7,0,1,0,0,24,32
156593,11,214,9,0,0,0,0,11,20
74665,4,375,10,0,0,0,0,16,26
125848,4,200,19,0,0,0,0,32,51
58408,6,885,4,0,0,0,0,10,14
141875,7,660,19,2,1,0,0,29,51
29052,7,744,7,0,0,0,0,21,28
70013,4,800,18,0,0,0,0,21,39
56036,7,744,2,0,0,0,0,3,5
36770,7,226,3,0,0,0,0,4,7
80739,9,341,6,0,0,0,0,3,9
95225,7,226,8,0,0,0,0,11,19
164714,9,472,5,0,0,0,0,7,12
98012,7,472,12,0,0,0,0,12,24
34040,9,819,20,0,0,0,0,22,42
150406,9,374,40,3,1,1,0,135,180
167389,9,302,32,1,1,0,0,52,86
31737,6,174,0,0,0,0,0,6,6
79352,8,800,248,9,3,0,1,527,788
146704,8,800,7935,138,37,7,33,13283,21433
86231,10,549,12,0,0,0,0,25,37
61106,10,111,18,0,0,0,1,48,67
96642,4,752,4,0,0,0,0,5,9
20749,7,693,268,8,4,2,2,523,807
103577,8,214,71,0,0,0,0,156,227
141970,9,631,2,0,0,0,0,7,9
157924,6,78,98,0,0,0,0,153,251
126047,5,159,20,0,0,0,0,32,52
74535,4,453,3,0,0,0,0,11,14
58943,9,89,419,5,1,1,0,534,960
78079,7,254,49,2,0,0,1,80,132
142773,7,542,4,0,0,0,0,6,10
88673,7,302,126,22,7,0,1,145,301
140106,6,537,18,1,1,0,0,28,48
118528,8,545,296,7,5,0,0,499,807
76379,5,106,6,0,0,0,1,13,20
21986,10,413,6,1,1,0,0,10,18
28701,5,800,1,0,0,0,0,4,5
165263,7,472,13,0,0,0,0,25,38
45894,7,484,6,0,0,0,0,11,17
132453,11,30,61,4,0,0,0,89,154
73712,8,545,1518,74,29,3,5,3109,4738
158870,8,214,525,0,0,0,2,941,1468
25398,5,159,9,0,0,0,0,15,24
99871,7,748,1,0,0,0,0,5,6
30531,9,657,17,1,2,0,1,31,52
109667,9,657,18,0,0,1,0,28,47
50133,10,917,5,2,0,1,0,19,27
143567,9,597,14,1,1,0,1,16,33
65709,9,710,5,0,0,0,0,11,16
68456,10,40,0,0,0,0,0,7,7
104225,6,785,46,2,1,0,0,75,124
101877,4,200,38,0,0,0,0,65,103
694,9,657,55,0,0,0,0,141,196
75803,9,483,4,0,0,0,0,6,10
84754,4,200,58,0,0,0,0,123,181
46936,8,812,10,0,0,0,0,14,24
95614,9,380,13,0,0,0,0,22,35
18902,7,611,1,0,0,0,0,3,4
80196,7,508,1,0,0,0,0,2,3
147177,7,611,2,0,0,0,0,6,8
138488,7,611,1,0,0,0,0,3,4
51787,6,159,18,0,0,0,0,21,39
127751,11,214,9,3,0,0,0,8,20
141759,9,657,52,0,0,1,0,90,143
97491,9,657,3,0,0,0,0,8,11
72311,4,596,27,1,0,0,0,38,66
153287,9,4,57,1,2,1,0,112,173
122140,9,4,11,0,0,0,0,41,52
121765,10,234,16,0,0,0,0,18,34
22855,5,263,16,0,0,0,0,26,42
151994,9,266,14,0,0,0,0,25,39
33704,9,202,8,0,0,0,0,13,21
122723,9,4,18,0,0,0,0,30,48
138761,10,917,11,0,0,0,0,33,44
76923,9,575,30,0,0,0,0,46,76
128321,8,885,3,0,0,0,0,0,3
62793,6,489,2,0,0,0,0,3,5
161957,9,741,48,0,0,0,0,72,120
16864,8,214,929,33,10,1,7,1695,2675
106585,8,214,104,0,0,0,1,188,293
102082,9,800,13,0,0,0,0,22,35
126890,10,111,12,0,0,0,0,17,29
87220,9,800,8,2,0,0,0,21,31
61728,10,111,8,0,0,0,0,16,24
170231,10,903,1,0,1,0,0,4,6
28183,10,413,0,0,1,0,0,3,4
106139,4,658,6,0,0,0,0,20,26
6765,5,159,25,0,0,0,0,35,60
36631,8,800,14,0,0,0,0,2,16
34312,10,653,40,0,0,0,0,52,92
159412,10,917,4,0,0,0,0,6,10
140137,8,623,42,0,0,0,0,58,100
46312,4,36,152,6,6,1,0,268,433
103684,10,628,22,0,0,0,0,26,48
142600,9,489,5,1,0,0,0,12,18
141457,10,628,13,0,0,0,1,28,42
98404,7,56,10,0,0,0,0,20,30
137418,8,124,18,0,0,0,0,13,31
36532,10,781,3,0,0,0,0,5,8
136241,4,923,12,1,0,0,0,22,35
120745,9,630,1,0,0,0,0,0,1
103951,6,221,25,0,0,0,0,40,65
158909,6,827,29,0,0,0,0,58,87
151953,7,521,77,4,2,1,0,106,190
170971,4,800,2,0,0,0,0,4,6
76682,8,800,1,0,0,0,0,0,1
23417,10,781,4,0,0,0,0,8,12
53057,5,140,21,0,0,0,0,38,59
17215,8,214,958,23,7,0,8,1709,2705
63106,7,228,2,0,0,0,0,10,12
51679,9,367,5,0,0,0,0,10,15
170989,9,367,0,1,1,0,0,5,7
107339,9,367,14,1,1,0,0,32,48
7614,4,678,423,3,3,0,3,752,1184
96810,9,367,33,0,0,0,0,51,84
152428,6,232,13,1,1,0,0,36,51
19687,7,864,30,1,1,0,0,56,88
119601,7,78,8,0,0,0,0,12,20
115250,9,30,48,0,0,0,0,67,115
82217,7,521,41,1,1,0,0,59,102
92420,9,107,4,0,0,0,0,16,20
117795,9,107,1,0,0,0,0,5,6
137517,9,341,135,15,3,0,2,215,370
68392,7,243,7,0,0,0,0,7,14
153073,7,492,1,0,0,0,0,0,1
71351,9,589,42,0,0,0,0,58,100
68808,7,374,3,0,0,0,0,4,7
165570,5,851,17,0,0,0,0,26,43
78148,9,325,22,0,2,0,0,36,60
77945,8,812,65,3,3,0,0,103,174
161441,9,710,8,0,0,0,0,37,45
147236,7,472,9,0,0,0,0,9,18
76251,9,489,47,0,0,0,0,75,122
116987,7,489,7,0,0,0,0,10,17
101060,9,819,2,6,0,0,0,18,26
70899,9,819,18,1,0,0,0,52,71
64772,9,819,8,6,0,0,0,14,28
64334,10,817,25,2,1,0,0,48,76
15877,9,42,0,0,0,0,0,4,4
86963,9,368,0,0,0,0,0,3,3
73074,4,306,1538,80,26,11,14,2830,4499
80733,9,456,0,0,0,0,0,3,3
31612,9,456,10,0,0,0,0,13,23
38803,11,214,30,3,0,0,0,29,62
4220,6,789,3,0,0,0,0,7,10
139825,9,560,1,0,0,0,0,2,3
2736,9,560,1,0,0,0,0,1,2
654,10,66,23,0,1,0,1,19,44
158620,4,658,24,0,0,0,0,59,83
51427,10,781,12,0,0,0,0,48,60
18330,9,8,11,0,0,0,0,33,44
12506,9,8,16,2,0,0,0,33,51
669,9,8,123,3,0,0,0,191,317
24221,8,800,35,0,0,0,1,47,83
107783,7,263,9,0,0,0,0,25,34
40446,7,587,88,2,1,0,1,113,205
95351,9,545,4,1,1,0,0,25,31
67713,8,812,166,3,0,0,1,271,441
19261,9,302,0,0,0,0,0,3,3
46709,9,380,3,0,0,0,0,3,6
102817,9,380,4,0,0,0,0,7,11
91994,8,545,61,0,0,0,0,90,151
95813,7,226,2,0,0,0,0,7,9
31736,9,538,67,0,0,0,2,171,240
1101,8,214,768,16,6,1,5,1223,2019
47396,8,214,527,9,4,1,7,874,1422
32525,9,489,152,0,0,0,1,198,351
166353,4,159,31,0,0,0,0,61,92
123925,4,159,17,0,0,0,0,23,40
21924,10,523,26,0,0,0,0,58,84
63780,7,295,17,0,0,0,0,34,51
80723,9,462,2,0,0,0,0,7,9
145833,7,126,5,1,1,0,0,17,24
21213,7,126,11,0,0,0,0,15,26
58412,6,251,1,0,0,0,0,3,4
103099,4,658,1,0,0,0,0,1,2
18853,4,923,5,0,0,0,0,13,18
35912,10,523,20,0,0,0,0,47,67
29588,9,575,48,5,1,0,0,88,142
143735,5,200,60,1,1,0,1,103,166
93678,9,575,7,0,0,0,0,15,22
92113,9,575,4,0,0,0,0,6,10
21018,4,752,6,1,0,0,0,2,9
122351,9,575,6,1,0,0,0,15,22
60857,9,575,10,0,0,0,0,20,30
15933,9,380,2,0,0,0,0,6,8
133502,9,157,37,2,1,0,0,69,109
82768,6,235,215,6,1,1,2,331,556
149245,7,693,2,0,0,0,0,4,6
15994,9,202,8,0,0,0,0,11,19
65819,9,202,1,0,0,0,0,2,3
103377,7,202,3,0,0,0,0,4,7
66837,6,800,40,0,0,0,0,107,147
51352,4,200,1,0,0,0,0,0,1
145093,10,81,28,0,0,0,0,37,65
34528,10,722,47,0,1,0,1,67,116
69017,5,78,15,0,0,0,0,29,44
159282,5,263,1,0,0,0,0,2,3
82601,7,374,8,0,0,0,0,21,29
129014,9,313,3,0,0,0,0,2,5
21270,6,489,2,0,0,0,0,15,17
57191,7,374,4,0,0,0,0,12,16
129564,7,484,11,0,0,0,0,20,31
74820,11,885,29,1,0,0,0,33,63
138709,9,302,19,1,1,0,0,54,75
70485,9,405,6,0,0,0,0,9,15
112120,11,812,11,0,0,0,0,6,17
88404,9,145,24,0,0,0,1,49,74
18936,10,628,12,0,0,0,0,10,22
47972,10,628,6,0,0,0,0,3,9
14276,9,158,28,0,0,0,0,62,90
168718,4,375,15,0,0,0,0,27,42
16450,9,145,1,0,0,0,0,2,3
17978,9,145,1,0,0,0,0,1,2
117872,9,145,12,4,0,0,0,43,59
19903,9,912,3,0,0,0,0,14,17
88677,8,545,303,7,4,0,2,515,831
138980,9,367,75,2,3,0,1,115,196
30837,9,302,47,2,2,0,0,74,125
165599,7,460,1,0,0,0,0,1,2
149802,7,521,17,0,0,0,1,25,43
61574,7,521,1,0,0,0,0,3,4
119178,7,228,31,3,2,1,0,74,111
166439,7,228,10,0,0,0,0,20,30
149549,7,748,4,0,0,0,0,8,12
115930,4,36,127,5,3,0,1,215,351
66982,9,374,2,0,0,0,0,6,8
126959,9,374,10,0,0,0,0,14,24
49443,7,521,1,0,0,0,0,4,5
153433,10,701,2,0,0,0,0,1,3
100969,5,225,0,1,0,0,0,0,1
37380,7,521,64,4,2,0,0,88,158
123594,5,693,3,0,0,0,0,12,15
168639,8,124,46,0,0,0,0,85,131
27387,7,521,23,0,0,0,0,37,60
95303,6,843,10,0,0,0,0,24,34
107621,7,521,17,0,0,0,0,30,47
89066,9,77,426,6,4,0,0,542,978
122963,7,228,36,0,1,0,0,68,105
52766,11,693,12,1,0,0,0,7,20
149393,11,375,34,2,0,0,0,39,75
146490,9,570,513,0,0,0,2,979,1494
153820,9,909,5,0,0,0,0,7,12
40496,7,521,1,0,0,0,0,3,4
108531,7,521,1,0,0,0,0,3,4
116170,9,472,9,1,0,0,0,18,28
20176,9,375,7,0,0,0,0,9,16
105604,9,452,1,0,0,0,0,1,2
166259,7,151,0,0,0,0,0,5,5
95295,6,375,2,0,0,0,0,4,6
137592,4,800,54,0,0,0,0,85,139
49390,5,489,11,0,0,0,0,11,22
51581,8,30,1,0,0,0,0,1,2
47085,9,367,41,0,0,0,1,70,112
144129,8,545,3597,103,38,8,22,6038,9806
111066,9,427,18,0,0,0,0,70,88
8565,7,741,157,3,2,0,1,295,458
158160,9,131,6,0,0,0,1,8,15
108590,9,131,8,0,0,0,1,14,23
4365,4,222,36,1,1,0,1,64,103
10029,9,483,6,0,0,0,0,6,12
52264,7,508,4,0,0,0,0,15,19
7108,10,743,14,0,0,0,0,44,58
101410,7,508,2,0,0,0,0,3,5
56570,6,453,10,0,0,0,0,18,28
124023,7,175,14,0,0,0,0,34,48
41642,7,484,10,0,0,0,0,12,22
31149,8,484,57,0,0,0,0,82,139
143178,7,216,98,1,0,0,0,163,262
135763,9,828,1,0,0,0,0,0,1
117904,9,607,25,0,0,0,0,50,75
45774,9,630,2,0,0,0,0,4,6
19091,6,103,15,0,0,0,0,24,39
8476,6,132,9,0,0,0,0,15,24
59714,5,238,4,0,0,0,0,2,6
83539,6,209,10,0,0,0,0,23,33
54132,6,785,93,3,1,0,0,137,234
90562,9,353,16,0,0,0,0,20,36
118693,11,214,4,0,0,0,0,2,6
53502,7,521,46,2,1,0,1,47,97
85309,11,214,2,0,0,0,0,1,3
106436,7,578,15,0,0,0,1,43,59
5159,10,474,15,1,0,0,0,28,44
4717,7,144,3,0,0,0,0,1,4
123734,7,429,69,0,0,0,0,83,152
85095,11,623,4,1,0,0,0,2,7
28926,10,289,91,4,0,0,0,144,239
113014,9,710,1,0,0,0,0,3,4
127531,9,710,2,0,0,0,1,3,6
80871,5,78,55,1,0,0,0,79,135
43041,8,427,77,0,0,0,0,108,185
117808,8,812,20,0,0,0,0,34,54
37989,8,800,256,4,2,0,0,455,717
106622,8,622,481,5,3,0,3,994,1486
65991,4,658,1,0,0,0,0,0,1
134089,6,200,94,1,0,0,0,128,223
115670,5,78,17,1,1,0,0,35,54
48688,9,489,104,2,4,0,1,173,284
74881,11,812,4,1,0,0,0,3,8
104182,7,302,13,0,0,0,0,17,30
58941,10,806,11,0,0,0,0,35,46
88270,9,100,50,0,0,0,1,115,166
55012,10,523,89,0,0,0,0,131,220
120447,7,157,0,0,0,0,1,127,128
89047,7,228,192,5,3,1,0,305,506
163320,10,322,0,1,1,0,0,0,2
88661,8,622,71,1,1,0,0,141,214
64310,7,100,25,3,3,0,0,37,68
7488,7,194,5,0,0,0,0,9,14
117211,6,78,420,5,2,0,2,633,1062
70216,11,489,4,0,0,0,0,5,9
140797,9,243,76,0,1,0,0,107,184
163097,6,601,72,3,2,0,1,122,200
158132,4,174,7,0,0,0,0,10,17
92261,7,484,4,0,0,0,0,4,8
85354,7,489,27,3,0,0,0,30,60
117612,9,306,13,0,0,0,0,17,30
114964,8,800,2,0,0,0,0,0,2
143166,6,78,23,0,0,0,0,34,57
125810,9,145,22,0,0,2,0,30,54
136781,10,334,2,0,0,0,0,3,5
50285,4,752,3,0,0,0,0,6,9
36188,10,743,6,1,1,0,0,19,27
22115,10,743,0,0,0,0,0,5,5
165740,10,628,7,0,0,0,1,17,25
55437,7,56,66,3,1,0,1,142,213
53253,10,628,6,0,0,0,0,10,16
45989,10,743,6,0,0,0,0,17,23
137573,10,743,2,0,0,0,0,10,12
145528,10,743,0,0,0,0,0,23,23
110159,6,200,645,4,2,0,2,974,1627
37277,6,59,8,0,0,0,0,12,20
37841,9,216,63,2,1,0,0,106,172
124571,9,741,19,0,1,0,0,38,58
115795,7,163,37,1,1,0,0,54,93
166049,9,640,171,4,2,1,2,332,512
151380,10,917,2,0,0,0,0,3,5
25187,8,812,70,5,6,0,0,102,183
137837,11,800,3,0,0,0,0,2,5
43082,9,487,40,4,2,0,0,62,108
18601,9,131,37,0,0,0,1,66,104
43335,10,289,15,0,0,0,0,18,33
115002,7,118,1,0,0,0,0,4,5
42911,7,46,3,0,0,0,0,3,6
16389,9,367,171,4,2,0,1,268,446
100956,9,216,58,2,2,0,0,91,153
154409,8,124,223,8,3,0,0,412,646
47158,7,587,322,10,6,2,3,458,801
24057,8,214,2,0,0,0,0,7,9
11992,4,800,1,0,0,0,0,1,2
65439,10,917,16,1,0,0,0,49,66
44641,10,917,20,0,0,0,0,62,82
55319,10,917,14,0,0,0,2,61,77
67745,10,917,4,0,0,0,0,14,18
78947,10,917,20,1,1,0,0,26,48
2980,10,111,6,0,0,0,0,13,19
48325,7,149,7,0,0,0,0,4,11
99485,7,149,1,0,0,0,0,2,3
30547,7,149,82,1,1,0,0,140,224
62455,7,149,6,0,0,0,0,14,20
63093,7,149,12,0,0,0,1,36,49
135836,9,472,3,0,0,0,0,5,8
101386,8,124,61,4,3,0,0,96,164
90570,7,842,130,11,3,0,0,198,342
128799,8,885,47,0,0,0,0,69,116
133552,11,306,17,0,0,0,0,22,39
87180,7,306,219,1,1,0,0,404,625
87206,9,4,19,0,1,0,0,18,38
138026,7,79,2,0,0,0,0,6,8
153071,4,174,9,0,0,0,0,17,26
98321,7,79,8,0,0,0,0,13,21
116116,4,885,347,4,2,0,0,517,870
84326,9,489,4,0,0,0,0,6,10
159253,5,263,56,0,0,0,0,99,155
159296,8,214,104,8,1,0,1,220,334
84455,4,638,1,0,0,0,0,1,2
86796,4,200,3,0,0,0,0,6,9
105877,8,623,11,0,0,0,0,27,38
111026,9,374,2,0,0,0,0,13,15
94312,9,597,17,1,1,0,0,22,41
161488,9,266,6,0,0,0,0,8,14
137239,9,575,16,0,0,0,0,38,54
17741,9,184,3,0,0,0,0,5,8
83127,9,266,12,0,0,0,0,12,24
68489,4,159,8,0,0,1,0,11,20
134221,9,86,6,2,1,0,0,17,26
140715,4,453,5,0,0,0,0,3,8
127779,9,367,47,0,0,0,0,106,153
159226,11,214,85,1,0,0,0,107,193
161885,5,556,10,0,0,0,0,14,24
37931,8,623,345,6,4,1,3,662,1021
150992,4,306,1,0,0,0,0,0,1
99429,9,575,62,0,0,0,0,90,152
89202,9,607,76,1,1,0,1,118,197
33249,9,607,8,0,0,0,0,0,8
118397,9,575,3,0,0,0,0,11,14
80830,10,549,18,0,1,0,0,53,72
12057,7,713,61,3,1,0,0,131,196
71737,4,658,12,0,0,0,0,17,29
57203,9,489,189,0,0,0,2,273,464
82176,7,521,41,1,1,0,0,56,99
60198,8,214,314,6,2,1,4,548,875
23041,7,587,52,0,0,0,1,98,151
72361,9,575,104,2,1,0,0,123,230
148527,9,375,2,0,0,0,0,5,7
944,9,375,2,0,0,0,0,4,6
124127,9,800,68,3,0,0,3,366,440
146835,9,452,11,2,1,0,0,18,32
144185,11,124,2,0,0,0,0,2,4
78420,10,798,2,0,0,0,0,4,6
164130,9,30,17,1,1,0,1,23,43
44976,7,521,8,0,0,0,0,18,26
55957,7,404,46,0,0,0,1,57,104
31252,5,885,7,0,0,0,0,7,14
65142,8,403,589,2,1,1,4,1202,1799
127555,6,800,8,0,0,0,0,5,13
153402,9,302,343,21,10,2,1,610,987
28493,4,365,20,0,0,0,0,34,54
168980,5,159,7,0,0,0,0,7,14
24616,9,78,38,0,0,0,0,58,96
156127,10,653,7,0,0,0,0,41,48
142380,8,214,315,4,2,0,0,469,790
4988,7,263,11,0,0,0,0,14,25
159602,7,263,8,0,0,0,0,13,21
66135,11,885,131,1,0,0,0,155,287
86370,9,556,11,0,0,0,1,6,18
119569,7,496,6,0,0,0,0,8,14
162047,9,302,26,3,2,0,0,34,65
59625,11,214,7,0,0,0,0,8,15
73424,9,657,42,2,1,0,0,83,128
9236,5,800,6,1,0,0,0,7,14
93255,7,216,198,1,0,0,1,248,448
95296,9,469,14,0,0,0,0,25,39
67453,9,469,9,0,0,0,0,13,22
114475,9,145,77,1,0,0,1,96,175
99315,8,885,187,0,0,0,5,616,808
82796,10,917,17,0,0,0,0,14,31
49630,9,828,0,2,1,0,1,0,4
38632,10,917,6,0,0,0,0,8,14
87090,7,202,11,0,0,0,0,13,24
25897,10,917,26,2,0,0,1,67,96
13649,9,353,8,0,0,0,0,23,31
87628,9,353,2,0,0,0,0,3,5
81435,9,353,4,0,0,0,0,6,10
75932,10,653,157,2,1,1,2,297,460
122617,5,489,329,16,8,1,1,484,839
28098,4,36,108,9,4,0,0,182,303
131295,5,355,37,0,0,0,0,56,93
95588,7,484,32,4,2,0,0,42,80
52440,4,270,9,0,0,0,0,11,20
119673,9,325,11,0,1,0,0,15,27
149444,8,800,589,9,2,3,2,1071,1676
92609,8,800,46,0,0,1,2,95,144
32935,4,36,195,10,4,1,1,375,586
162447,9,658,53,2,1,0,1,61,118
62704,7,496,12,0,0,0,0,18,30
82606,9,607,96,1,0,0,0,227,324
25961,9,538,145,3,2,0,2,225,377
54787,9,469,12,0,0,0,0,23,35
36460,9,658,21,0,0,0,1,28,50
113747,9,607,40,0,0,0,0,69,109
168336,5,124,19,0,0,0,0,28,47
142850,9,30,74,0,0,0,0,118,192
157371,9,607,18,0,0,0,0,32,50
63647,6,728,3,0,0,0,0,6,9
122419,9,452,8,0,0,0,0,18,26
93119,4,270,22,2,1,0,0,45,70
53105,4,159,6,0,0,0,0,8,14
39008,8,885,8,0,0,0,0,6,14
58185,9,306,36,0,0,0,0,92,128
68203,9,658,1,0,0,0,0,2,3
57673,9,79,8,0,0,0,0,19,27
142466,9,510,4,0,0,0,0,6,10
125440,9,315,46,0,0,0,1,74,121
128729,8,427,7,0,0,0,0,13,20
1126,9,657,64,3,1,1,0,93,162
17831,9,658,3,0,0,0,0,6,9
130196,9,489,129,8,2,1,0,218,358
19587,9,800,3,0,0,0,0,8,11
105145,9,145,8,0,1,0,0,11,20
36228,6,537,20,0,0,0,1,28,49
23584,7,295,2,0,0,0,0,3,5
144839,7,295,4,0,0,0,0,3,7
92583,7,77,9,1,1,0,0,32,43
66353,7,295,4,0,0,0,0,5,9
80075,9,575,6,1,1,0,0,29,37
118753,9,483,14,1,1,0,0,28,44
16965,10,653,84,0,0,0,0,106,190
63314,9,367,81,2,2,0,0,109,194
33195,5,453,29,0,0,0,0,45,74
64111,11,214,8,0,0,0,0,13,21
162639,9,741,131,0,0,0,0,165,296
3418,9,741,86,0,0,0,1,127,214
134105,7,30,4,0,0,0,0,11,15
83367,9,741,88,0,0,0,1,121,210
112497,9,378,32,1,1,0,0,89,123
862,8,124,40,0,0,0,0,63,103
17315,9,378,6,0,0,0,0,10,16
19723,9,117,7,0,0,0,0,6,13
92034,9,658,17,3,2,0,0,23,45
161707,9,374,37,4,2,0,0,92,135
84323,11,355,15,0,0,0,0,18,33
3905,6,103,43,2,0,0,0,52,97
167758,9,405,5,0,0,0,0,5,10
79663,7,228,22,0,0,0,0,65,87
147774,9,873,2,0,0,0,0,10,12
115628,9,873,4,0,0,0,0,11,15
36935,7,228,16,0,0,0,0,25,41
117532,4,569,13,0,0,0,0,4,17
93152,10,66,4,0,0,0,0,6,10
34503,9,741,4,0,0,0,0,6,10
70381,9,607,225,9,2,1,2,496,735
37797,7,79,50,1,0,1,2,88,142
103006,7,912,7,0,0,0,0,13,20
121930,9,145,2,0,0,0,0,2,4
49882,10,799,5,0,0,0,0,8,13
125842,9,489,6,0,0,0,0,4,10
12685,9,489,51,0,0,0,2,80,133
138755,9,489,13,0,0,0,0,16,29
167811,6,843,104,3,2,1,0,149,259
37573,9,607,16,2,1,0,0,17,36
129254,10,653,268,5,3,0,2,458,736
115300,10,798,4,0,0,0,0,9,13
170465,7,30,93,5,2,0,0,171,271
111756,9,607,25,2,1,0,0,49,77
91525,9,341,85,0,0,0,0,101,186
27232,7,521,10,0,0,0,0,12,22
143277,4,658,54,1,1,0,0,86,142
162697,7,211,5,0,0,0,0,6,11
107900,7,484,3,0,0,0,0,2,5
142266,9,489,32,0,0,0,0,47,79
38132,8,693,2,0,0,0,0,3,5
92684,11,658,83,3,0,0,1,87,174
17224,9,314,4,0,0,0,0,5,9
50967,9,158,4,0,0,0,0,6,10
67076,7,693,25,3,3,0,0,33,64
152291,7,310,12,0,0,0,0,48,60
95131,7,310,2,0,0,0,0,23,25
158481,9,158,8,0,0,0,0,9,17
37537,10,413,3,0,0,0,0,5,8
56614,9,65,50,1,1,0,0,72,124
36889,5,306,8,0,0,0,0,11,19
101389,9,145,146,2,0,1,0,242,391
92182,7,211,6,0,0,0,0,4,10
15285,5,381,12,0,0,0,0,10,22
136097,9,607,2,0,0,0,0,3,5
60949,7,232,2,0,0,0,0,3,5
105333,5,200,68,0,0,0,1,117,186
121499,9,100,26,0,0,0,0,29,55
143481,8,124,4,0,0,0,0,33,37
228,9,607,1,0,0,0,0,4,5
135058,5,225,74,2,0,0,0,111,187
155641,4,890,92,2,1,0,1,136,232
63192,9,630,51,2,2,0,0,85,140
38954,9,684,1,0,0,0,0,3,4
21754,9,570,13,0,0,0,0,21,34
139345,7,611,4,0,0,0,0,4,8
141478,7,587,22,0,0,0,0,33,55
107892,7,314,2,0,0,0,1,25,28
122646,4,159,3,0,0,0,0,3,6
51722,11,214,51,0,0,0,0,76,127
157770,7,508,4,0,0,0,0,3,7
76512,10,898,9,0,0,0,0,17,26
157149,10,898,8,0,0,0,0,16,24
7918,10,898,45,0,0,0,0,41,86
148512,9,607,6,0,0,0,0,14,20
131565,9,607,37,0,0,0,0,73,110
6177,9,145,54,1,0,0,0,96,151
151539,9,607,65,4,3,1,0,124,197
54589,7,563,45,2,2,0,0,151,200
41424,9,456,2,0,0,0,0,5,7
62310,5,585,7,0,0,0,0,7,14
113246,10,917,11,0,0,0,0,19,30
31540,5,59,33,4,1,0,0,41,79
124385,6,269,103,0,0,0,0,141,244
138336,9,30,28,0,0,0,0,59,87
94172,7,118,2,0,0,0,0,0,2
165086,9,145,11,0,0,0,0,22,33
105517,7,157,42,2,4,0,1,72,121
94472,9,147,36,1,1,0,0,72,110
61522,10,781,9,0,0,0,1,20,30
6980,6,296,7,0,0,0,0,16,23
130443,9,65,5,0,0,0,0,4,9
104968,4,890,39,0,0,0,0,52,91
35970,9,147,17,0,0,0,0,27,44
16791,6,843,102,2,1,0,0,200,305
11950,8,124,5,0,0,0,0,7,12
113046,9,842,82,0,0,0,0,152,234
84304,7,56,96,6,5,0,1,286,394
138343,4,222,36,1,1,0,1,76,115
70329,7,79,10,0,1,0,0,18,29
79526,10,798,8,1,1,0,0,14,24
70222,10,799,8,0,0,0,0,12,20
53211,10,831,11,0,0,0,0,26,37
151715,4,222,13,0,0,0,0,28,41
95094,8,214,7,0,0,0,0,14,21
3670,9,6,5,0,0,0,0,8,13
83234,9,6,1,0,0,0,0,4,5
152315,9,145,16,1,1,0,0,71,89
126838,9,462,2,0,0,0,0,2,4
94267,7,74,5,0,0,0,0,20,25
87823,9,282,1,0,0,0,0,1,2
135988,9,710,1,0,0,0,0,1,2
133204,7,710,1,0,0,0,0,1,2
141580,9,6,57,1,0,0,0,86,144
107882,7,118,6,0,0,0,0,15,21
9387,9,8,22,2,1,0,0,26,51
152217,9,452,7,0,0,0,0,5,12
104811,4,306,2,0,0,0,0,0,2
62838,6,296,4,0,0,0,0,4,8
160853,9,657,74,3,1,0,0,101,179
96678,4,375,2,0,0,0,0,3,5
158428,9,4,7,0,0,0,0,10,17
4976,9,4,12,0,0,0,0,9,21
123994,10,413,10,0,0,0,0,16,26
128002,9,4,21,0,0,0,0,22,43
137155,9,4,34,0,0,0,0,49,83
90935,9,4,24,0,0,0,0,34,58
123043,9,4,56,3,0,0,0,81,140
39182,9,489,19,0,1,0,0,16,36
6267,9,95,4,0,0,0,0,4,8
30653,10,66,50,1,0,0,0,67,118
161837,9,95,6,0,0,0,0,7,13
165345,4,36,52,1,1,0,0,94,148
118725,9,658,12,1,1,0,0,28,42
67662,5,366,23,1,0,0,0,44,68
50537,9,885,20,0,0,0,0,15,35
38630,4,200,16,0,0,0,0,29,45
67252,7,521,1,0,0,0,0,1,2
154014,9,100,105,0,0,0,1,222,328
117555,9,100,131,9,0,0,0,182,322
149895,7,521,5,0,0,0,0,3,8
13751,9,622,10,0,0,0,0,16,26
91894,6,427,15,0,0,0,0,26,41
131886,9,405,38,0,0,10,0,55,103
154624,9,266,6,0,0,0,0,5,11
145726,9,65,2,0,0,0,0,2,4
59627,9,95,11,0,1,0,0,20,32
119967,9,95,7,0,0,0,0,8,15
58102,9,95,7,0,0,0,0,13,20
103158,9,95,6,0,0,0,0,11,17
108898,11,489,6,0,0,0,0,6,12
7096,9,630,1,0,0,0,0,0,1
123076,4,752,11,0,0,0,0,13,24
114131,7,374,6,0,0,0,0,3,9
169044,7,489,65,1,1,0,0,83,150
145195,9,89,50,0,1,0,0,81,132
138678,9,89,44,2,0,0,0,59,105
78333,7,312,0,1,0,0,0,0,1
49992,9,89,26,0,0,0,1,31,58
134543,9,89,23,0,0,0,0,36,59
85319,6,106,70,1,0,0,1,91,163
24595,5,821,16,3,1,0,2,34,56
70880,5,545,35,4,2,0,0,54,95
66142,6,545,59,1,1,0,1,84,146
143525,8,801,40,1,1,0,0,66,108
101905,4,200,4,0,0,0,0,9,13
119911,9,693,13,0,0,0,0,33,46
82396,10,820,4,0,0,0,0,6,10
109730,9,302,22,2,1,0,0,58,83
65309,10,355,7,0,0,0,0,13,20
76281,9,462,10,0,0,0,0,12,22
105868,5,893,2,0,0,0,0,3,5
10953,5,200,14,1,0,0,0,20,35
7399,10,355,6,0,0,0,0,13,19
116797,10,628,55,1,0,0,0,77,133
81237,10,355,8,0,0,0,0,15,23
4932,9,629,2,0,0,0,0,3,5
64234,10,355,2,0,0,0,0,4,6
76763,10,355,2,0,0,0,0,3,5
116845,6,235,282,20,10,2,0,443,757
94299,7,194,29,1,0,0,0,81,111
74050,7,194,10,0,0,0,0,44,54
131037,9,158,0,0,0,0,0,36,36
119071,6,556,83,0,0,0,0,96,179
42588,8,30,1,0,0,0,0,3,4
13715,6,479,235,6,8,0,1,393,643
70321,5,200,45,0,0,0,0,59,104
153210,10,29,10,0,0,0,0,12,22
45,10,208,3,0,0,0,0,4,7
97998,10,653,30,0,0,0,0,46,76
103437,4,174,10,0,0,0,0,11,21
2671,8,545,6,0,0,0,1,11,18
9983,9,452,3,0,0,0,0,5,8
126875,9,452,1,0,0,0,0,1,2
609,9,301,25,1,0,0,1,44,71
119995,8,916,6,0,0,0,0,6,12
141617,8,214,30,0,0,0,0,34,64
85257,10,322,4,0,0,0,0,7,11
105385,9,30,2,0,0,0,0,2,4
129452,9,380,7,0,0,0,0,9,16
77500,9,380,25,4,3,0,0,38,70
121990,9,380,10,0,0,0,0,15,25
161536,9,380,10,0,0,0,0,18,28
19214,9,266,10,0,0,0,0,15,25
87815,4,800,48,0,0,0,0,73,121
30750,10,802,8,0,0,0,0,13,21
162840,11,214,7,0,0,0,0,6,13
98919,4,215,21,0,0,0,0,29,50
81532,9,658,9,2,2,0,0,20,33
83072,6,140,28,0,0,0,0,53,81
129388,9,658,16,3,1,0,0,31,51
78914,10,256,47,0,0,0,1,101,149
53173,9,630,13,0,0,0,0,11,24
98800,9,658,97,7,4,0,1,113,222
54077,10,621,8,0,0,0,0,10,18
141985,9,658,41,1,1,0,0,68,111
51723,6,431,170,9,3,0,0,297,479
5257,9,577,1,0,0,0,0,4,5
34873,8,306,1,0,0,0,0,2,3
24487,6,165,8,0,0,0,0,11,19
66364,4,124,5,0,0,0,0,3,8
73596,5,306,5,0,0,0,0,5,10
87540,9,452,1,0,0,0,0,0,1
78852,11,812,16,0,0,0,0,11,27
167012,7,484,18,5,1,0,0,33,57
74398,9,800,10,1,1,0,0,21,33
13309,8,812,22,0,0,0,0,40,62
41737,6,200,23,0,0,0,0,34,57
30658,10,781,9,0,0,0,0,16,25
52477,11,489,8,0,0,0,0,4,12
9999,9,658,53,1,0,1,2,87,144
162805,10,256,4,0,1,0,0,1,6
39502,8,885,1,0,0,0,0,0,1
46096,7,611,103,1,1,0,0,141,246
45766,5,885,28,0,0,0,0,43,71
84701,10,413,1,0,0,0,0,3,4
146457,6,785,17,0,0,0,0,22,39
74510,6,800,14,0,0,0,0,11,25
134247,9,367,9,0,0,0,0,12,21
159016,6,78,1,0,0,0,0,0,1
87259,4,658,1,0,0,0,0,0,1
76831,9,658,41,4,1,0,0,57,103
143811,7,100,4,0,0,0,0,6,10
31389,5,200,56,2,1,0,0,78,137
144590,7,100,6,0,0,0,0,7,13
66704,9,535,20,0,0,0,0,30,50
104545,9,640,64,1,1,0,0,94,160
93590,9,535,47,0,0,0,0,52,99
80184,10,820,3,0,0,0,0,10,13
13136,7,214,56,0,0,0,0,89,145
30585,4,36,126,0,0,11,0,130,267
74742,9,658,3,0,0,0,0,12,15
52419,4,159,81,0,0,0,1,87,169
37585,7,77,19,0,0,0,0,26,45
99327,10,781,4,0,0,0,0,2,6
121652,10,781,6,0,0,0,0,8,14
81542,10,781,5,0,0,0,0,3,8
41659,9,796,2,0,0,0,0,2,4
106927,8,800,483,16,7,0,4,752,1262
32654,9,842,40,0,0,0,0,63,103
72031,5,181,53,1,1,0,0,103,158
13366,10,549,17,0,0,0,0,35,52
135782,10,549,4,0,0,0,0,4,8
37410,10,549,9,0,0,0,0,22,31
130002,5,200,3,1,1,0,0,7,12
2476,10,618,10,0,0,0,0,21,31
99446,10,66,22,0,0,0,0,44,66
145656,10,628,10,1,0,1,0,24,36
16446,9,78,1,0,0,0,0,18,19
372,11,214,10,1,0,0,0,10,21
67502,8,885,1,0,0,0,0,0,1
97274,7,78,1,0,0,0,0,2,3
79173,10,256,1,0,1,0,0,1,3
73269,4,215,68,4,0,0,0,104,176
65690,9,813,27,0,0,0,0,45,72
69197,4,908,1,0,0,0,0,0,1
19970,9,184,5,2,0,0,0,7,14
109323,4,658,3,0,0,0,0,3,6
83467,9,800,8,0,0,0,0,6,14
95995,9,813,15,0,0,0,0,49,64
7136,6,200,11,0,0,0,0,6,17
1110,8,693,27,0,1,0,0,43,71
131691,6,103,38,1,0,0,0,58,97
58514,4,36,59,0,0,0,0,133,192
96151,11,214,1,0,0,0,0,2,3
110037,6,789,29,0,0,0,0,45,74
161653,7,74,3,0,0,0,0,26,29
140606,7,306,12,0,0,0,0,26,38
10713,9,658,10,0,0,0,0,16,26
57465,9,575,69,0,0,0,0,94,163
147232,5,225,1,0,0,0,0,0,1
167835,7,741,35,0,0,0,0,72,107
37195,7,535,64,1,0,0,0,113,178
8784,9,184,1,0,0,0,0,1,2
100757,9,353,4,0,0,0,0,8,12
35459,9,353,6,0,0,0,0,6,12
167040,10,66,2,0,0,0,0,10,12
104024,10,66,2,0,0,0,0,14,16
164712,7,861,26,2,1,0,0,60,89
137838,7,535,14,0,0,0,0,26,40
74781,10,66,1,0,0,0,0,6,7
119181,10,66,0,0,0,0,0,10,10
47325,10,817,6,0,0,0,0,10,16
144661,10,66,4,0,0,0,0,21,25
74348,10,66,0,0,0,0,0,5,5
78462,5,885,2,0,0,0,0,0,2
17898,11,214,17,0,0,0,0,24,41
123940,4,800,1,0,0,0,0,1,2
76680,5,821,9,0,0,0,0,10,19
138595,9,575,14,0,0,0,0,16,30
156330,9,89,6,0,0,0,0,4,10
45320,8,885,1337,46,20,3,15,2051,3472
48189,7,489,121,4,1,0,0,213,339
79292,9,379,76,8,0,2,0,141,227
92928,9,89,2,0,0,0,0,3,5
56964,9,89,6,0,0,0,0,9,15
64610,9,89,4,0,0,0,0,5,9
61741,9,89,2,0,0,0,0,3,5
122630,9,800,4,0,0,0,0,3,7
115405,9,909,36,0,0,0,0,52,88
84799,6,209,39,0,0,0,0,50,89
12797,9,79,27,1,1,0,0,42,71
161893,6,235,68,0,0,0,1,137,206
161132,11,545,10,0,0,0,0,16,26
165676,11,677,9,0,0,0,0,9,18
15898,11,545,3,0,0,0,0,6,9
108530,11,545,3,0,0,0,0,3,6
28315,11,658,13,1,0,0,0,12,26
50051,11,658,15,4,0,0,0,24,43
122127,11,214,5,0,0,0,0,10,15
61976,5,296,14,0,1,0,0,17,32
96219,5,667,65,2,2,0,0,87,156
145837,8,214,4,0,0,0,0,1,5
135502,6,78,1126,26,15,0,7,1769,2943
32970,8,214,3,0,0,0,0,22,25
102015,11,214,29,3,0,0,0,30,62
21231,4,453,17,0,0,0,0,30,47
156618,4,596,4,0,0,0,0,7,11
16014,8,214,53,0,1,0,0,97,151
71332,11,623,4,0,0,0,0,7,11
136389,11,545,8,1,0,0,0,8,17
104896,11,545,1,1,0,0,0,2,4
161469,4,36,182,3,1,0,2,332,520
156687,9,89,6,0,1,0,0,8,15
60067,10,217,20,0,0,0,0,31,51
61724,11,30,3,0,0,0,0,1,4
78728,11,30,5,0,0,0,0,5,10
105888,4,36,1,0,0,0,0,2,3
158638,7,496,12,0,0,0,0,17,29
51135,9,630,3331,153,29,12,20,6604,10149
42931,11,800,8,0,0,0,0,5,13
29679,9,842,154,6,2,1,0,256,419
127783,11,403,5,0,0,0,0,5,10
95380,11,403,50,2,0,0,0,57,109
115774,11,658,339,22,0,0,0,417,778
10965,11,545,3,0,0,0,0,3,6
91699,11,885,23,1,0,0,0,26,50
43691,11,885,48,2,0,0,0,56,106
165003,11,885,19,1,0,0,0,24,44
105022,4,908,4,0,0,0,0,6,10
5798,7,61,26,0,0,0,0,37,63
156841,9,570,35,4,4,0,0,64,107
116115,9,535,18,0,0,0,0,21,39
155869,9,535,8,0,0,0,0,11,19
99591,9,535,6,0,0,0,1,14,21
49093,7,693,14,0,0,0,0,30,44
105298,7,658,10,0,0,0,0,22,32
19169,10,653,53,1,1,0,1,84,140
100571,9,462,36,1,1,0,0,79,117
21589,9,838,69,3,2,0,0,99,173
68738,4,453,322,8,1,0,1,563,895
48722,9,65,8,0,0,0,0,12,20
36809,4,800,4,0,0,0,0,6,10
2757,4,174,1,0,0,0,0,1,2
106384,9,630,1,0,0,0,0,0,1
64555,9,89,9,0,0,0,0,16,25
67765,10,618,16,0,0,0,0,42,58
41613,9,842,15,1,0,0,0,23,39
113340,9,842,25,1,2,0,0,38,66
68600,4,885,2517,63,22,8,19,4416,7045
126268,7,896,155,4,3,0,0,240,402
157446,6,269,3,0,0,0,0,6,9
51871,9,510,4,0,0,0,0,3,7
50270,9,145,4,0,0,0,0,4,8
118288,9,158,0,0,0,0,0,9,9
18410,10,355,2,0,0,0,0,11,13
19888,8,214,161,5,3,1,2,264,436
2023,9,65,13,0,0,0,0,19,32
167712,5,800,19,0,2,0,0,38,59
102544,10,355,4,0,0,0,0,6,10
32659,4,300,10,0,0,0,0,14,24
26069,4,375,4,0,0,0,0,14,18
112751,7,521,11,0,0,0,0,13,24
150258,7,78,19,0,0,0,0,41,60
60815,9,909,15,0,0,0,0,64,79
43249,9,909,32,1,1,0,0,90,124
14214,9,302,0,0,0,0,0,55,55
49545,6,78,1,0,0,0,0,0,1
3724,9,489,15,0,0,0,0,14,29
5694,10,111,8,0,0,0,0,28,36
35647,10,66,6,0,0,0,0,12,18
137709,9,399,16,0,0,0,0,16,32
118016,9,86,4,0,0,0,0,19,23
27815,9,819,29,0,0,0,1,51,81
5185,9,909,3,0,0,0,0,6,9
62729,7,157,10,0,0,0,0,14,24
149789,6,78,604,19,7,0,5,1089,1724
115938,7,741,26,0,0,0,0,30,56
69981,5,556,3,0,0,0,0,3,6
140200,7,626,7,6,1,0,0,6,20
76828,6,296,76,2,0,1,0,77,156
148319,9,589,11,0,0,0,0,12,23
13941,11,214,2,0,0,0,0,2,4
87148,6,453,1,0,0,0,0,2,3
153367,4,638,43,1,0,5,0,51,100
116006,4,752,1,0,0,0,0,0,1
11424,9,8,14,3,1,0,0,32,50
119525,7,556,26,0,0,0,0,36,62
123622,5,232,223,4,2,0,0,130,359
102346,7,207,18,1,0,0,2,52,73
150303,4,36,77,0,0,0,0,117,194
99774,8,403,12,0,0,0,0,13,25
10984,7,489,1779,51,23,11,14,3822,5700
123526,10,256,9,0,0,0,0,38,47
151511,7,471,8,0,0,0,0,20,28
119731,9,640,61,1,1,0,0,110,173
131983,10,576,14,0,0,0,0,21,35
142242,7,306,3,0,0,0,0,0,3
125280,5,306,22,0,0,0,0,40,62
38208,10,576,2,0,0,0,0,3,5
154860,7,306,1,0,0,0,0,0,1
20068,10,413,6,0,0,0,0,10,16
70547,6,209,9,0,0,0,0,12,21
138456,7,56,11,0,0,0,0,18,29
16625,6,209,7,0,0,0,0,14,21
60334,4,375,1,0,0,0,0,1,2
140005,11,124,5,0,0,0,0,6,11
137734,11,124,1,0,0,0,0,0,1
32608,9,657,6,0,0,0,0,11,17
9381,10,621,4,0,0,0,0,4,8
135928,7,78,12,0,0,0,0,16,28
134009,5,893,9,0,0,0,0,17,26
83574,9,800,8,0,0,0,0,18,26
990,9,800,11,0,0,0,0,13,24
22332,9,800,6,0,0,0,0,11,17
141906,11,545,4,0,0,0,0,5,9
10707,9,800,2,0,0,0,0,3,5
115925,9,800,2,0,0,0,0,3,5
122540,9,800,31,1,1,0,1,64,98
8754,11,489,7,1,0,0,0,4,12
56164,8,623,2,0,0,0,0,5,7
22051,11,214,18,0,0,0,0,17,35
91468,9,828,2,0,0,0,0,3,5
84280,6,453,57,1,0,0,0,83,141
38076,7,56,2,0,0,0,0,6,8
666,6,453,4,0,0,0,0,3,7
144226,6,453,3,0,0,0,0,2,5
21393,10,911,128,11,3,0,0,193,335
119319,7,56,5,0,0,0,0,17,22
90422,9,828,2,0,0,0,0,3,5
29919,10,81,4,0,0,0,0,3,7
87041,9,89,15,0,0,0,0,23,38
73432,9,89,36,0,0,0,1,59,96
79753,10,841,15,0,0,0,0,25,40
23653,5,78,39,1,0,0,0,68,108
6547,7,741,30,0,0,0,0,37,67
58196,9,89,12,0,0,0,0,19,31
57021,9,842,70,0,0,0,0,117,187
60237,7,126,3,0,0,0,0,5,8
31942,7,384,12,0,0,0,0,8,20
30459,9,838,2,0,0,0,0,3,5
110865,7,384,4,0,0,0,0,6,10
90244,7,601,16,0,0,2,0,28,46
62628,9,632,2,0,0,0,0,4,6
10149,9,532,4,0,0,0,0,8,12
130780,7,384,4,0,0,0,0,4,8
127797,9,367,70,2,1,0,0,129,202
17359,8,623,112,6,5,0,0,172,295
156642,11,403,10,0,0,0,0,9,19
149005,6,505,21,2,2,0,0,49,74
100088,9,175,2,0,0,0,0,6,8
165032,9,157,39,1,1,0,0,48,89
82994,6,922,4,0,0,0,0,11,15
91417,9,607,2,0,0,0,0,5,7
134349,10,66,87,2,2,0,0,147,238
88922,9,6,10,0,0,0,0,13,23
50139,9,6,52,1,0,1,0,76,130
147610,5,489,535,11,6,0,2,886,1440
71824,9,107,5,0,0,0,0,6,11
160038,9,107,13,1,1,0,0,23,38
62293,9,6,2,0,0,0,0,2,4
95026,9,6,2,0,0,0,0,4,6
104222,9,607,44,4,2,0,0,82,132
36777,9,158,11,0,0,0,1,47,59
90265,9,800,8,0,0,0,0,13,21
154203,9,353,8,0,0,0,0,11,19
1994,8,562,240,2,1,0,1,370,614
66502,9,353,2,0,0,0,0,4,6
104208,9,202,6,0,0,0,0,9,15
26592,7,379,19,0,0,0,1,31,51
29587,6,235,146,2,3,0,2,234,387
136647,7,611,6,0,0,0,0,10,16
152442,10,653,22,0,0,0,0,29,51
96995,9,353,2,0,0,0,0,0,2
49674,8,403,88,0,0,0,1,154,243
34692,11,355,8,0,0,0,0,6,14
79041,7,126,9,0,0,0,1,21,31
170719,9,367,41,0,1,0,1,100,143
72230,8,403,18,0,0,0,0,30,48
134911,9,353,8,0,0,0,0,10,18
15578,9,452,7,1,1,0,0,11,20
58573,6,103,27,0,0,0,0,34,61
32397,8,885,2,0,0,0,0,2,4
6888,10,898,3,0,0,0,0,5,8
112060,10,898,11,0,0,0,1,18,30
101133,8,403,210,1,1,0,4,515,731
62989,8,403,23,1,0,0,0,35,59
84426,8,403,22,0,0,0,0,33,55
160056,8,403,183,1,0,0,1,311,496
21814,10,474,9,0,0,0,0,18,27
88036,5,200,83,1,0,0,0,122,206
28905,9,838,5,0,0,0,0,8,13
135271,9,658,54,1,1,0,0,88,144
82220,5,489,5,0,0,0,0,5,10
42879,9,483,17,1,1,0,0,55,74
131553,5,124,358,2,1,0,1,529,891
154057,9,301,5,1,1,0,0,16,23
21978,9,301,2,0,0,0,0,0,2
146937,9,483,5,0,0,0,0,9,14
59155,7,61,28,0,1,0,0,40,69
113464,7,61,39,1,0,1,0,73,114
146060,10,820,20,0,0,0,0,36,56
153378,7,263,23,0,0,0,0,41,64
81797,10,798,2,0,0,0,0,2,4
90905,9,489,5,0,0,0,0,6,11
158346,9,489,4,0,0,0,0,11,15
112463,9,489,4,0,0,0,0,6,10
131333,4,375,18,0,0,0,0,34,52
49303,9,341,22,1,1,0,0,44,68
80973,9,315,3,0,0,0,0,6,9
98880,9,243,2,0,0,0,0,4,6
41063,9,469,46,0,0,0,0,78,124
104074,9,469,7,0,0,0,0,12,19
27124,9,469,7,0,0,0,0,9,16
108842,6,785,8,0,0,0,0,10,18
78803,5,225,76,2,0,0,0,106,184
8511,11,30,2,0,0,0,0,2,4
60041,7,194,9,0,0,0,0,7,16
65515,7,194,11,0,0,0,0,12,23
80630,7,194,30,0,0,0,0,52,82
62291,7,429,31,0,0,0,0,96,127
44536,9,714,2,0,0,0,0,2,4
66785,9,704,20,0,0,0,0,44,64
153982,9,202,6,0,0,0,0,6,12
13467,9,301,13,0,0,0,0,23,36
146743,9,456,20,0,0,0,0,37,57
156386,9,243,8,1,1,0,0,6,16
3503,9,714,2,0,0,0,0,2,4
121161,9,367,28,0,0,0,0,34,62
21209,7,79,9,1,0,1,0,31,42
52050,9,575,29,0,0,0,0,36,65
61368,9,314,11,0,0,0,0,15,26
123495,7,861,8,0,0,0,0,15,23
23567,6,218,19,1,2,0,0,25,47
3336,7,741,17,0,0,0,0,27,44
88943,6,489,6,1,0,0,0,13,20
161831,9,842,1,0,0,0,0,0,1
17350,10,781,72,2,1,0,0,97,172
110302,7,496,4,0,0,0,0,6,10
164051,11,214,2,0,0,0,0,3,5
146447,9,341,14,0,0,0,0,25,39
14817,9,202,20,0,0,0,0,21,41
114235,9,117,71,4,2,1,0,170,248
105682,11,30,51,5,0,0,0,46,102
5427,8,623,40,0,0,0,1,56,97
24255,8,623,26,0,0,0,1,46,73
87813,8,214,463,1,0,0,2,740,1206
142496,11,214,10,1,0,0,0,11,22
138491,11,812,8,0,0,0,0,8,16
75395,9,158,25,1,0,0,0,43,69
53403,4,220,2,0,0,0,0,4,6
149713,9,374,2,0,0,0,0,19,21
87946,4,188,7,0,0,0,0,15,22
52009,7,100,2,0,0,0,0,3,5
27370,7,484,1,0,0,0,0,1,2
71567,4,174,1,0,0,0,0,0,1
159528,8,545,495,29,12,0,4,811,1351
88159,8,489,10,0,0,0,0,6,16
137834,5,800,1,0,0,0,0,0,1
87949,9,314,90,4,0,0,0,148,242
153375,9,657,44,0,0,0,0,47,91
136770,4,174,1,0,0,0,0,0,1
1864,9,202,5,0,0,0,0,5,10
40448,9,202,1,0,0,0,0,0,1
63063,9,202,8,1,1,0,0,6,16
74667,6,159,12,0,0,0,0,17,29
86872,5,479,75,0,0,0,0,145,220
55861,9,657,9,0,0,2,0,12,23
138146,5,225,112,4,1,0,2,212,331
75357,9,457,2,0,0,0,0,2,4
22608,8,124,1,0,0,0,0,23,24
72971,8,214,93,0,0,0,0,139,232
157563,10,831,3,0,0,0,0,6,9
26404,5,200,147,2,1,0,1,243,394
95263,8,693,1,0,0,0,0,0,1
36942,9,6,12,0,0,0,0,11,23
1020,8,214,257,3,1,0,4,436,701
7120,4,200,13,0,0,0,0,20,33
104281,9,158,5,0,0,0,0,16,21
57983,9,158,12,0,0,0,0,18,30
144154,9,158,7,0,1,0,0,10,18
5997,6,59,66,3,2,0,2,113,186
91121,5,489,2,3,0,0,0,3,8
49782,4,658,119,0,0,0,1,164,284
82205,4,174,2,0,0,0,0,5,7
72610,4,200,13,0,0,0,0,14,27
119008,8,214,87,2,0,0,0,126,215
296,7,56,4,0,0,0,0,3,7
77062,6,59,13,0,0,0,0,15,28
49679,7,429,78,3,0,0,0,91,172
89726,7,535,2,0,0,0,0,57,59
111251,6,368,32,0,0,0,1,36,69
36698,7,100,1,0,0,0,0,1,2
88127,9,469,21,1,0,0,0,37,59
41704,9,452,22,0,0,0,0,49,71
32109,9,6,2,0,0,0,0,4,6
136680,7,693,43,3,1,1,1,77,126
62930,9,597,13,1,1,0,0,21,36
59090,9,367,8,0,0,0,0,15,23
141781,9,597,37,1,1,0,0,51,90
63597,9,589,48,0,0,0,0,76,124
153069,6,78,62,1,0,0,2,90,155
115484,5,893,274,6,3,2,0,356,641
153797,9,909,7,0,0,0,0,7,14
58363,7,306,334,2,2,0,1,720,1059
70026,9,158,44,0,1,0,0,72,117
102256,9,597,60,3,0,1,0,87,151
38577,7,367,36,0,0,0,0,43,79
63086,5,238,6,0,0,0,0,10,16
112268,8,214,8,0,0,0,0,10,18
134025,9,6,52,3,4,0,0,72,131
18599,5,375,19,0,0,0,0,26,45
68747,9,484,48,0,0,0,1,74,123
52328,10,81,10,0,0,0,0,21,31
27198,10,917,10,1,0,0,0,20,31
148286,9,452,7,2,1,0,0,14,24
119820,9,380,5,0,0,0,0,11,16
146173,9,380,5,0,0,0,0,12,17
106931,9,380,13,0,0,0,0,17,30
116946,4,453,1,0,0,0,0,0,1
58816,8,214,416,0,0,0,2,630,1048
26025,6,339,2,0,0,0,0,0,2
126177,6,843,31,2,0,0,0,95,128
120336,5,218,27,0,0,0,0,43,70
59393,5,124,90,7,1,1,0,150,249
72405,9,622,18,0,0,0,0,22,40
71740,9,622,41,1,1,0,0,60,103
90127,9,341,8,0,0,0,0,10,18
123584,9,341,32,0,0,0,0,48,80
69313,9,158,0,0,0,0,0,4,4
65555,7,741,3,0,0,0,0,5,8
93475,10,917,5,0,0,0,0,8,13
81320,7,741,4,1,0,0,0,12,17
79569,9,575,6,0,0,0,0,7,13
90508,8,403,1,0,0,0,0,1,2
52457,9,42,12,0,1,0,0,17,30
89668,8,214,108,2,2,0,2,250,364
77915,9,640,14,3,1,0,0,31,49
170291,10,820,2,0,0,0,0,2,4
10333,6,200,6,0,0,0,0,11,17
94766,4,174,6,0,0,0,0,3,9
27649,4,780,9,0,0,0,0,2,11
142635,4,159,48,0,0,0,0,72,120
45072,4,159,1,0,0,0,0,1,2
10956,9,452,15,0,0,0,0,27,42
47451,10,781,2,0,0,0,0,3,5
4558,6,718,2,0,0,0,0,4,6
169991,10,831,53,1,1,0,0,77,132
16967,10,831,2,0,0,0,0,0,2
45318,11,214,25,3,0,0,0,24,52
26012,7,484,1,0,0,0,0,5,6
40904,7,484,1,0,0,0,0,0,1
14720,7,484,2,0,0,0,0,0,2
103857,9,489,10,0,0,0,0,12,22
170839,7,748,11,0,0,0,0,18,29
21899,5,200,109,5,1,0,0,154,269
94646,9,800,2,0,0,0,0,3,5
5389,5,489,84,6,2,0,0,159,251
60887,5,218,1,0,0,0,0,1,2
121398,10,653,160,6,3,0,2,324,495
126029,8,214,15,0,0,0,0,22,37
82777,8,545,1,0,0,0,0,0,1
123871,9,380,8,1,1,0,0,15,25
130873,9,374,6,0,0,0,0,7,13
86632,9,374,60,1,1,0,0,58,120
79734,8,623,1,0,0,0,0,1,2
70987,7,641,8,0,0,0,0,15,23
136816,7,535,16,2,0,0,0,33,51
98109,9,368,2,0,0,0,0,3,5
146598,8,623,156,2,2,0,1,263,424
88369,7,535,6,0,0,0,0,12,18
134271,7,149,7,0,0,0,0,13,20
81692,9,449,1,0,0,0,0,0,1
55462,10,322,3,0,0,0,0,7,10
17974,6,165,15,0,1,0,0,23,39
33861,9,374,13,0,1,0,0,37,51
56680,8,214,92,0,0,0,0,128,220
14282,10,550,28,2,0,0,0,63,93
170705,10,550,7,0,0,0,0,33,40
45921,10,550,5,0,0,0,0,29,34
104628,10,550,19,0,0,0,0,41,60
2092,7,748,5,0,0,0,0,4,9
115662,10,550,6,0,0,0,0,18,24
140144,7,521,9,0,0,0,0,27,36
98389,9,575,39,1,1,0,0,62,103
70218,9,492,10,0,0,0,0,0,10
120959,7,79,4,0,0,0,0,10,14
15062,9,492,4,0,0,0,0,0,4
67319,4,36,116,2,1,0,1,211,331
82270,4,36,403,15,12,1,2,769,1202
57765,4,174,7,0,0,0,0,12,19
3582,5,176,3,0,0,0,0,4,7
62826,7,429,16,1,1,0,0,28,46
22779,8,214,8,0,0,0,0,15,23
129563,9,570,1,0,0,0,0,2,3
128700,7,800,24,0,0,0,0,56,80
117249,7,214,7,0,0,0,0,19,26
144428,9,341,20,0,0,0,0,23,43
12425,9,819,10,1,0,0,0,24,35
129907,9,314,3,0,0,0,0,12,15
106224,9,302,10,0,0,0,0,10,20
30651,6,78,37,0,1,0,0,49,87
6327,7,312,7,0,0,0,0,11,18
139009,9,341,20,2,1,0,0,32,55
69206,5,200,11,0,0,0,0,16,27
16720,6,78,52,1,1,0,1,79,134
138182,10,653,34,0,0,0,0,101,135
143554,9,341,9,1,1,0,0,16,27
92392,8,489,303,3,0,0,1,485,792
145648,9,472,30,2,0,0,0,56,88
111091,6,103,5,0,0,0,0,3,8
6389,9,706,2,0,1,0,0,5,8
78386,9,145,6,0,0,0,0,8,14
88663,9,341,9,0,0,0,0,19,28
48206,8,489,445,6,3,0,1,738,1193
55221,8,214,35,0,0,0,0,48,83
37887,9,341,147,1,1,0,1,159,309
147647,11,214,20,0,0,0,0,24,44
165159,7,149,5,0,0,0,0,6,11
91676,4,36,51,0,0,0,0,60,111
150768,7,570,7,0,0,0,0,10,17
107670,9,302,8,0,0,0,0,13,21
2753,9,657,2,0,0,0,0,4,6
79117,8,885,4,0,0,0,0,6,10
110496,9,341,4,0,0,0,0,10,14
95881,9,341,37,0,0,0,0,50,87
17423,6,221,229,2,2,0,0,329,562
116655,9,630,4,0,0,0,0,3,7
156681,4,800,2,0,0,0,0,5,7
163583,9,399,4,0,0,0,0,5,9
2629,4,885,14,0,0,0,0,15,29
125229,9,484,2,0,0,0,0,3,5
56747,8,214,730,13,7,1,2,1204,1957
162974,6,922,52,0,0,0,0,62,114
5024,9,640,27,0,0,0,0,43,70
66292,5,585,4,0,0,0,0,5,9
8662,10,523,8,0,0,0,0,42,50
57863,10,576,3,0,0,0,0,7,10
57831,5,225,110,0,0,1,0,153,264
54227,10,413,21,0,0,0,1,20,42
128469,9,575,32,1,1,0,0,40,74
5682,9,575,20,0,0,0,0,37,57
139135,9,575,20,2,0,0,0,39,61
19194,9,575,3,0,0,0,0,15,18
169215,9,575,4,1,1,0,0,20,26
83235,4,885,2,0,0,0,0,3,5
115719,9,462,2,0,0,0,0,3,5
166283,10,66,4,0,0,0,0,28,32
37459,8,214,3,0,0,0,0,3,6
109245,10,66,1,0,0,0,0,0,1
89519,10,66,1,0,0,0,0,0,1
135030,9,575,38,1,0,0,0,37,76
19372,9,78,2,0,0,0,0,11,13
116087,5,489,11,0,0,0,0,16,27
115065,9,367,11,0,0,0,0,12,23
115880,9,379,14,0,0,0,0,20,34
78015,6,489,506,21,9,0,10,924,1470
158853,9,243,77,1,2,0,1,105,186
165015,9,243,4,0,0,0,0,3,7
106551,6,124,83,4,2,0,0,111,200
17715,9,607,7,1,1,0,0,12,21
74718,7,909,24,1,1,0,0,38,64
35162,6,561,4,0,0,0,0,5,9
68969,9,693,8,0,0,0,0,7,15
64853,9,693,5,0,0,0,0,6,11
32043,4,200,2,0,0,0,0,2,4
4404,9,427,10,0,0,0,0,10,20
130660,6,235,431,22,8,1,1,663,1126
166336,8,214,72,0,0,0,0,109,181
92116,11,306,10,1,0,0,0,7,18
78289,8,214,104,0,0,0,1,192,297
44858,5,893,24,0,0,0,0,37,61
70510,4,375,2633,117,54,12,16,5404,8236
20093,7,693,19,0,0,0,1,26,46
38458,6,106,84,4,2,0,1,143,234
100109,5,693,19,0,0,0,0,22,41
47271,5,176,36,0,0,0,0,45,81
54368,9,630,1,0,0,0,0,0,1
47832,9,30,57,2,1,0,0,88,148
129314,8,124,4,0,0,0,0,5,9
9629,6,215,25,0,0,0,0,48,73
102107,7,157,8,0,0,0,0,14,22
7338,8,214,257,0,0,0,1,442,700
123788,10,111,36,0,0,0,0,73,109
124821,9,589,2,0,0,0,0,1,3
158201,8,812,2,0,0,0,0,2,4
157284,9,30,40,0,0,0,0,48,88
89830,10,81,2,0,0,0,0,8,10
61000,10,81,0,0,0,0,0,8,8
163111,10,81,0,0,0,0,0,7,7
128474,7,74,22,0,0,0,0,32,54
159826,9,589,89,2,1,0,0,30,122
158912,11,214,2,0,0,0,0,2,4
87184,10,781,5,0,0,0,0,7,12
73890,4,36,152,3,3,0,0,251,409
96175,7,484,4,0,0,0,0,4,8
132735,7,492,4,0,0,0,0,6,10
106319,7,822,16,0,1,0,0,25,42
65644,9,575,35,0,0,0,0,40,75
164254,9,452,10,0,0,0,0,14,24
85926,9,302,1,0,0,0,0,1,2
158492,9,452,17,3,0,0,0,20,40
30682,10,918,4,1,1,0,0,0,6
158186,7,611,2,0,0,0,0,3,5
72410,9,158,3,0,1,0,0,12,16
96675,10,111,8,0,0,0,0,7,15
18914,9,483,2,0,0,0,0,3,5
43443,8,214,424,7,3,0,1,641,1076
131751,9,315,1,0,0,0,0,0,1
22298,7,587,43,0,0,0,0,53,96
79139,10,799,2,0,0,0,0,5,7
65232,7,263,30,0,0,0,1,55,86
62601,9,560,2,0,0,0,0,8,10
18900,7,295,2,0,0,0,0,3,5
114641,9,30,7,1,1,0,0,18,27
59586,5,200,79,2,0,0,1,111,193
159480,8,800,56,0,0,0,0,106,162
30260,5,124,79,0,0,0,0,125,204
64855,5,78,178,3,2,0,2,272,457
15164,7,489,132,6,2,1,0,197,338
157682,7,489,156,21,7,1,0,267,452
122182,7,489,90,4,2,0,1,193,290
75171,9,78,67,0,0,0,0,98,165
7366,9,78,4,0,0,0,0,5,9
131583,7,374,1,0,0,0,0,4,5
59989,8,124,130,7,2,0,1,224,364
28947,9,452,1,0,0,0,0,2,3
76641,7,263,30,0,0,0,1,50,81
71426,4,36,5,0,0,0,0,4,9
83448,10,29,13,0,0,0,0,21,34
2015,9,367,8,0,0,0,0,15,23
20751,6,200,30,1,1,0,0,50,82
92102,6,200,52,1,1,0,0,94,148
50247,6,821,9,0,0,0,1,11,21
24102,9,367,180,3,0,0,0,251,434
152117,11,214,11,1,0,0,0,8,20
8119,9,489,403,32,15,4,4,653,1111
6851,9,489,187,0,0,0,4,330,521
26486,9,243,10,0,0,0,0,12,22
123363,9,243,25,1,0,0,0,46,72
147937,9,243,22,0,1,0,0,26,49
135755,9,243,88,3,1,0,1,89,182
131124,9,243,32,0,0,0,0,45,77
6043,7,587,30,0,0,0,0,48,78
948,9,607,21,0,0,0,0,48,69
112552,9,243,4,0,0,0,0,41,45
84510,9,607,15,0,0,0,0,25,40
45137,7,484,11,0,0,0,0,13,24
5055,9,158,41,1,0,0,2,56,100
61729,9,65,24,1,1,0,1,38,65
20204,7,741,74,2,0,0,1,125,202
64582,8,623,3,0,0,0,0,4,7
301,5,78,131,0,0,0,0,213,344
134797,9,630,6,0,0,0,0,11,17
139809,7,896,4,0,0,0,0,5,9
125114,4,453,244,5,3,0,1,352,605
28906,7,542,18,0,0,0,0,24,42
103816,7,196,10,0,0,0,0,8,18
31883,4,752,307,3,2,0,1,504,817
143149,6,366,120,5,0,0,0,227,352
15691,6,453,17,0,0,0,0,25,42
70047,4,174,123,2,0,0,1,231,357
13702,7,872,30,0,0,0,0,32,62
156869,9,65,12,0,0,0,0,18,30
128999,5,371,9,0,0,0,0,10,19
21395,9,65,10,0,0,0,0,13,23
111571,9,131,7,0,0,0,0,9,16
75784,4,365,8,0,0,0,0,12,20
39248,4,174,1,0,0,0,0,0,1
45098,4,159,69,2,1,0,1,127,200
163526,4,115,2,0,0,0,0,0,2
10663,9,158,19,0,0,0,1,27,47
39599,9,158,10,0,0,0,0,10,20
109692,10,618,7,0,0,0,0,17,24
46330,9,483,12,0,0,0,0,20,32
51488,9,158,3,0,0,0,0,11,14
112765,7,228,53,1,2,0,0,97,153
53861,4,752,457,4,4,0,8,828,1301
66332,9,79,18,0,0,0,0,32,50
170216,10,798,5,0,0,0,0,16,21
157552,10,322,2,0,0,0,0,3,5
60833,8,214,757,6,2,2,3,1174,1944
141761,8,214,213,1,0,0,0,312,526
169503,8,214,267,2,1,0,1,431,702
156331,8,214,632,14,10,1,4,971,1632
27463,7,211,9,0,0,0,0,14,23
106071,7,211,14,0,0,0,0,15,29
139877,6,269,6,0,0,0,0,6,12
94926,7,285,2,0,0,0,0,3,5
52145,9,243,34,2,1,0,0,38,75
127574,9,243,15,0,0,0,0,29,44
146889,9,243,7,0,0,0,0,15,22
24954,9,243,2,0,0,0,0,1,3
26151,9,243,8,0,0,0,0,8,16
35644,9,243,28,0,0,0,0,29,57
21341,9,243,14,0,0,0,0,14,28
142984,4,200,39,0,0,0,0,66,105
101629,11,214,7,0,0,0,0,6,13
92014,5,200,51,2,0,0,1,81,135
120603,10,355,2,0,0,0,0,3,5
120160,10,653,33,0,0,0,0,47,80
123265,10,104,25,0,0,0,0,112,137
60559,7,587,68,0,0,0,0,120,188
68013,7,587,31,0,0,0,0,35,66
134602,7,587,44,1,0,0,0,79,124
92174,10,355,4,0,0,0,0,20,24
109849,10,628,2,0,0,0,0,2,4
91912,6,209,4,0,0,0,0,9,13
112334,10,322,2,0,0,0,0,2,4
46227,10,322,2,0,0,0,0,2,4
116008,9,483,2,0,0,0,0,4,6
39541,7,492,17,0,0,0,0,14,31
122037,10,66,2,0,0,0,0,3,5
98604,7,373,29,1,0,0,1,35,66
54158,10,682,1,0,0,0,0,1,2
110252,10,682,1,0,0,0,0,1,2
48073,4,365,6,0,0,0,0,8,14
26056,4,365,6,0,0,0,0,7,13
101111,4,365,6,0,0,0,0,7,13
39126,9,243,9,0,1,0,0,20,30
146456,9,838,74,1,1,0,0,109,185
123328,8,214,1029,22,9,2,1,1752,2815
159225,8,214,92,0,0,0,0,136,228
169222,4,36,46,1,1,0,0,65,113
166520,4,270,11,0,0,0,0,31,42
113116,7,306,2,0,0,0,0,2,4
95761,4,36,150,1,0,0,0,155,306
103729,7,373,18,0,0,0,0,25,43
148986,6,693,9,0,0,0,0,9,18
145996,10,550,49,0,0,0,0,84,133
31202,7,228,14,0,0,0,0,20,34
139,5,235,38,1,0,0,0,57,96
56481,8,885,28,0,0,0,0,37,65
132014,10,104,74,0,0,0,0,110,184
129098,7,551,14,0,0,0,0,7,21
71264,7,384,4,0,0,0,0,7,11
19440,7,551,26,0,0,0,0,40,66
85545,7,864,10,0,0,0,0,11,21
103169,6,514,2,0,0,0,0,6,8
149879,6,106,63,7,0,0,0,100,170
170057,5,106,1,0,0,0,0,1,2
102054,8,214,7,0,0,0,0,10,17
117223,10,841,10,0,0,0,0,9,19
127917,10,81,16,0,0,0,1,41,58
170900,10,81,30,0,0,0,0,53,83
143648,8,214,594,7,2,0,4,958,1565
7788,8,214,968,22,3,2,4,1547,2546
7081,7,157,1,0,0,0,0,0,1
63312,5,181,8,0,0,0,0,14,22
41612,9,575,4,0,0,0,0,12,16
22712,6,269,30,0,0,0,0,46,76
95,8,214,472,6,2,1,5,755,1241
24310,6,643,1,0,0,0,0,0,1
39828,8,214,220,1,0,0,3,389,613
82609,10,798,3,0,0,0,0,4,7
125309,7,563,0,0,0,0,0,14,14
5022,9,622,24,0,0,0,0,48,72
35742,8,812,63,1,3,0,0,107,174
147211,7,556,0,0,0,0,0,5,5
25143,10,104,45,1,1,0,0,102,149
46186,8,403,1162,74,17,0,8,2366,3627
24086,6,290,7,0,0,0,0,8,15
27780,6,290,11,0,0,0,0,17,28
77486,10,322,12,3,0,0,0,25,40
3181,9,483,4,0,0,0,0,8,12
110798,10,322,2,0,0,0,0,3,5
34905,10,355,11,0,0,0,0,13,24
142715,10,413,2,0,0,0,0,3,5
152308,10,111,3,0,0,0,0,3,6
142730,11,677,12,1,0,0,0,11,24
62233,9,607,2,0,0,0,0,3,5
153166,9,243,17,0,0,0,0,39,56
85897,8,812,84,0,0,0,0,141,225
1289,9,243,29,0,0,0,0,33,62
120766,9,243,15,0,0,0,0,12,27
143516,10,799,10,0,0,0,0,15,25
81200,5,238,6,0,0,0,0,9,15
139431,11,489,3,0,0,0,0,1,4
82782,10,628,3,0,0,0,0,5,8
103202,10,413,6,0,0,0,0,7,13
204,9,315,3,0,0,0,0,5,8
27442,7,24,4,0,0,0,0,8,12
7684,7,367,20,1,1,0,0,32,54
9910,10,618,9,0,0,0,1,81,91
136821,10,355,6,0,0,0,0,5,11
82492,10,355,2,0,0,0,0,7,9
30167,6,585,49,1,0,0,0,74,124
9116,10,355,1,0,0,0,0,7,8
56714,10,322,4,0,0,0,0,3,7
20594,10,322,4,0,0,0,0,5,9
16669,6,585,52,0,0,0,0,87,139
28511,10,628,4,0,0,0,0,3,7
28748,10,322,2,0,0,0,0,4,6
78426,10,66,8,0,0,0,0,8,16
21004,10,322,2,0,0,0,0,3,5
116859,8,214,200,1,1,0,3,355,560
116499,10,618,2,0,0,0,0,4,6
97593,9,607,2,0,0,0,0,4,6
132618,10,798,6,0,0,0,0,10,16
86956,10,807,29,1,1,0,0,60,91
16061,10,66,30,0,0,0,0,47,77
23112,10,111,7,0,0,0,0,11,18
121419,10,322,4,0,0,0,0,5,9
69069,10,322,2,0,0,0,0,4,6
94094,8,403,275,3,1,0,5,734,1018
88626,6,263,18,0,0,0,1,25,44
154316,7,30,44,2,2,1,0,57,106
142338,10,555,6,0,0,0,0,8,14
86899,4,306,16,0,0,0,0,26,42
88353,11,916,2,0,0,0,0,4,6
67088,4,365,2,0,0,0,0,0,2
69457,7,100,1,0,0,0,0,0,1
30346,4,519,6,0,0,0,0,13,19
76998,8,403,8,0,0,0,0,9,17
124840,7,310,12,0,0,0,0,11,23
129836,9,842,674,9,2,3,0,994,1682
69367,10,289,9,0,0,0,0,12,21
118097,9,640,29,0,0,0,0,40,69
142468,9,885,6,0,0,0,0,6,12
94448,8,214,369,3,0,0,0,556,928
17069,8,214,344,1,0,0,1,533,879
99785,5,78,79,1,0,0,1,136,217
87654,4,200,2,0,0,0,0,36,38
79594,6,200,35,1,0,0,0,65,101
79652,7,824,17,0,0,0,0,23,40
78315,9,301,8,0,0,0,0,12,20
97043,9,301,4,0,0,0,0,8,12
131522,9,301,6,0,0,0,0,6,12
13769,9,910,5,0,0,0,0,5,10
159794,6,232,32,0,1,0,0,35,68
30494,9,184,2,0,0,0,0,3,5
87648,7,492,6,0,0,0,1,10,17
9349,8,214,10,0,0,0,0,12,22
75636,4,375,6,0,0,0,0,18,24
58687,7,216,2,0,0,0,0,3,5
160632,5,159,2,0,0,0,0,1,3
64152,7,484,7,0,0,0,0,21,28
101311,11,693,6,0,0,0,0,6,12
155171,10,881,17,0,0,0,2,49,68
129997,8,214,192,0,1,0,0,301,494
44123,10,820,0,0,0,0,0,4,4
167651,9,575,5,0,0,0,0,7,12
17867,7,570,1,0,0,0,0,0,1
9878,4,658,1,0,0,0,0,0,1
148883,6,200,12,0,0,0,0,15,27
79927,6,200,70,1,0,0,1,96,168
137028,7,484,70,0,0,0,0,160,230
137124,7,484,4,0,0,0,0,2,6
46491,7,492,5,0,0,0,0,7,12
56995,4,375,2,0,0,0,0,6,8
19412,9,145,77,1,1,0,0,123,202
65212,4,890,14,0,0,0,0,25,39
165924,5,225,18,0,0,0,0,18,36
97233,7,157,1,0,0,0,0,0,1
125703,9,714,6,0,0,0,0,8,14
67329,9,570,4,0,0,0,0,6,10
162609,9,570,19,0,0,0,0,30,49
74110,7,157,13,0,0,0,0,18,31
138004,9,79,4,0,0,0,0,15,19
58886,7,263,11,0,0,0,0,17,28
78114,9,570,1,0,0,0,0,1,2
59856,9,570,4,0,0,0,0,9,13
86855,9,741,49,1,1,0,0,59,110
141187,9,658,154,7,6,0,0,244,411
122147,6,200,11,0,0,0,0,22,33
152870,7,157,1,0,0,0,0,0,1
159530,10,653,1,0,0,0,0,0,1
82572,5,489,159,2,1,0,0,222,384
140256,7,693,6,0,0,0,0,5,11
61484,7,79,17,0,0,0,0,25,42
122982,9,145,1,0,0,0,0,15,16
90453,9,145,2,0,0,0,0,12,14
117177,9,145,17,0,0,0,0,41,58
119157,9,100,11,1,0,0,0,13,25
82118,10,104,1,0,0,0,0,0,1
149064,4,752,30,0,1,0,0,66,97
72739,11,214,7,0,0,0,0,7,14
79481,9,483,7,0,0,0,0,16,23
27685,9,838,2,0,0,0,0,5,7
161273,9,838,3,0,0,0,0,16,19
130594,9,145,4,0,0,0,0,6,10
166035,9,145,31,2,0,0,0,69,102
137187,9,145,1,0,0,0,0,14,15
134428,9,145,0,0,0,0,0,27,27
62429,9,145,4,0,0,0,0,4,8
17762,9,202,8,0,0,0,0,9,17
101517,9,202,10,0,0,0,0,15,25
125896,4,658,2,0,0,0,0,3,5
128735,9,483,8,0,0,0,0,13,21
26555,9,145,12,1,1,0,0,23,37
16750,9,145,14,0,0,0,0,53,67
161642,4,885,8,0,0,0,0,19,27
84132,9,489,2,0,0,0,0,4,6
151163,9,842,28,0,0,0,0,38,66
63037,10,653,50,1,1,0,0,124,176
80167,10,653,297,4,1,0,2,471,775
120059,7,157,93,2,0,1,0,114,210
15909,7,310,8,0,0,0,0,16,24
81174,9,469,10,0,0,0,0,19,29
139859,9,456,13,0,0,0,0,18,31
111403,9,456,2,0,0,0,0,2,4
107925,4,752,79,1,0,0,1,143,224
164973,5,78,24,0,0,0,0,26,50
106657,7,578,22,0,0,0,0,19,41
165917,7,578,2,0,0,0,0,5,7
84446,9,302,11,0,0,0,0,8,19
8734,9,302,2,0,0,0,0,3,5
138211,9,302,13,0,0,0,1,11,25
19481,7,578,2,0,0,0,0,4,6
151758,10,111,5,0,0,0,0,11,16
35639,5,263,2,0,0,0,0,1,3
129776,8,489,185,4,1,0,1,279,470
143077,9,483,2,0,0,0,0,3,5
19319,7,589,35,0,0,0,0,116,151
46754,9,100,6,1,1,0,0,14,22
106688,6,585,27,0,0,0,0,34,61
113245,9,175,26,1,1,0,0,47,75
44243,10,820,9,0,1,0,0,18,28
87121,8,800,4,0,0,0,0,3,7
82509,7,353,10,0,0,0,0,18,28
130849,10,820,4,0,0,0,0,14,18
123807,8,214,489,6,1,0,0,911,1407
60171,9,483,20,0,0,0,0,21,41
161933,9,158,27,0,0,0,0,61,88
42068,9,483,2,0,0,0,0,5,7
87273,7,824,11,0,0,0,0,18,29
113609,7,310,5,0,0,0,0,7,12
93050,11,427,35,2,0,0,0,37,74
30255,9,630,18,1,0,0,0,18,37
112500,4,200,26,0,0,0,0,51,77
44354,5,124,4,0,0,0,0,0,4
56092,8,403,25,0,0,0,0,49,74
67749,9,909,4,0,0,0,0,5,9
109467,7,521,2,0,0,0,0,3,5
66316,9,819,76,1,0,1,0,169,247
104966,4,885,22,0,0,0,0,32,54
79277,7,563,8,0,0,0,1,15,24
150410,11,545,4,0,0,0,0,6,10
90386,4,365,13,0,0,0,0,17,30
22230,6,165,26,1,0,0,0,53,80
119219,9,538,13,0,1,0,1,17,32
79001,9,489,37,1,1,0,0,54,93
126434,9,640,142,0,0,0,0,250,392
22479,5,293,8,0,0,0,0,8,16
97725,8,403,75,1,1,0,0,154,231
148668,9,314,10,0,0,0,0,33,43
101915,9,452,18,0,0,0,0,31,49
116569,9,909,6,0,0,0,0,16,22
36896,9,353,30,2,3,0,1,35,71
33547,4,36,42,2,2,0,0,62,108
153439,10,200,2,0,0,0,0,4,6
63809,9,657,20,0,0,0,0,31,51
16420,7,175,6,0,0,0,0,11,17
27615,4,800,33,0,0,0,0,63,96
23294,7,77,6,0,0,0,0,6,12
30425,8,489,140,1,1,0,0,247,389
65809,10,66,8,0,0,0,0,13,21
105850,7,587,208,7,6,1,2,309,533
95678,10,111,16,0,0,0,0,42,58
76248,5,78,20,0,0,0,0,25,45
134557,9,158,0,0,0,0,0,22,22
51707,7,587,42,1,1,0,1,64,109
56505,7,737,17,0,0,0,0,31,48
82737,10,81,6,0,0,0,0,13,19
55943,9,873,3,0,0,0,1,14,18
72560,9,65,7,0,0,0,0,15,22
90963,9,570,33,0,0,0,1,42,76
142433,6,215,4,0,0,0,0,5,9
149834,4,174,34,0,0,0,0,72,106
109275,9,706,2,0,0,0,0,4,6
16160,9,706,2,0,0,0,0,3,5
112796,11,812,6,2,0,0,0,7,15
67933,9,158,2,0,0,0,0,10,12
156950,9,640,432,0,0,0,1,610,1043
119829,9,6,6,0,0,0,0,15,21
169595,9,6,2,0,0,0,0,4,6
108280,5,489,144,2,1,0,2,290,439
162600,9,6,4,0,0,0,0,6,10
89632,9,6,10,0,0,0,0,23,33
119671,8,545,12,0,0,0,0,15,27
169755,9,374,1,0,0,0,0,15,16
115399,10,355,2,0,0,0,0,5,7
32501,9,469,11,0,0,0,0,16,27
8413,10,781,5,0,0,0,0,7,12
170607,9,245,2,0,0,0,0,2,4
126789,10,621,11,0,0,0,0,15,26
141118,9,245,2,0,0,0,0,5,7
152852,9,589,1,0,0,0,0,0,1
162105,5,693,25,0,0,0,0,40,65
14325,9,302,13,0,0,0,0,17,30
106189,10,66,18,0,0,0,0,29,47
150384,7,521,7,0,0,0,0,9,16
24379,11,214,13,0,0,0,0,10,23
153089,9,65,2,0,0,0,0,6,8
88440,7,521,5,0,0,0,0,5,10
109751,9,158,8,0,0,0,0,17,25
112533,9,873,4,0,0,0,0,7,11
84904,9,873,2,0,0,0,0,4,6
153843,9,873,0,0,0,0,0,4,4
166746,9,873,4,0,0,0,0,10,14
110335,9,873,4,0,0,0,0,10,14
116781,9,873,2,0,0,0,0,10,12
161415,9,873,1,0,0,0,0,7,8
113279,9,630,2,0,0,0,0,3,5
32827,5,479,16,0,0,0,0,21,37
141447,9,828,2,0,0,0,0,9,11
99444,5,78,73,0,0,0,0,98,171
24074,9,828,0,0,0,0,0,4,4
90269,9,828,2,0,0,0,1,8,11
16572,9,828,2,0,0,0,0,5,7
37839,9,828,0,0,0,0,0,4,4
35906,9,266,12,0,0,0,0,45,57
125857,9,706,2,0,0,0,0,9,11
92377,9,706,0,0,0,0,0,4,4
91387,9,706,0,0,0,0,0,8,8
65553,7,521,18,0,0,0,0,23,41
164309,9,706,0,0,0,0,0,3,3
141681,7,645,2,0,0,0,0,4,6
11552,9,6,14,0,0,0,0,21,35
159345,8,214,18,0,0,0,0,17,35
19285,9,380,38,1,1,0,0,65,105
122826,8,403,10,0,0,0,0,6,16
95523,6,570,27,0,0,0,0,162,189
14234,6,785,3,0,0,0,0,3,6
160778,6,827,28,0,0,0,0,48,76
12142,6,827,23,0,0,0,0,39,62
11182,6,420,31,0,1,0,0,49,81
142162,9,632,6,0,0,0,0,11,17
87912,9,632,15,0,0,0,0,34,49
165487,9,632,2,0,0,0,0,13,15
71883,6,78,51,1,0,0,1,85,138
154503,6,78,12,0,0,0,0,21,33
70254,10,898,6,0,0,0,0,11,17
86292,9,838,2,0,0,0,0,3,5
146232,5,489,32,0,0,0,0,65,97
40847,7,492,3,0,0,0,0,5,8
130994,5,181,4,0,0,0,0,2,6
72013,6,453,21,0,0,0,0,54,75
99431,9,158,9,0,0,0,0,16,25
153905,9,158,1,0,0,0,0,11,12
49335,9,532,51,1,1,0,0,108,161
40517,6,78,21,0,0,0,0,20,41
103898,4,885,3,0,0,0,0,1,4
23655,9,145,3,0,0,0,0,5,8
24307,5,225,1,0,0,0,0,0,1
47291,9,145,1,0,0,0,0,8,9
68874,9,314,7,0,0,0,0,14,21
6939,6,209,20,0,0,0,0,24,44
126199,9,145,1,0,0,0,0,1,2
147793,6,922,2,0,0,0,0,3,5
139539,7,508,122,1,0,0,3,274,400
151419,7,508,15,0,0,0,0,25,40
73727,9,374,14,0,0,0,0,37,51
50251,7,508,259,2,1,0,2,424,688
159977,9,819,6,1,1,0,0,8,16
107018,7,508,15,0,0,0,1,19,35
88412,9,374,3,0,0,0,0,3,6
71473,9,706,2,0,0,0,0,9,11
144054,9,374,4,0,0,0,0,7,11
92196,4,658,18,0,0,0,0,47,65
139795,9,374,27,2,0,1,0,49,79
85661,9,374,1,0,0,0,0,0,1
33344,9,838,31,1,1,0,0,55,88
137999,9,452,5,0,0,0,0,7,12
123844,5,263,103,0,0,0,0,199,302
115363,9,873,1,0,0,0,0,2,3
138384,9,873,3,0,1,0,0,9,13
46849,11,214,27,2,0,0,0,38,67
72895,7,214,7,0,0,0,0,22,29
169801,9,175,36,3,1,0,0,65,105
94291,9,175,8,0,0,0,0,24,32
63258,11,214,2,0,0,0,0,2,4
126385,9,42,9,0,0,0,0,14,23
18990,8,427,26,0,0,0,0,52,78
143634,9,42,7,0,0,0,0,10,17
26263,10,63,7,0,0,0,0,26,33
7413,11,244,16,0,0,0,0,18,34
17262,6,78,31,1,0,0,0,51,83
159771,9,570,95,0,0,0,0,149,244
71388,7,144,37,1,1,0,0,58,97
97681,7,144,21,1,0,0,0,33,55
10781,10,550,6,0,0,0,0,14,20
167770,10,550,4,0,0,0,0,7,11
31137,6,200,24,0,0,0,0,41,65
49248,7,214,4,0,0,0,0,6,10
111717,10,798,2,0,0,0,0,3,5
107016,10,29,18,1,0,0,0,6,25
36310,9,202,9,0,0,0,0,14,23
10223,8,214,119,1,1,0,1,206,328
147037,10,903,8,0,0,0,0,12,20
114822,10,903,2,0,0,0,0,4,6
96961,10,903,0,0,0,0,0,7,7
93527,9,314,8,0,0,0,0,7,15
114415,7,864,32,3,0,0,1,84,120
12429,9,314,48,4,3,0,1,81,137
59456,9,77,48,2,1,0,1,65,117
156751,9,77,138,1,1,0,0,209,349
49747,9,77,128,3,2,0,1,208,342
70053,9,86,9,2,3,0,0,19,33
92908,4,800,16,0,0,0,0,32,48
102770,7,521,24,0,0,0,0,32,56
151525,6,200,49,0,0,0,0,62,111
8082,10,111,47,4,2,0,0,74,127
103546,7,508,47,0,0,0,0,78,125
157065,7,508,14,0,0,0,0,22,36
26020,7,508,36,0,0,0,1,61,98
150981,7,508,131,5,2,0,1,244,383
77142,7,587,21,0,0,0,0,35,56
73391,5,306,192,7,2,0,1,394,596
8722,9,367,49,0,0,0,0,64,113
122547,9,367,2,0,0,0,0,3,5
35414,7,489,247,6,2,0,3,373,631
89317,4,658,18,0,0,0,0,32,50
98977,7,551,34,0,0,0,1,58,93
26108,6,235,62,0,0,0,0,104,166
138559,9,828,2,0,0,0,1,11,14
132680,10,628,6,0,0,0,0,20,26
137163,10,111,10,0,0,0,0,24,34
143784,9,828,1,0,0,0,1,5,7
12100,8,623,170,5,1,0,0,273,449
6745,10,807,2,0,0,0,0,7,9
117008,8,214,165,2,1,0,0,257,425
158286,10,820,3,0,0,0,0,4,7
90201,10,820,8,0,0,0,0,13,21
37355,10,413,2,0,0,0,0,4,6
42137,7,521,9,0,0,0,0,12,21
54381,7,521,29,0,0,0,0,39,68
5622,7,521,20,0,0,0,0,21,41
127521,10,576,31,1,0,0,0,45,77
156311,7,521,5,0,0,0,0,7,12
30019,7,521,8,0,0,0,0,8,16
373,10,413,6,0,0,0,0,12,18
33820,10,474,16,0,0,0,0,25,41
2432,5,159,172,6,2,1,1,240,422
20084,11,427,2,0,0,0,0,6,8
137341,10,44,91,2,0,0,1,169,263
22116,9,819,2,0,0,0,0,2,4
72613,5,693,8,0,0,0,0,13,21
51888,9,838,2,0,0,0,0,2,4
49513,10,917,24,0,0,0,0,33,57
76132,11,214,6,0,0,0,0,5,11
78906,4,365,15,0,0,0,0,25,40
152968,10,549,4,0,0,0,0,8,12
46774,4,36,1,0,0,0,0,0,1
74098,11,214,27,0,0,0,0,27,54
52962,8,403,26,0,0,0,0,34,60
88715,8,623,4,0,0,0,0,4,8
32298,4,752,2,0,0,0,0,2,4
147843,7,527,2,0,0,0,0,3,5
115779,4,159,32,0,0,0,0,47,79
22487,9,545,19,0,0,0,0,25,44
25482,5,124,19,0,0,0,0,27,46
164394,5,218,2,0,0,0,0,4,6
6392,5,78,44,1,1,0,0,72,118
17970,9,30,25,1,0,0,0,30,56
122467,9,30,13,0,0,0,0,21,34
60344,10,628,17,0,0,0,0,24,41
133136,9,556,26,5,0,0,0,56,87
44662,10,111,63,1,1,0,2,78,145
121358,11,623,2,0,0,0,0,1,3
85395,9,405,3,0,0,0,0,4,7
122842,9,640,32,0,0,0,0,49,81
122504,4,908,2,0,0,0,0,3,5
22382,7,645,2,0,0,0,0,3,5
5327,6,124,57,0,0,0,0,98,155
45652,10,523,9,0,0,0,0,20,29
85104,9,378,8,0,0,0,0,15,23
28503,7,611,8,0,0,0,0,10,18
50309,9,452,1,0,0,0,0,4,5
10242,9,452,7,2,0,1,0,21,31
156835,9,302,9,0,0,0,0,3,12
94342,9,380,1,0,0,0,0,0,1
144721,11,658,0,1,0,0,0,0,1
74812,9,6,19,1,1,0,0,35,56
149243,7,77,27,0,0,0,0,49,76
17904,10,628,10,0,0,0,0,21,31
155451,10,628,29,0,0,0,0,65,94
58543,10,555,8,0,0,0,0,9,17
146573,7,387,19,0,0,0,0,34,53
108701,10,917,2,0,0,0,0,3,5
114756,6,585,18,1,0,0,0,28,47
57029,9,545,3,0,0,0,0,6,9
117067,4,658,1,0,0,0,0,1,2
74457,9,46,22,1,0,0,0,36,59
95088,7,578,11,0,0,0,0,29,40
165724,9,302,10,0,0,0,0,16,26
31761,5,296,54,1,1,0,0,94,150
74880,8,214,212,0,1,0,2,364,579
82573,8,214,2,0,0,0,0,5,7
99293,9,570,17,1,1,0,0,19,38
45993,9,469,6,0,0,0,0,10,16
123476,9,570,2,1,1,0,0,5,9
60942,7,157,51,0,0,0,0,68,119
120858,8,623,59,0,0,0,0,101,160
36847,8,403,59,2,1,0,0,105,167
88813,9,315,8,0,0,0,0,11,19
111887,7,126,80,3,1,1,2,145,232
162377,9,378,11,0,1,0,0,15,27
99816,9,483,2,0,0,0,0,11,13
158176,9,399,4,0,0,0,0,6,10
67628,7,535,93,1,1,0,0,139,234
35251,9,367,47,2,2,0,0,102,153
51811,9,367,12,0,0,0,0,16,28
26573,9,131,7,0,0,0,0,8,15
7385,4,658,1,0,0,0,0,8,9
96097,7,822,3,0,0,0,0,3,6
20182,7,822,6,0,0,0,0,8,14
87984,10,81,0,0,0,0,0,4,4
169747,10,81,0,0,0,0,0,8,8
1004,9,202,10,5,0,0,0,20,35
168313,9,630,132,3,1,2,0,186,324
131201,9,202,28,0,0,0,0,35,63
60107,9,202,2,0,0,0,0,3,5
154055,9,202,2,0,0,0,0,3,5
64950,9,202,4,0,0,0,0,4,8
131115,4,890,2,0,0,0,0,2,4
27326,9,469,83,1,1,0,0,148,233
36723,9,243,32,1,1,0,0,37,71
33572,9,202,4,0,0,0,0,5,9
83333,9,800,10,1,1,0,0,20,32
21661,9,323,1,1,0,0,0,0,2
86889,9,80,173,4,3,0,0,281,461
15432,9,323,0,1,0,0,0,0,1
97490,7,46,2,0,0,0,0,2,4
120782,7,472,5,0,0,0,0,6,11
143890,4,375,2,0,0,0,0,2,4
85154,8,211,4,0,0,0,0,5,9
147033,9,427,12,0,0,0,0,63,75
156510,9,489,34,1,1,0,0,49,85
147972,8,812,46,1,1,0,0,69,117
42184,6,235,104,1,0,0,0,232,337
156508,6,922,6,0,0,0,0,15,21
110106,9,589,111,7,2,1,0,185,306
126098,9,570,4,0,0,0,0,4,8
133672,9,489,59,3,0,1,0,88,151
142511,4,675,4,0,0,0,0,5,9
162109,9,489,75,3,3,0,1,124,206
94590,6,402,10,0,0,0,1,30,41
20086,7,551,6,0,0,0,0,22,28
102872,5,159,15,0,0,0,0,29,44
21228,7,489,3,0,0,1,0,1,5
115908,9,741,179,3,1,1,0,225,409
81711,9,472,6,0,0,0,0,7,13
33459,9,658,9,0,0,0,0,17,26
102456,8,214,1,0,0,0,0,1,2
100420,10,617,22,0,0,0,0,31,53
59746,9,302,23,1,1,0,0,43,68
82636,4,678,2,0,0,0,0,1,3
105672,9,607,56,1,0,0,1,83,141
57718,11,489,4,0,0,0,0,3,7
12444,8,214,4,0,0,0,0,5,9
115840,4,800,4,0,0,0,0,7,11
67750,7,648,34,1,1,0,0,101,137
54112,4,800,2,0,0,0,0,3,5
50747,11,214,1,0,0,0,0,0,1
35877,6,106,103,6,3,0,2,216,330
97293,6,269,4,1,0,0,0,5,10
160393,9,483,6,0,0,0,0,12,18
56473,11,658,20,2,0,0,0,16,38
26488,9,353,4,0,0,0,0,9,13
89959,7,263,4,0,0,0,0,6,10
81164,7,263,8,0,0,0,0,13,21
84653,9,632,14,0,0,0,0,25,39
25531,9,353,4,0,0,0,0,5,9
150895,9,456,2,0,0,0,0,3,5
160608,9,456,5,0,0,0,0,9,14
135495,9,545,7,0,0,0,0,7,14
47351,9,545,11,0,0,0,0,22,33
23959,9,353,4,0,0,0,0,3,7
92960,6,785,1,0,0,0,0,0,1
165450,9,353,26,0,0,0,0,35,61
142866,7,611,78,0,1,0,0,98,177
34063,9,65,2,0,0,0,0,4,6
100396,9,353,9,0,0,0,0,10,19
17418,8,214,109,0,0,0,0,161,270
62652,7,74,19,0,0,0,0,14,33
44765,7,589,17,0,0,0,0,13,30
168164,5,693,60,4,0,0,0,82,146
61414,9,145,15,0,0,0,0,32,47
92953,4,124,1,0,0,0,0,80,81
152667,7,489,93,1,1,0,0,126,221
89645,9,145,5,0,0,0,0,48,53
22156,5,124,70,0,0,0,0,76,146
167635,5,124,13,0,0,0,0,21,34
133384,9,145,2,0,0,0,0,8,10
156971,7,648,48,4,1,0,0,110,163
104078,9,483,6,0,0,0,0,10,16
24019,9,693,2,0,0,0,0,2,4
25632,7,693,9,1,0,0,0,15,25
151034,8,812,49,0,0,0,0,82,131
153779,6,165,34,0,0,0,0,62,96
85616,8,214,119,2,1,0,1,224,347
92668,6,306,9,1,0,0,0,13,23
6499,6,545,129,8,3,0,0,167,307
13691,9,657,7,0,0,0,0,7,14
162808,6,514,17,0,0,0,0,29,46
130301,7,587,53,0,0,0,0,73,126
99168,7,404,25,0,0,0,0,37,62
98905,11,658,15,0,0,0,0,8,23
18021,9,43,8,0,0,0,0,13,21
67144,9,457,4,0,0,0,0,7,11
168253,9,457,4,0,0,0,0,6,10
126652,10,798,4,0,0,0,0,4,8
45961,9,657,2,0,0,0,0,4,6
29132,8,403,1,0,0,0,0,0,1
104557,9,570,78,0,0,0,0,185,263
171024,9,658,20,0,0,0,0,30,50
74560,6,124,1,0,0,0,0,4,5
117484,7,587,457,18,8,1,1,704,1189
108063,10,781,2,0,0,0,0,4,6
4896,7,542,16,0,0,0,0,14,30
146615,9,570,8,0,0,0,0,11,19
46469,7,542,8,0,0,0,0,7,15
129290,10,820,4,0,0,0,0,4,8
80705,7,648,10,0,0,0,0,29,39
153563,7,521,25,0,0,0,1,26,52
75582,9,800,3,2,0,0,0,10,15
136918,8,403,4,0,0,0,0,3,7
137302,9,483,2,0,0,0,0,5,7
6504,7,521,32,1,1,0,0,40,74
148147,4,890,14,0,0,0,0,22,36
120225,9,302,3,0,0,0,0,4,7
168069,5,489,16,0,0,0,0,38,54
9508,9,266,6,0,0,0,0,11,17
9038,7,484,2,0,0,0,0,2,4
161292,9,314,4,0,0,0,0,9,13
18688,9,842,74,1,2,0,0,118,195
105579,4,593,49,0,0,0,0,100,149
81633,9,842,90,1,0,0,0,129,220
162319,9,842,95,1,2,0,0,180,278
76293,11,812,18,0,0,0,0,21,39
32097,7,648,8,0,0,0,0,7,15
67000,7,551,7,0,0,0,0,12,19
133344,7,77,8,0,0,0,0,12,20
42414,7,551,10,0,0,0,0,10,20
2080,9,367,45,0,1,0,0,118,164
44307,7,551,2,0,0,0,0,3,5
19962,7,551,6,0,0,0,0,6,12
133472,9,367,59,1,2,0,0,101,163
164988,7,521,19,2,1,0,0,31,53
48420,9,632,3,0,0,0,0,3,6
133514,9,640,22,0,0,0,0,33,55
20257,9,367,19,1,1,0,0,137,158
39355,9,632,0,0,0,0,0,2,2
71398,9,367,11,1,1,0,0,17,30
50322,7,669,7,0,0,0,0,18,25
89832,6,78,6,0,0,0,0,12,18
18939,6,200,6,0,0,0,0,17,23
14618,11,306,2,0,0,0,0,2,4
69485,9,302,9,0,0,0,0,10,19
136258,9,302,4,1,1,0,0,13,19
129783,9,538,61,0,0,0,1,116,178
19621,9,538,13,0,0,0,1,16,30
63720,9,538,6,0,0,0,0,9,15
96319,9,302,2,0,0,0,0,3,5
116193,9,489,16,0,0,0,0,47,63
125322,6,165,74,0,0,0,0,92,166
58088,10,63,27,1,1,0,0,39,68
38615,7,380,6,0,0,0,0,10,16
115879,9,560,21,0,0,0,0,27,48
63301,4,678,32,0,0,0,0,34,66
37835,7,660,50,2,1,0,0,72,125
39405,6,404,1,0,0,0,0,1,2
106967,9,575,4,0,0,0,0,5,9
20997,9,483,1,0,0,0,0,5,6
65446,10,66,4,0,0,0,0,14,18
3082,4,890,166,3,1,0,1,300,471
24977,9,353,2,0,0,0,0,4,6
75555,4,427,84,2,0,1,1,138,226
32379,9,510,2,1,0,0,0,3,6
97099,7,263,0,0,0,0,0,1,1
72819,7,263,5,0,0,0,0,5,10
73373,10,781,2,0,0,0,0,3,5
129716,9,630,28,3,3,0,0,48,82
59883,9,510,2,0,0,0,0,3,5
69414,10,322,2,0,0,0,0,3,5
92008,7,226,4,0,0,0,0,7,11
38642,9,630,1,0,0,0,0,2,3
84681,5,570,13,0,0,0,0,13,26
153045,9,4,6,0,0,0,0,20,26
120038,10,377,9,1,1,0,0,33,44
167064,7,885,29,0,0,0,0,43,72
76064,7,484,4,0,0,0,0,19,23
18050,7,660,8,1,1,0,1,26,37
79015,10,628,39,3,1,0,0,62,105
122314,8,885,39,0,0,0,0,44,83
169337,8,214,91,2,1,0,1,152,247
126247,9,828,2,0,0,0,0,5,7
15580,7,484,0,0,0,0,0,15,15
21220,7,660,6,0,0,0,0,4,10
52179,9,313,65,2,0,0,1,155,223
4314,9,313,14,1,0,0,0,37,52
138455,9,457,2,0,0,0,0,2,4
158032,9,657,4,0,0,0,0,6,10
12921,9,313,3,0,0,0,0,70,73
61044,9,457,1,0,0,0,0,1,2
89058,9,457,3,0,0,0,0,3,6
98396,9,457,5,0,0,0,0,15,20
70640,9,457,1,0,0,0,0,1,2
89120,10,29,5,0,0,0,0,8,13
92567,10,618,8,0,0,0,0,18,26
160785,7,157,99,2,1,0,1,166,269
47096,10,898,13,0,0,0,0,31,44
101093,10,628,2,0,0,0,0,3,5
154594,9,452,20,1,1,0,1,27,50
19002,9,379,68,3,1,0,1,106,179
49101,6,431,1,0,0,0,0,3,4
13190,4,678,18,0,0,0,0,33,51
68991,9,575,28,1,1,0,0,41,71
92780,9,575,16,0,0,0,0,25,41
158415,8,124,1,0,0,0,0,0,1
128287,8,214,8,0,0,0,0,8,16
97174,9,367,42,0,0,0,0,60,102
38956,9,452,17,1,0,0,0,26,44
2047,9,100,7,0,0,0,0,16,23
115917,9,538,30,0,0,0,0,42,72
52184,9,100,26,0,0,0,1,38,65
50769,9,65,3,0,0,0,0,3,6
71584,9,560,5,0,0,0,0,6,11
166279,9,575,29,3,2,0,0,44,78
121434,10,550,7,0,0,0,0,10,17
130379,9,462,4,0,0,0,0,16,20
61607,9,100,62,0,0,0,0,113,175
168416,9,640,22,1,1,0,1,36,61
50022,9,483,5,1,0,0,0,6,12
134606,9,483,3,0,0,0,0,3,6
167413,9,483,4,1,0,0,0,13,18
160428,9,483,0,0,0,0,0,5,5
31751,9,202,4,0,0,0,0,7,11
81863,9,457,1,0,0,0,0,1,2
77736,9,483,2,0,0,0,0,2,4
82830,9,483,5,0,0,0,0,3,8
165549,11,214,7,1,0,0,0,7,15
72481,10,40,11,0,0,0,0,19,30
25921,7,100,11,0,0,0,1,27,39
52976,9,589,1,0,0,0,0,0,1
392,4,174,6,0,0,0,0,10,16
146885,8,556,16,0,0,0,0,24,40
166411,9,556,4,0,0,0,0,6,10
170871,7,800,6,0,0,0,0,24,30
118085,7,800,45,1,1,0,0,99,146
91117,7,471,6,0,0,0,0,10,16
39607,9,302,2,0,1,0,0,3,6
151031,9,302,2,0,0,0,0,8,10
8674,9,302,2,0,0,0,0,4,6
152573,9,630,12,0,0,0,0,21,33
105778,7,587,3,0,0,0,0,4,7
139853,7,508,44,0,0,0,0,85,129
141480,6,821,24,0,0,0,0,29,53
129453,4,159,2,0,0,0,0,2,4
123008,10,917,4,0,0,0,0,16,20
75962,7,800,20,0,0,0,0,25,45
17608,10,917,2,0,0,0,0,3,5
83294,11,545,4,1,0,0,0,5,10
99154,10,917,22,1,1,0,1,46,71
42499,9,353,49,1,1,0,1,72,124
93220,9,353,24,1,1,0,0,39,65
600,10,29,13,0,0,0,0,12,25
137273,10,917,12,0,0,0,0,39,51
22839,10,917,117,3,2,0,0,235,357
162834,10,322,2,0,0,0,0,3,5
106156,10,716,22,0,0,0,0,31,53
66715,6,489,121,3,1,0,3,196,324
41713,9,630,0,0,0,0,0,10,10
114016,9,325,6,0,0,0,0,11,17
16166,7,578,7,0,0,0,1,11,19
44556,7,254,10,0,0,0,0,8,18
94200,9,374,20,3,1,0,0,24,48
141531,9,838,14,1,1,0,0,18,34
152278,9,838,8,0,0,0,0,16,24
72852,9,796,5,0,0,0,0,12,17
17517,9,796,0,0,0,0,0,3,3
88824,9,796,2,0,0,0,0,8,10
103676,9,796,0,0,0,0,0,4,4
85994,9,873,4,0,0,0,0,3,7
10007,9,302,10,0,0,0,0,15,25
166205,9,630,2,0,0,0,0,3,5
71777,9,452,16,0,0,0,0,31,47
166579,9,489,17,0,0,0,0,26,43
23127,7,367,16,0,0,0,0,24,40
59350,9,452,1,0,0,0,0,2,3
70449,9,375,6,0,0,0,0,24,30
157489,10,208,13,0,0,0,0,22,35
149414,10,208,4,0,0,0,0,6,10
126704,10,29,5,0,0,0,0,26,31
33609,10,208,7,0,0,0,0,11,18
46851,10,841,10,0,0,0,0,10,20
31429,7,489,38,0,0,0,0,50,88
65926,6,200,12,0,0,0,0,4,16
45157,9,452,25,0,0,0,1,45,71
17713,10,743,9,0,0,0,0,21,30
29503,10,743,2,0,0,0,0,10,12
108753,6,785,35,0,0,0,0,43,78
146522,10,743,2,0,0,0,0,6,8
61032,7,611,2,1,1,0,0,4,8
39058,9,489,387,0,0,0,2,670,1059
52742,6,78,5,0,0,0,0,7,12
161598,6,78,4,0,0,0,0,4,8
51338,8,214,53,0,0,0,0,122,175
167563,5,59,2,0,0,0,0,3,5
145279,10,628,18,0,0,0,0,22,40
109758,7,460,9,0,0,0,0,18,27
69958,9,65,13,0,0,0,0,19,32
157129,7,254,8,0,0,0,0,13,21
100829,10,628,149,3,1,2,0,188,343
160363,6,489,81,1,1,0,0,141,224
145777,9,405,1,0,0,0,0,0,1
69916,10,66,23,0,0,0,0,23,46
134381,4,375,2,0,0,0,0,2,4
80047,10,29,2,0,0,0,0,2,4
35872,10,44,34,1,0,0,0,65,100
153549,9,589,2,0,0,0,0,2,4
37099,11,244,22,0,0,0,0,22,44
118639,10,628,2,0,0,0,0,5,7
10798,10,917,4,0,0,0,0,4,8
36959,5,570,9,1,0,0,0,17,27
150559,10,413,1,0,0,0,0,2,3
165533,10,289,4,0,0,0,0,9,13
29908,10,289,1,0,0,0,0,2,3
138929,10,208,1,0,0,0,0,3,4
18858,10,208,1,0,0,0,0,0,1
568,10,355,1,0,0,0,0,0,1
20058,11,489,1,1,0,0,0,3,5
107813,9,89,20,1,0,0,0,39,60
146757,9,100,10,0,0,0,0,9,19
144593,9,819,68,6,3,1,1,154,233
116015,9,800,3,0,0,0,0,7,10
124108,5,59,40,0,0,0,0,72,112
141284,8,622,83,2,1,0,0,128,214
139065,9,658,16,0,0,0,0,24,40
9119,10,917,28,0,0,0,0,46,74
169559,8,489,166,4,0,0,0,269,439
39064,9,640,4,0,0,0,0,4,8
138970,6,78,4,0,0,0,0,7,11
13383,6,78,2,0,0,0,0,5,7
154754,9,452,2,0,0,0,0,3,5
79709,6,785,53,0,0,0,2,91,146
83386,6,375,1,0,0,0,0,1,2
106579,7,741,165,4,2,0,3,294,468
109939,5,235,25,0,0,0,0,51,76
134328,10,66,12,0,0,0,0,24,36
113463,10,817,20,1,1,0,0,28,50
7073,5,693,3,0,0,0,0,4,7
101529,10,81,10,0,0,0,0,14,24
49146,4,375,3,0,0,0,0,4,7
51857,9,556,2,6,0,0,0,2,10
93651,9,46,2,0,0,0,0,6,8
86680,9,145,10,0,0,0,1,20,31
160144,9,145,24,0,0,0,0,22,46
149865,9,145,1,0,0,0,0,2,3
77422,4,159,1,0,0,0,0,0,1
15740,4,375,2943,99,53,12,19,6185,9311
135653,9,145,5,0,0,0,0,9,14
140778,7,472,2,0,0,0,0,5,7
59612,9,145,10,1,0,0,0,20,31
13515,9,46,4,0,0,0,0,4,8
141222,7,472,2,0,0,0,0,7,9
140072,8,812,40,1,1,0,1,68,111
131580,9,46,4,0,0,0,0,6,10
35016,7,367,8,0,0,0,0,16,24
147785,8,623,104,3,2,0,1,216,326
24840,8,214,72,0,0,0,0,109,181
154322,6,785,3,0,0,0,0,5,8
106512,7,660,15,0,0,0,0,16,31
127321,10,29,8,0,0,0,0,19,27
158268,7,521,126,1,0,0,0,133,260
169742,10,66,1,0,0,0,0,8,9
88520,10,66,10,1,1,0,0,28,40
128267,8,812,14,0,0,0,0,25,39
146140,7,741,37,0,0,0,0,51,88
152119,8,214,521,7,1,0,1,781,1311
1590,9,589,7,0,0,0,0,8,15
129009,8,800,1,1,0,0,0,0,2
49161,6,159,12,0,0,0,0,18,30
147168,10,200,1,0,0,0,0,0,1
37923,8,812,1,0,0,0,0,2,3
116709,7,100,1,0,0,0,0,3,4
137244,7,77,14,0,0,0,0,23,37
97171,7,77,11,0,0,0,0,22,33
7379,7,79,5,0,0,0,0,8,13
62222,9,640,27,0,0,0,0,36,63
37450,8,623,16,0,0,0,0,15,31
126683,6,453,15,0,0,0,0,24,39
95558,7,669,1,0,0,0,0,2,3
3069,10,618,11,0,0,0,0,31,42
162940,10,618,3,0,0,0,0,8,11
30563,7,46,118,3,0,0,0,161,282
131335,5,489,8,0,0,0,0,12,20
84281,6,800,5,0,0,0,0,7,12
50558,6,120,2,0,0,0,0,4,6
24523,8,403,3,0,0,0,0,0,3
140267,6,106,1,0,0,0,0,3,4
63255,6,306,5,0,0,0,0,1,6
17364,7,741,4,0,0,0,0,7,11
123449,9,489,50,2,2,0,1,99,154
45846,5,371,10,0,0,0,0,17,27
56330,8,214,10,0,0,0,0,9,19
44059,10,289,7,0,0,0,0,14,21
159963,7,755,15,0,0,0,0,22,37
108786,10,555,3,0,0,0,0,4,7
142987,10,555,3,0,0,0,0,2,5
135982,10,555,1,0,0,0,0,0,1
19778,7,202,5,1,0,0,0,13,19
43032,5,225,2,0,0,0,0,2,4
165514,8,214,8,0,0,0,0,12,20
18201,8,545,16,0,0,0,0,35,51
80638,5,408,85,1,0,0,0,188,274
14086,8,489,1,0,0,0,0,1,2
134548,9,489,11,0,0,0,0,14,25
3399,10,413,8,1,0,0,0,16,25
141060,10,66,4,0,0,0,0,0,4
27134,6,103,3,0,0,0,0,1,4
80394,11,403,27,0,0,0,0,28,55
162786,9,405,0,0,0,1,0,0,1
163008,9,65,8,0,0,0,0,13,21
144326,7,741,3,0,0,0,0,5,8
16319,8,790,17,1,0,0,0,38,56
112475,8,800,17,1,2,0,0,100,120
121847,7,100,2,0,0,0,0,1,3
116069,7,56,11,0,0,0,0,21,32
53020,11,214,49,2,0,0,0,59,110
142677,4,200,30,0,0,0,0,40,70
30108,9,6,3,1,1,0,0,7,12
19693,9,65,4,0,0,0,0,6,10
120483,9,65,5,0,0,0,0,24,29
167918,9,885,2,0,0,0,0,4,6
83012,9,874,16,0,0,0,1,28,45
30777,9,570,4,0,0,0,0,6,10
138396,9,469,2,0,0,0,0,4,6
55017,9,46,2,0,0,0,0,3,5
144004,9,570,4,0,0,0,0,6,10
134965,7,741,11,0,0,0,0,16,27
109293,9,95,18,0,0,0,1,26,45
8845,9,95,7,0,0,0,0,11,18
85683,9,95,11,0,0,0,0,16,27
149230,9,492,23,0,0,0,0,22,45
94949,9,575,1,0,0,0,0,2,3
100900,9,374,16,0,0,0,0,25,41
63893,9,570,23,0,0,0,0,50,73
123208,4,36,117,2,1,0,1,254,375
98310,7,379,17,3,0,0,0,30,50
52327,7,669,12,1,1,0,0,21,35
18539,7,693,5,0,0,0,0,6,11
13426,7,56,26,2,1,0,0,36,65
120844,7,56,2,0,0,0,0,2,4
48937,11,214,19,3,0,0,0,21,43
47385,4,220,8,0,0,0,0,8,16
135443,9,607,16,0,0,0,0,24,40
91160,8,214,134,0,0,0,2,239,375
113979,9,538,2,0,0,0,0,5,7
166261,10,917,50,3,1,1,1,76,132
144367,9,510,6,0,0,0,0,10,16
156051,9,89,7,0,0,0,0,10,17
8189,6,718,0,0,0,0,0,1,1
86036,9,706,22,1,1,0,0,46,70
152939,10,917,14,0,0,0,0,26,40
73720,10,355,4,0,0,0,0,5,9
97468,11,244,2,0,0,0,0,2,4
44477,9,706,2,0,0,0,0,5,7
109991,9,706,2,0,0,0,0,28,30
120737,9,706,0,0,0,0,0,12,12
140557,9,706,0,0,0,0,0,11,11
12774,8,812,2,0,0,0,0,1,3
133577,11,489,4,0,0,0,0,4,8
96890,10,653,190,1,1,0,1,315,508
165193,9,693,4,0,0,0,0,7,11
78159,9,147,2,0,0,0,0,3,5
113622,10,653,136,2,0,0,1,221,360
166973,9,538,58,0,0,0,0,98,156
113716,9,538,11,1,1,0,0,22,35
62452,5,235,13,3,3,0,0,24,43
78624,7,508,5,0,0,0,0,10,15
20842,9,489,40,0,0,0,0,61,101
161283,7,587,167,5,0,3,0,341,516
37513,9,487,7,0,0,0,0,32,39
150100,4,658,2,0,0,0,0,3,5
68190,10,781,2,0,0,0,0,2,4
51254,10,653,73,0,0,0,0,143,216
168875,7,391,93,3,2,0,0,115,213
109184,9,65,5,0,0,0,0,41,46
2766,11,214,10,0,0,0,0,12,22
151970,6,729,16,0,0,0,0,29,45
78273,9,65,7,0,0,0,0,43,50
93704,9,483,4,0,0,0,0,8,12
66225,9,483,4,0,0,0,0,10,14
139685,9,427,18,0,0,0,0,50,68
61644,9,658,2,0,0,0,0,5,7
107934,10,917,9,1,0,0,0,22,32
62607,4,174,3,0,0,0,0,4,7
14242,7,489,87,2,1,0,1,139,230
29292,7,384,8,0,0,0,0,9,17
146063,7,384,16,0,0,0,0,21,37
87865,9,489,9,0,0,0,0,7,16
59115,11,812,2,0,0,0,0,2,4
32121,7,570,3,0,0,0,0,0,3
28124,9,607,6,0,0,0,0,15,21
36859,7,508,10,0,0,0,0,13,23
113843,9,570,16,0,0,0,0,26,42
61143,4,200,19,1,1,0,0,27,48
132161,9,145,0,0,0,0,0,10,10
45550,9,145,0,0,0,0,0,9,9
94584,7,508,44,0,0,0,0,76,120
22456,10,355,0,0,0,0,0,12,12
109213,9,368,4,0,0,0,0,3,7
90199,10,355,0,0,0,0,0,15,15
82858,10,355,0,0,0,0,0,13,13
110616,8,562,134,0,0,0,0,241,375
107514,5,893,18,1,0,0,0,49,68
11389,10,653,18,0,0,0,0,26,44
23374,10,628,39,2,0,0,0,76,117
10101,10,653,69,0,0,0,0,94,163
86958,7,748,1,0,0,0,0,9,10
29118,4,365,5,0,0,0,0,9,14
46406,11,812,4,0,0,0,0,2,6
4948,8,214,125,0,0,0,0,205,330
102552,7,575,12,4,0,0,0,7,23
116007,9,54,19,0,1,0,0,33,53
43940,8,403,940,26,11,1,4,1282,2264
7034,10,799,10,0,0,0,0,10,20
41012,9,909,2,0,0,0,0,4,6
112664,6,78,34,0,0,0,0,48,82
162167,9,489,2,0,0,0,0,3,5
144647,7,587,10,0,0,0,0,12,22
104699,4,174,34,0,0,0,0,47,81
73551,7,521,8,0,0,0,0,17,25
141101,9,77,28,1,1,0,1,29,60
195,7,521,18,0,0,0,0,25,43
61191,9,77,94,0,0,0,0,131,225
59107,9,657,39,0,0,0,0,69,108
95223,10,29,14,0,0,0,0,29,43
51128,9,353,21,0,1,0,0,36,58
42047,10,29,6,0,0,0,0,12,18
46176,9,243,7,0,0,0,0,4,11
2528,8,427,40,1,1,0,0,76,118
128961,9,457,2,0,0,0,0,0,2
108527,9,457,2,0,0,0,0,0,2
135833,7,429,37,2,1,0,0,51,91
170688,7,74,19,1,1,0,1,43,65
140468,7,74,13,2,0,0,1,48,64
102196,7,492,5,0,0,0,0,11,16
81625,7,484,9,0,0,0,0,12,21
50284,7,484,2,0,0,0,0,4,6
134648,7,861,24,0,0,0,0,36,60
58269,9,405,3,0,0,0,0,6,9
110813,8,812,44,3,2,0,1,89,139
165873,9,65,7,0,0,0,0,8,15
100479,11,812,2,0,0,0,0,2,4
82406,9,800,4,0,0,0,0,9,13
60477,9,117,2,0,0,0,0,0,2
105372,10,653,66,1,2,0,1,112,182
116512,9,175,6,0,0,0,0,12,18
143458,9,532,22,0,0,0,0,79,101
115806,9,175,4,0,0,0,0,7,11
92051,9,570,71,3,1,0,0,179,254
170687,9,489,32,0,0,0,0,43,75
150736,6,263,4,0,0,0,0,6,10
51208,10,289,1,0,0,0,0,1,2
159965,11,800,43,2,0,0,0,52,97
139261,9,538,2,1,1,0,0,8,12
35566,9,489,89,3,2,0,2,183,279
105027,11,812,8,0,0,0,0,8,16
63869,10,653,95,1,0,0,0,148,244
97646,9,65,34,0,0,0,1,54,89
162480,8,489,1,0,0,0,0,0,1
159589,9,800,2,0,0,0,0,2,4
131437,5,238,8,0,0,0,0,18,26
13714,7,79,4,0,0,0,0,5,9
77201,6,885,0,1,0,0,0,0,1
169515,9,640,42,1,1,0,0,56,100
39202,4,200,23,0,0,0,0,103,126
20796,7,748,7,0,0,0,0,10,17
158371,9,65,26,0,0,0,0,41,67
76945,6,215,22,1,0,0,0,26,49
144113,9,796,2,0,0,0,0,2,4
167226,9,158,3,0,0,0,0,8,11
98137,9,796,4,0,0,0,0,5,9
102445,9,796,4,0,0,0,0,5,9
97385,9,65,8,0,0,0,0,9,17
166164,9,65,7,0,0,0,0,7,14
95422,9,909,15,1,2,0,0,26,44
104347,10,653,82,0,1,0,1,158,242
114605,7,587,35,1,1,0,0,60,97
14177,9,367,11,0,0,0,0,57,68
160195,7,508,2,0,0,0,0,5,7
48714,7,508,65,1,0,0,0,94,160
92964,7,508,12,1,1,0,0,32,46
135976,7,508,10,0,0,0,0,25,35
43822,9,374,7,0,0,0,0,17,24
92875,10,289,17,0,0,0,0,21,38
81715,10,653,58,0,0,0,0,127,185
131521,9,714,3,0,0,0,0,5,8
27772,9,95,19,0,0,0,0,36,55
143687,9,95,5,0,0,0,0,10,15
22027,9,556,6,0,0,0,0,7,13
88781,9,95,11,0,0,0,0,14,25
103332,4,800,10,0,0,0,0,13,23
82672,9,429,176,3,0,1,1,338,519
146779,9,216,15,0,0,0,0,24,39
104351,7,243,4,0,0,0,0,6,10
84058,9,457,4,1,2,0,0,2,9
67481,7,508,20,0,0,0,1,34,55
48751,9,575,3,0,0,0,0,11,14
83786,9,657,51,2,2,0,0,103,158
140569,4,375,24,0,0,0,0,33,57
65567,9,842,68,5,4,1,2,112,192
75602,9,575,17,0,0,0,0,31,48
125952,7,56,19,2,1,1,0,100,123
56950,9,157,8,0,0,0,0,7,15
104286,9,714,1,0,0,0,0,2,3
114015,5,375,852,20,8,2,5,1298,2185
62531,7,521,17,2,2,0,0,32,53
16574,7,306,4,0,0,0,0,3,7
57054,10,903,1,0,0,0,0,4,5
168580,10,903,1,0,0,0,0,0,1
51083,9,489,65,4,1,0,1,116,187
21828,11,306,18,0,0,0,0,13,31
54070,10,217,78,0,0,0,0,84,162
43186,7,207,2,0,0,0,0,12,14
72999,5,489,23,2,1,1,0,34,61
114222,9,302,14,0,0,0,0,25,39
144435,5,225,13,0,0,0,0,19,32
65875,9,399,9,0,0,0,0,8,17
73633,7,214,228,5,1,0,1,316,551
37004,8,489,1,0,0,0,0,8,9
87235,7,489,46,0,0,0,0,88,134
115190,8,489,4,0,0,0,0,3,7
35863,7,741,12,1,1,0,0,20,34
156661,9,4,0,0,1,0,0,3,4
24425,11,812,4,0,0,0,0,4,8
40697,8,885,49,0,0,0,0,103,152
24284,5,489,27,0,0,0,0,51,78
41394,5,489,86,0,0,0,0,132,218
116457,9,469,4,0,0,0,0,7,11
110846,9,622,8,0,0,0,0,8,16
101213,5,225,1,0,0,0,0,2,3
140793,5,561,1,0,0,0,0,0,1
129143,7,56,31,0,0,0,0,35,66
30880,9,630,8,0,0,0,0,8,16
86150,5,78,36,1,1,0,0,39,77
16370,10,917,6,0,0,0,0,15,21
17100,7,100,6,0,0,1,0,10,17
149004,6,269,146,4,2,0,1,289,442
49069,8,658,2,0,0,0,0,0,2
155305,9,145,2,0,0,0,0,29,31
160925,8,214,8,0,0,0,0,11,19
160359,9,145,2,0,0,0,0,17,19
134190,5,489,79,1,1,0,0,114,195
105427,9,65,17,0,0,0,0,36,53
76754,9,489,93,0,0,0,1,278,372
27454,11,214,25,1,0,0,0,31,57
124249,9,253,5,0,0,0,0,7,12
151433,8,916,0,0,0,0,0,2,2
102091,11,812,4,0,0,0,0,3,7
82392,7,144,3,0,0,0,0,5,8
23307,10,208,10,0,0,0,0,19,29
95318,6,885,2,1,0,0,0,2,5
7109,4,174,197,2,2,0,2,377,580
143141,9,243,6,0,0,0,0,6,12
135188,4,365,5,0,0,0,1,7,13
65205,11,800,62,5,0,0,0,59,126
260,9,302,18,0,0,0,0,59,77
147705,4,338,4,0,0,0,0,4,8
110882,10,111,7,0,0,0,0,30,37
54661,5,893,27,1,0,0,0,79,107
113708,7,484,20,0,0,0,0,42,62
30042,5,78,39,0,0,0,0,51,90
46824,9,469,27,0,0,0,0,65,92
26652,10,413,10,0,0,0,0,13,23
149499,9,469,16,0,0,0,0,27,43
74040,9,302,17,1,1,0,0,46,65
147313,9,302,10,0,0,0,1,21,32
127858,9,302,8,0,0,0,0,13,21
140315,5,218,37,2,2,0,0,78,119
153649,9,796,2,0,0,0,0,4,6
119937,4,200,1,0,0,0,0,2,3
132012,7,587,10,0,0,0,0,18,28
100110,9,145,2,0,0,0,0,11,13
36926,9,315,14,0,0,0,0,19,33
164070,9,302,10,0,0,0,0,20,30
166912,9,95,8,1,1,0,0,14,24
78232,9,483,0,0,0,0,0,10,10
41005,9,483,0,0,0,0,0,9,9
140206,10,781,6,0,0,0,0,3,9
36269,10,355,3,0,0,0,0,4,7
60786,6,124,26,0,0,0,0,36,62
68324,9,353,4,0,0,0,0,8,12
45812,7,587,7,0,0,0,0,17,24
38732,9,374,1,0,0,0,0,6,7
151592,6,269,103,1,1,0,0,193,298
34392,7,263,24,0,0,0,0,36,60
32012,8,214,2,0,0,0,0,0,2
56361,6,106,85,5,2,0,0,149,241
126592,9,630,2,0,0,0,0,2,4
80255,10,256,11,0,0,0,0,29,40
42038,9,367,20,0,0,0,0,22,42
3770,10,256,9,0,0,0,0,25,34
77428,9,570,1,0,0,0,0,3,4
37644,9,630,1,0,0,0,0,1,2
132561,7,755,7,1,1,0,0,4,13
59088,6,431,7,0,0,0,0,17,24
1665,5,200,210,10,4,1,2,316,543
67609,5,225,2593,80,38,6,21,4929,7667
61125,6,269,7,0,0,0,0,10,17
104340,10,752,5,0,0,0,0,10,15
22766,7,374,31,0,0,16,0,40,87
82850,7,374,23,0,0,16,0,31,70
139102,7,374,26,0,0,16,0,37,79
86299,7,374,24,0,0,16,0,38,78
146293,7,864,8,0,0,0,0,16,24
66619,7,741,4,0,0,0,0,9,13
96795,5,693,10,0,0,0,0,4,14
54761,10,820,9,0,0,0,0,7,16
161974,10,413,6,0,0,0,1,10,17
915,10,29,6,0,0,0,0,11,17
54654,6,514,5,1,0,0,1,10,17
36398,10,111,22,0,0,0,0,28,50
132945,9,374,2,0,0,0,0,3,5
164538,10,29,6,0,0,0,0,11,17
112573,8,306,1,0,0,0,0,0,1
10137,10,200,23,0,0,0,0,32,55
76950,8,403,1,0,0,0,0,0,1
4764,5,159,6,0,0,0,0,0,6
95113,5,655,30,1,1,0,0,54,86
99026,9,607,11,0,0,0,0,22,33
156111,4,675,1,0,0,0,0,6,7
18530,10,628,42,1,0,1,0,71,115
109686,7,508,5,0,0,0,0,7,12
127913,7,527,1,0,0,0,0,2,3
68773,4,199,3,0,0,0,0,3,6
21364,8,214,82,0,0,0,0,120,202
145815,6,537,21,1,1,0,0,23,46
24257,9,405,29,0,0,0,0,56,85
161227,10,820,2,0,0,0,0,3,5
169973,5,159,3,0,0,0,0,3,6
52916,7,864,46,1,0,0,0,66,113
140251,9,538,6,0,0,0,0,13,19
123801,9,538,24,1,1,0,0,33,59
27881,5,693,1,0,0,0,0,1,2
111166,11,306,2,1,0,0,0,1,4
154991,5,200,1,0,0,0,0,1,2
69164,9,607,29,0,0,0,0,38,67
123377,10,474,17,0,0,0,0,35,52
105678,8,489,6,0,0,0,0,10,16
157478,9,838,8,0,0,0,0,10,18
118168,9,89,7,0,0,0,0,9,16
128636,6,643,4,0,0,0,0,4,8
28109,9,89,2,0,0,0,0,3,5
86372,9,538,6,0,0,0,0,11,17
8607,7,374,80,3,0,26,0,130,239
160908,4,36,42,0,0,0,0,70,112
48023,9,800,11,2,1,0,0,28,42
82309,6,78,302,9,4,0,2,435,752
115862,6,106,16,0,0,0,1,31,48
64888,7,909,33,1,1,0,0,41,76
7862,7,484,6,0,0,0,0,5,11
58624,10,66,6,0,0,0,0,17,23
80040,5,225,65,3,3,0,1,111,183
92357,10,66,0,0,0,0,0,8,8
73565,10,66,1,0,0,0,0,6,7
54630,10,66,0,0,0,0,0,4,4
75706,10,66,27,1,1,0,0,89,118
46758,7,489,2,0,0,0,0,2,4
5690,7,126,20,2,0,1,2,39,64
129359,7,551,21,1,1,0,0,55,78
170109,7,77,18,0,0,0,0,26,44
125742,7,374,35,3,0,26,0,53,117
85580,7,374,42,3,0,26,0,63,134
109654,7,374,43,3,0,26,0,72,144
118711,10,917,78,1,1,0,1,218,299
59490,7,77,37,0,0,0,0,87,124
103610,7,77,15,0,0,0,0,29,44
146276,9,909,2,0,0,0,0,24,26
79513,9,909,5,0,0,0,0,12,17
28790,7,563,4,0,0,0,0,8,12
93048,9,341,22,0,0,0,0,42,64
106557,7,484,6,0,0,0,0,8,14
104494,7,578,4,0,0,0,0,7,11
83538,9,658,2,0,0,0,0,2,4
38851,6,800,2,0,0,0,0,3,5
36614,9,658,14,0,0,0,0,14,28
80190,9,545,2,0,0,0,0,2,4
71512,5,306,204,2,1,0,3,310,520
144272,5,200,10,0,0,0,0,18,28
170468,5,306,74,0,0,0,0,92,166
60588,7,367,7,0,0,0,0,10,17
144198,9,158,31,0,0,0,0,42,73
116518,7,909,2,0,0,0,0,4,6
19326,9,874,10,0,0,0,0,17,27
123753,9,469,11,0,0,0,0,18,29
30993,6,221,20,0,0,0,0,28,48
28316,6,78,2,0,0,0,0,2,4
82359,7,824,26,0,0,0,0,53,79
92140,7,489,4,0,0,0,0,5,9
32589,6,78,15,0,0,0,1,22,38
55679,6,537,75,4,4,0,1,99,183
46431,11,214,26,2,0,0,0,32,60
19705,9,607,120,3,0,19,0,155,297
1617,9,607,106,3,0,19,0,154,282
101340,9,607,100,3,0,19,0,132,254
75123,9,158,2,0,0,0,0,15,17
74226,6,106,0,0,0,0,0,3,3
80408,10,798,0,0,0,0,0,3,3
134019,9,457,4,0,0,0,0,4,8
34807,5,225,3,0,0,0,0,4,7
150383,7,24,7,0,0,0,0,10,17
8915,9,838,2,0,0,0,0,3,5
34406,8,214,566,16,6,0,2,936,1526
10485,9,266,4,0,0,0,0,6,10
113549,8,214,322,2,0,0,0,532,856
47155,5,78,17,0,0,0,0,29,46
149389,7,46,2,0,0,0,0,2,4
109142,5,140,16,0,0,0,0,23,39
122922,6,209,12,1,1,0,0,26,40
4117,6,78,158,1,1,0,1,269,430
71,11,800,23,1,0,0,0,25,49
5033,7,460,2,0,0,0,0,5,7
88329,9,375,5,0,0,0,0,28,33
6324,9,622,1,0,0,0,0,2,3
37268,6,103,21,3,1,0,0,35,60
52892,7,484,4,0,0,0,0,5,9
144423,9,8,55,0,1,0,0,93,149
146491,7,211,3,0,0,0,0,4,7
4521,9,575,12,1,1,0,0,22,36
69832,7,551,4,0,0,0,0,8,12
104741,9,510,3,0,0,0,0,4,7
21969,10,917,0,0,0,0,0,9,9
125445,6,78,35,1,0,0,1,44,81
153837,9,597,71,2,2,0,0,118,193
104691,10,523,51,1,1,0,0,134,187
165212,10,868,1,0,0,0,0,0,1
152045,10,781,6,1,0,1,0,15,23
124066,7,842,74,3,2,0,0,116,195
25116,9,368,8,0,0,0,0,13,21
76824,7,312,3,0,0,0,0,4,7
102005,9,510,8,0,0,0,0,6,14
145432,10,841,26,3,0,0,0,52,81
44143,4,159,38,0,0,0,0,106,144
60923,4,200,8,0,0,0,0,16,24
58382,7,489,2,0,0,0,0,4,6
103364,10,701,61,0,0,0,0,69,130
2836,6,106,56,2,1,0,0,106,165
33971,7,263,14,0,0,0,0,17,31
148919,9,95,5,0,0,0,0,8,13
159250,9,353,9,0,0,0,0,13,22
50014,10,653,20,0,0,0,0,22,42
47269,9,353,2,0,0,0,0,4,6
150822,9,658,2,0,0,0,0,3,5
71092,9,353,13,0,0,0,0,19,32
33863,9,658,8,0,0,0,0,17,25
166987,9,658,24,1,0,0,0,31,56
126775,9,353,10,1,0,0,0,14,25
171168,9,353,11,0,1,0,0,19,31
96875,8,30,1,0,0,0,0,1,2
100582,8,693,1,0,0,0,0,10,11
102695,9,341,10,0,0,0,0,17,27
75812,11,693,1,0,0,0,0,3,4
56624,7,484,7,0,0,3,0,9,19
92873,7,489,2,0,0,0,0,2,4
80112,10,392,0,0,0,0,0,14,14
95302,6,585,6,1,1,0,0,8,16
136616,7,144,3,1,1,0,0,3,8
63695,7,741,161,2,2,1,2,214,382
84209,7,748,4,0,0,0,0,11,15
16589,7,74,5,0,0,0,0,6,11
47875,9,483,2,0,0,0,0,6,8
61760,9,483,0,0,0,0,0,5,5
156758,9,483,0,0,0,0,0,9,9
33842,7,56,15,1,1,0,0,22,39
112164,4,679,15,0,0,0,0,35,50
8783,10,413,2,0,0,0,0,3,5
159828,7,367,4,0,0,0,0,10,14
155378,9,245,4,0,0,0,0,5,9
14419,9,489,45,3,0,0,0,60,108
115452,9,684,8,0,0,0,0,18,26
134242,7,611,2,0,0,0,0,2,4
85626,7,741,26,0,0,0,0,38,64
96668,9,885,8,0,0,0,0,9,17
113751,9,885,13,0,0,0,0,18,31
118548,7,885,8,0,0,0,0,13,21
50751,5,78,9,0,0,0,0,9,18
1607,10,653,111,1,1,0,1,209,323
159238,9,796,10,0,0,0,0,10,20
120027,4,365,4,0,0,0,0,5,9
122020,7,243,8,0,0,0,0,9,17
151148,7,243,4,0,0,0,0,12,16
57730,7,243,12,0,0,0,0,7,19
44912,9,622,0,0,0,0,0,4,4
11410,9,622,1,0,0,0,0,5,6
148122,9,483,2,0,0,0,0,5,7
152723,7,589,21,0,0,0,0,12,33
122000,4,725,29,1,0,0,0,70,100
105711,8,214,70,0,0,0,0,117,187
54998,6,215,9,0,0,0,0,8,17
170435,4,365,8,0,0,0,0,11,19
98924,5,176,18,0,0,1,0,35,54
115564,9,657,1,0,0,0,0,1,2
142829,8,658,1437,67,16,7,11,2211,3749
124045,9,657,75,0,0,0,2,233,310
62773,9,657,60,0,0,0,0,150,210
46752,5,893,52,0,0,0,1,87,140
138074,7,100,6,0,0,0,0,11,17
164165,6,78,21,1,0,0,0,29,51
96638,7,912,5,0,0,0,0,8,13
18776,9,418,26,1,1,0,0,50,78
91163,9,800,6,0,0,0,0,11,17
73051,9,302,2,0,0,0,0,4,6
95683,6,78,559,10,8,0,2,841,1420
150148,6,140,7,0,0,0,0,7,14
12778,9,657,38,1,0,0,0,77,116
2333,5,479,2,0,0,0,0,2,4
31478,6,140,14,0,0,0,0,18,32
166068,4,375,3,0,0,0,0,5,8
35363,4,36,102,2,1,0,0,156,261
123979,4,375,1,0,0,0,0,1,2
76502,5,200,22,1,0,0,0,32,55
39412,5,159,18,0,0,0,0,26,44
146545,4,679,22,0,0,0,0,34,56
160806,6,785,56,3,2,0,0,104,165
168881,5,489,8,0,0,0,0,16,24
7193,5,773,7,0,0,0,0,8,15
145158,9,630,1,0,0,0,0,0,1
163924,4,678,3,0,0,0,0,0,3
54931,9,266,1,0,0,0,0,2,3
128902,8,489,1,0,0,0,0,2,3
164645,4,36,350,7,6,1,3,643,1010
21738,11,214,22,1,0,0,0,24,47
127820,9,469,7,0,0,0,0,13,20
103561,7,157,1,0,0,0,0,2,3
92870,8,306,1,0,0,0,0,0,1
49382,9,452,2,0,0,0,0,3,5
107168,9,910,14,0,0,0,0,16,30
1155,9,658,31,1,1,0,0,60,93
71769,9,910,12,0,0,0,0,17,29
9573,7,489,2,0,0,0,0,3,5
40649,8,403,2,0,0,0,0,0,2
123312,10,66,31,1,1,1,0,59,93
130238,10,66,9,0,0,0,0,22,31
152069,10,66,1,0,0,0,0,6,7
31418,8,693,5,0,0,0,0,11,16
81191,8,214,5,0,0,0,0,0,5
23845,8,214,3,0,0,0,0,0,3
38962,8,214,13,0,0,0,0,10,23
104642,8,214,1,0,0,0,0,0,1
131529,8,214,7,0,0,0,0,11,18
78611,8,214,1,0,0,0,0,0,1
116878,8,214,3,0,0,0,0,0,3
41533,8,214,2,0,0,0,0,0,2
33705,8,214,2,0,0,0,0,0,2
105955,8,214,3,0,0,0,0,0,3
5085,8,693,1,0,0,0,0,0,1
122677,8,214,2,0,0,0,0,0,2
167929,8,214,1,0,0,0,0,0,1
138781,8,214,2,0,0,0,0,0,2
113540,8,214,1,0,0,0,0,0,1
165129,11,214,3,0,0,0,0,0,3
110386,11,214,1,0,0,0,0,0,1
126784,4,306,21,0,0,0,0,25,46
123129,9,556,9,0,0,0,0,13,22
65074,10,36,210,3,0,0,1,365,579
47649,9,353,40,2,0,0,0,96,138
134249,9,95,11,1,1,0,0,13,26
96168,5,821,266,14,8,1,3,700,992
24062,6,537,76,2,1,0,1,118,198
160828,5,118,1,0,0,0,0,0,1
111974,10,474,6,0,0,0,0,8,14
9705,10,781,6,0,0,0,0,8,14
44589,9,489,143,2,0,0,1,196,342
30323,9,489,41,2,1,0,1,53,98
75823,9,658,14,0,0,0,1,33,48
106353,9,658,0,0,0,0,0,5,5
159182,9,457,8,0,0,0,1,15,24
170651,5,225,4,0,0,0,0,4,8
144768,7,56,1242,21,10,5,5,1953,3236
19637,4,159,185,2,1,0,0,321,509
129086,9,456,1,0,0,0,0,2,3
137667,10,289,8,0,0,0,0,9,17
33492,10,289,6,1,1,0,0,6,14
20036,10,111,59,2,0,0,0,73,134
150952,8,812,32,0,0,0,0,47,79
34492,11,214,2,0,0,0,0,1,3
46444,8,306,1,0,0,0,0,4,5
156589,9,489,8,0,0,0,0,13,21
98839,5,408,1,0,0,0,0,1,2
12996,11,812,8,0,0,0,0,9,17
111610,7,864,10,0,0,0,0,16,26
96002,7,149,21,0,0,0,0,26,47
25994,9,374,7,1,1,0,0,14,23
131741,9,487,1,0,0,0,0,1,2
94102,9,42,1,0,0,0,0,1,2
97928,9,575,5,0,0,0,0,11,16
120351,9,314,3,0,0,0,0,6,9
96899,8,658,2,1,0,0,0,4,7
61431,9,175,2,0,0,0,0,2,4
115202,9,405,5,0,0,0,0,9,14
68883,7,263,16,0,0,0,0,36,52
64702,5,570,4,0,0,0,0,4,8
50717,4,885,283,2,2,0,2,447,736
117954,9,800,8,2,0,0,0,14,24
106601,5,306,267,3,2,0,1,482,755
83912,8,812,38,2,2,0,0,82,124
121318,9,658,5,0,0,0,0,13,18
120684,8,545,361,5,0,0,2,469,837
130996,10,917,3,0,0,0,0,17,20
44222,4,159,5,0,0,0,0,10,15
96828,10,111,2,0,0,0,0,15,17
65449,11,489,1,0,0,0,0,1,2
152722,5,225,25,1,0,0,0,29,55
76821,4,752,651,15,6,1,2,1080,1755
125078,11,214,2,0,0,0,0,3,5
49205,4,159,8,0,0,0,0,3,11
75698,4,752,19,0,0,0,0,27,46
146749,5,355,525,17,6,3,0,830,1381
15234,10,820,4,0,0,0,0,2,6
77619,10,820,3,0,0,0,0,11,14
106738,5,561,1,0,0,0,0,0,1
58241,11,30,40,1,0,0,0,40,81
107705,9,472,2,0,0,0,0,3,5
113045,8,124,2,0,0,0,0,17,19
42076,9,657,28,0,0,0,0,29,57
153115,4,923,1,0,0,0,0,0,1
165034,9,657,6,0,0,0,0,6,12
102424,9,657,31,1,1,0,1,62,96
13079,9,657,46,1,1,0,0,68,116
122181,7,306,1,0,0,0,0,0,1
94277,5,355,105,6,4,0,1,214,330
4235,7,508,4,0,0,0,0,10,14
94911,7,508,3,0,0,0,0,4,7
7499,10,817,4,0,0,0,0,6,10
124510,9,323,2,0,0,0,0,2,4
34830,9,353,2,0,0,0,0,2,4
112327,8,812,27,0,0,0,0,43,70
97240,10,917,9,0,0,0,0,27,36
158429,9,375,1,0,0,0,0,0,1
2520,9,243,4,0,0,0,0,6,10
101014,9,842,53,0,0,0,0,54,107
50792,9,302,3,0,0,0,0,5,8
121051,5,78,32,3,1,0,0,46,82
70308,5,381,1,0,0,0,0,1,2
70624,11,214,2,0,0,0,0,2,4
69159,5,479,37,0,0,0,1,55,93
128775,6,585,23,1,0,0,1,36,61
101106,4,885,1533,40,20,0,6,2815,4414
71987,5,78,1,0,0,0,0,2,3
75568,4,200,1,0,0,0,0,1,2
123120,9,456,2,0,0,0,0,2,4
9418,9,8,10,0,0,0,0,20,30
106889,9,8,21,0,0,0,0,31,52
156210,5,78,302,10,4,0,0,521,837
125915,9,607,6,0,0,0,0,8,14
64439,9,65,55,3,2,0,0,119,179
113898,5,355,610,10,3,0,4,962,1589
112735,4,36,1756,58,32,3,13,3903,5765
106165,9,65,12,0,0,0,0,24,36
75902,11,693,2,0,0,0,0,5,7
48939,8,693,19,0,0,0,0,20,39
123367,6,78,150,0,0,0,1,231,382
92599,9,65,4,0,0,0,0,4,8
100068,10,519,0,0,0,0,0,78,78
6276,7,367,13,0,0,0,0,21,34
47128,4,800,2,0,0,0,0,2,4
46932,9,379,32,1,1,0,0,49,83
109985,9,243,2,0,0,0,0,2,4
16831,9,575,37,1,3,0,0,28,69
87893,7,80,16,0,0,0,0,24,40
90999,9,314,3,0,0,0,0,6,9
110136,9,107,9,0,0,0,0,16,25
71250,7,118,7,0,0,0,0,16,23
90951,9,78,33,0,0,0,0,54,87
49877,4,800,116,1,0,0,1,163,281
105488,4,159,46,0,0,0,0,61,107
145682,7,56,19,5,0,0,0,30,54
37008,6,885,8,0,0,0,0,8,16
38826,6,128,1,0,0,0,0,2,3
129002,9,575,4,0,0,0,0,6,10
169596,9,374,18,0,0,0,0,83,101
132579,9,560,18,0,0,0,0,24,42
16279,4,36,75,3,0,0,1,153,232
40856,7,864,44,1,0,0,0,53,98
72854,10,798,2,0,0,0,0,2,4
70955,7,669,3,0,0,0,0,7,10
96585,4,36,63,2,0,0,0,107,172
134206,7,669,6,0,0,0,0,15,21
105213,7,669,26,3,1,0,0,50,80
86458,7,669,8,0,0,0,0,24,32
44433,7,669,4,0,0,0,0,8,12
7931,7,669,8,0,0,0,0,13,21
98988,7,669,17,0,0,0,0,32,49
144502,7,157,33,0,0,0,0,53,86
102101,10,807,10,0,0,0,0,21,31
100549,9,570,5,1,0,0,0,6,12
85567,10,820,4,0,0,0,0,7,11
91706,7,74,8,0,0,0,0,6,14
118375,9,457,4,0,0,2,0,5,11
54845,8,214,341,3,1,0,0,486,831
8272,4,752,671,8,5,1,2,1118,1805
49257,11,214,2,0,0,0,0,0,2
166378,9,570,7,2,1,0,0,16,26
7774,9,483,1,0,0,0,0,0,1
39261,5,78,11,0,0,0,0,16,27
37732,9,510,2,0,0,0,0,7,9
28805,9,117,12,0,0,0,0,23,35
131882,9,510,3,0,0,0,0,6,9
91102,8,658,10,0,0,0,0,12,22
87486,5,78,36,0,0,0,1,51,88
84926,5,78,14,0,0,0,0,23,37
148213,9,489,3,0,0,0,0,5,8
53248,9,575,9,1,1,0,0,19,30
123964,5,453,15,0,0,0,0,26,41
156646,8,658,1088,35,14,1,9,1749,2896
143911,7,741,4,0,0,0,0,5,9
134038,10,549,5,0,0,0,0,5,10
156080,7,578,7,0,0,0,0,13,20
138009,6,290,2,0,0,0,0,2,4
89391,6,269,8,0,0,0,0,17,25
67231,7,657,8,0,0,0,0,24,32
154651,9,243,45,2,1,0,1,66,115
57941,7,611,6,0,0,0,0,15,21
17456,7,56,8,0,0,0,0,17,25
60955,8,812,31,0,0,0,0,70,101
77394,9,374,4,0,0,0,0,6,10
123099,6,78,115,0,0,0,1,177,293
155310,8,885,36,0,0,0,0,50,86
65769,4,658,57,0,0,0,0,72,129
119940,7,472,12,0,0,0,0,17,29
170306,9,510,2,0,0,0,0,2,4
9476,11,124,19,1,0,0,0,22,42
36291,9,85,6,0,0,0,0,5,11
45946,6,785,13,2,1,0,0,23,39
60883,9,85,2,0,0,0,0,5,7
46102,9,85,2,0,0,0,0,9,11
128655,5,200,9,0,0,0,0,12,21
166134,9,8,15,0,0,0,0,24,39
21609,11,623,11,0,0,0,0,15,26
128410,6,843,41,0,0,0,1,95,137
159674,4,36,5310,151,61,16,22,9307,14867
62689,4,36,150,2,1,0,1,219,373
139373,7,741,65,0,0,0,0,118,183
24215,9,4,16,0,0,0,0,20,36
154840,6,601,10,1,1,0,0,24,36
75059,11,214,2,0,0,0,0,1,3
120063,7,228,9,1,1,0,0,15,26
119825,9,243,1,0,0,0,0,0,1
164030,9,538,7,0,0,0,0,13,20
114825,9,367,5,0,0,0,0,7,12
45523,6,306,2,0,0,0,0,0,2
143913,9,800,6,0,0,0,0,5,11
101726,11,214,14,0,0,0,0,15,29
152447,5,78,13,0,0,0,0,27,40
125574,5,78,146,8,3,0,0,249,406
73952,6,290,5,0,0,0,0,10,15
21755,9,575,13,0,0,0,0,21,34
94861,6,78,72,0,0,0,0,102,174
152566,6,78,32,1,1,0,1,39,74
5990,9,313,10,0,0,0,0,9,19
18026,9,313,2,0,0,0,0,4,6
39137,7,521,6,0,0,0,0,9,15
86665,7,741,15,0,0,0,0,20,35
59899,7,741,13,0,0,0,0,28,41
115651,9,157,27,0,0,0,0,48,75
63417,9,575,13,0,0,0,0,25,38
128709,11,812,1,0,0,0,0,0,1
27248,7,611,22,0,0,0,0,43,65
138844,8,124,1,0,0,0,0,0,1
64027,7,157,5,0,0,0,0,29,34
101134,8,124,30,0,0,0,2,39,71
73802,7,611,64,0,0,0,1,115,180
30207,7,611,20,0,0,0,0,26,46
54587,8,124,9,0,0,0,0,8,17
137001,8,403,311,10,4,0,1,469,795
142714,9,266,8,0,0,0,0,9,17
79413,6,375,2,0,0,0,0,0,2
15344,7,429,1,0,0,0,0,1,2
94204,4,679,345,9,8,0,0,573,935
123933,7,611,4,0,0,0,0,4,8
149533,9,353,10,0,0,0,0,17,27
160495,5,489,48,0,0,0,0,91,139
135346,9,538,13,0,0,0,0,32,45
117996,8,214,2290,67,23,4,21,3795,6200
82262,4,678,9,0,0,0,0,6,15
4523,9,158,16,0,0,0,0,18,34
137316,4,36,59,2,1,0,0,87,149
40682,8,812,27,1,1,0,0,38,67
34629,7,448,353,10,6,2,0,547,918
136819,7,508,3,0,0,0,0,5,8
115115,10,868,6,0,0,0,0,14,20
79877,10,868,0,0,0,0,0,4,4
41993,10,868,0,0,0,0,0,3,3
141856,8,214,92,1,1,0,2,179,275
140885,10,413,2,0,1,0,0,2,5
138111,10,807,3,0,0,0,0,3,6
38331,7,226,6,0,0,0,0,8,14
97630,7,196,11,0,0,0,0,10,21
88311,10,653,23,0,0,0,0,48,71
104235,7,587,14,0,0,0,0,26,40
28081,7,587,14,0,0,0,0,14,28
95880,6,453,16,0,0,0,0,97,113
107973,8,214,124,3,2,0,1,251,381
103422,4,679,60,1,1,0,0,107,169
138372,9,828,2,0,0,0,0,2,4
118998,6,140,23,0,0,0,0,32,55
148850,9,532,20,1,1,0,0,43,65
167907,9,452,12,0,0,0,0,10,22
13211,9,302,18,0,0,0,0,46,64
76608,9,532,1,1,1,0,0,25,28
131860,10,820,4,1,1,0,0,10,16
32892,9,658,24,0,0,0,0,34,58
155563,8,885,11,3,0,0,0,14,28
122722,11,885,0,3,0,0,0,0,3
98749,5,78,76,1,1,0,1,120,199
127236,5,78,65,0,0,0,0,94,159
150361,9,462,5,1,0,0,0,6,12
133255,8,214,2,0,0,0,0,4,6
120510,8,489,2,0,0,0,0,3,5
35570,9,54,1,0,0,0,0,1,2
9973,5,71,27,2,1,0,0,28,58
12356,8,693,2,0,0,0,0,3,5
63770,9,8,10,1,0,0,0,19,30
128652,8,489,182,2,2,0,1,363,550
114675,9,800,11,0,0,0,0,20,31
100468,10,653,108,1,1,0,1,192,303
12811,10,653,82,1,1,0,0,186,270
34084,6,71,88,3,1,0,0,104,196
93864,5,479,73,2,0,0,0,109,184
133917,9,469,3,1,1,0,0,5,10
128022,8,489,1,0,0,0,0,0,1
41113,11,885,1,0,0,0,0,2,3
57392,7,24,3,0,0,0,0,1,4
152625,4,800,27,0,0,0,0,39,66
62060,7,226,2,0,0,0,0,0,2
72148,7,306,1,0,0,0,0,3,4
161694,8,658,672,38,7,1,7,1236,1961
89381,9,367,0,0,1,0,0,0,1
15138,8,800,3,0,0,0,0,0,3
119646,7,741,15,0,0,0,0,17,32
98933,4,453,7,0,0,0,0,8,15
86970,5,176,23,0,0,0,0,31,54
104260,10,322,4,1,1,0,0,4,10
61245,8,790,1,0,0,0,0,1,2
6694,4,36,6582,202,79,14,49,11694,18620
34293,9,842,1258,28,15,6,1,1834,3142
54379,10,322,2,1,1,0,0,5,9
86024,8,489,1,0,0,0,0,0,1
110166,4,36,3281,120,47,16,31,6576,10071
160805,9,873,118,4,2,0,0,182,306
114832,7,521,15,0,0,0,0,15,30
152068,7,741,7,0,0,0,0,9,16
114784,8,214,38,0,0,0,1,67,106
130376,10,289,0,0,0,0,0,4,4
129351,10,289,4,0,0,0,0,6,10
154460,9,842,983,22,6,4,5,1635,2655
116182,9,175,4,0,0,0,0,13,17
5068,8,214,18,0,0,0,0,25,43
64899,11,124,10,0,0,0,0,7,17
103462,7,611,2,0,0,0,0,3,5
51565,7,611,2,0,0,0,0,3,5
170603,7,611,2,0,0,0,0,4,6
128708,5,235,3,0,0,0,0,4,7
33667,7,570,15,0,0,0,0,16,31
140159,4,675,3,0,0,0,0,3,6
18211,6,505,23,0,0,0,0,52,75
2589,9,640,141,0,0,0,0,204,345
80956,9,367,16,0,0,0,0,23,39
133054,9,452,9,1,1,0,0,8,19
80953,9,100,29,3,0,0,0,42,74
115211,5,78,3,0,0,0,0,2,5
119085,8,214,574,9,2,1,0,898,1484
33386,5,355,42,0,0,0,0,76,118
19017,9,314,16,1,0,0,0,16,33
20663,6,235,1,0,0,0,0,1,2
134899,9,570,5,0,0,0,0,11,16
126104,8,214,2,0,0,0,0,2,4
6202,6,200,3,0,0,0,0,5,8
6454,9,545,11,0,0,0,0,30,41
116295,9,353,6,0,0,0,0,10,16
39595,11,916,1,0,0,0,0,0,1
110204,9,658,2,0,0,0,0,3,5
37707,7,448,27,2,2,0,0,82,113
35811,11,214,1,0,0,0,0,1,2
121697,8,545,1,0,0,0,0,0,1
168740,7,521,21,1,0,0,0,28,50
145131,7,864,11,2,1,0,0,21,35
47703,10,208,3,0,0,0,0,4,7
131245,6,785,26,0,0,0,0,51,77
20787,4,679,35,0,0,0,0,53,88
123300,4,200,3,0,0,0,0,17,20
95003,7,126,5,0,0,0,0,7,12
82878,11,214,7,0,0,0,0,5,12
96674,5,78,20,0,0,0,1,39,60
107314,7,56,4,0,0,0,0,8,12
3924,11,812,4,0,0,0,0,5,9
37317,6,232,1,0,0,0,0,1,2
46822,10,820,8,0,0,0,0,25,33
10231,5,306,1,0,0,0,0,0,1
100119,8,812,21,0,1,0,0,39,61
88424,4,679,11,1,1,0,0,17,30
132349,9,418,37,1,1,0,1,52,92
169342,9,418,4,0,0,0,0,5,9
76553,9,6,4,0,0,0,0,5,9
67433,7,100,6,0,0,0,0,4,10
51617,9,6,2,0,0,0,0,3,5
52376,10,217,33,0,0,0,0,30,63
42693,10,256,31,1,0,1,0,58,91
11600,5,225,2,1,0,0,0,3,6
145618,11,812,0,0,0,0,0,34,34
162476,5,78,1,0,0,0,0,1,2
5596,10,722,51,3,2,0,0,116,172
67073,5,4,3,0,0,0,0,5,8
102409,5,4,1,0,0,0,0,0,1
154629,9,489,6,0,0,0,0,6,12
45453,9,489,1,0,0,0,0,1,2
71590,10,653,88,0,0,0,0,167,255
141866,9,658,15,1,0,0,0,16,32
134905,9,640,4,0,0,0,0,4,8
143689,4,36,1,0,0,0,0,1,2
68698,6,78,31,0,0,0,0,51,82
144873,9,575,28,0,0,0,0,49,77
132592,9,302,4,0,0,0,0,6,10
98998,9,657,9,1,1,0,0,19,30
89126,9,657,25,2,1,0,0,30,58
81056,10,653,6,0,0,0,0,37,43
151973,10,653,5,0,0,0,0,54,59
114560,7,741,16,0,0,0,0,26,42
38530,7,698,27,1,0,1,0,57,86
735,7,74,46,0,0,0,0,81,127
18572,7,578,0,0,0,0,0,4,4
100039,6,263,2,0,0,0,0,1,3
155102,6,561,2,0,0,0,0,1,3
166027,4,679,39,3,2,0,1,87,132
115995,9,202,6,0,0,0,0,12,18
124142,9,202,3,0,0,0,0,10,13
70176,6,885,19,0,0,0,0,25,44
111532,6,306,16103,532,186,37,123,26065,43046
43199,9,341,4,0,0,0,0,15,19
87777,6,306,3875,97,37,6,24,6177,10216
78534,10,653,2,0,0,0,0,5,7
127338,10,653,50,0,0,0,0,79,129
24427,9,78,1,0,0,0,0,1,2
79928,9,43,2,0,0,0,0,3,5
28083,9,202,6,0,0,0,0,10,16
86815,9,85,44,0,0,0,0,64,108
160104,9,469,44,0,0,0,1,50,95
156578,9,469,2,0,0,0,0,3,5
42492,9,469,16,0,0,0,0,28,44
144053,11,355,3,0,0,0,0,2,5
6380,9,89,2,0,0,0,0,3,5
78476,10,66,4,0,0,0,0,6,10
159796,10,66,1,0,0,0,0,1,2
109671,10,66,5,0,0,0,0,10,15
95913,10,355,47,0,0,0,0,80,127
28924,5,78,16,0,0,0,0,18,34
112689,9,4,18,1,0,0,0,16,35
48521,9,909,3,0,0,0,0,5,8
42905,9,909,2,0,0,0,0,6,8
143636,9,367,82,0,0,0,1,100,183
81592,8,214,77,2,1,0,0,112,192
59376,9,8,5,0,0,0,0,14,19
3153,10,618,5,4,1,0,0,9,19
54647,10,81,6,0,0,0,0,7,13
7368,6,215,6,0,0,0,0,10,16
152255,9,216,8,0,0,0,0,16,24
129438,9,243,8,0,0,0,0,9,17
88333,10,841,5,0,0,0,0,12,17
77429,10,841,8,0,0,0,0,9,17
91599,6,489,76,2,1,0,0,153,232
88988,6,514,11,0,0,0,0,19,30
131129,7,508,10,0,0,0,0,12,22
130739,6,585,7,0,0,0,0,15,22
137765,10,355,2,0,0,0,0,0,2
99989,7,508,7,0,0,0,0,10,17
94876,7,508,6,0,0,0,0,8,14
147188,9,314,56,1,0,0,0,48,105
16981,9,885,2,0,0,0,0,3,5
47350,9,452,4,0,0,0,0,6,10
108508,5,124,14,0,0,0,0,18,32
19381,4,675,1,0,0,0,0,2,3
124895,7,660,2,0,0,0,0,2,4
152214,4,174,1,0,0,0,0,2,3
34034,7,228,2,0,0,0,0,10,12
15847,7,228,4,0,0,0,1,17,22
39015,7,306,1,0,0,0,0,2,3
49430,4,800,2,0,0,0,0,3,5
134704,4,200,4,0,0,0,0,7,11
131166,9,301,107,1,0,1,0,163,272
142990,9,693,6,0,0,0,0,9,15
98673,4,159,9,0,0,0,0,21,30
165707,4,300,252,6,3,0,2,482,745
140344,9,575,2,0,0,0,0,3,5
68608,9,243,16,0,0,0,0,26,42
168382,9,570,6,0,0,0,0,7,13
53922,7,56,1,0,0,0,0,4,5
27346,9,158,4,0,0,0,0,6,10
80719,9,158,47,1,1,0,1,111,161
29451,4,679,791,25,8,2,6,1389,2221
63189,9,873,12,0,0,0,1,60,73
93494,9,873,14,0,0,0,0,41,55
138806,9,873,20,1,1,0,0,49,71
122635,9,842,22,0,0,0,0,18,40
117428,10,66,6,0,1,0,1,13,21
115070,10,66,40,0,0,0,0,20,60
44331,9,78,300,0,0,0,0,463,763
95684,7,861,23,0,0,0,0,67,90
163821,10,22,4,0,0,0,0,4,8
21522,4,923,7,2,0,0,0,12,21
103386,8,214,11,0,0,0,0,6,17
27241,9,175,6,2,1,0,0,13,22
74607,9,175,8,0,0,0,0,12,20
107488,9,456,4,0,0,0,0,4,8
128268,9,456,6,0,0,0,0,4,10
140603,9,175,2,0,0,0,0,3,5
57912,8,214,1,0,0,0,0,0,1
57288,11,545,24,8,0,0,0,25,57
137221,11,306,27,0,0,0,0,25,52
127344,4,174,0,1,0,0,0,0,1
26453,7,384,41,0,1,0,0,44,86
60610,9,429,1,0,0,0,0,1,2
51215,9,429,3,0,0,0,0,4,7
64212,10,628,1,0,0,0,0,6,7
171102,7,484,9,0,0,0,0,18,27
76672,7,484,17,0,0,0,1,36,54
159562,9,367,35,0,0,0,0,50,85
92736,9,367,33,2,1,0,0,71,107
114255,8,403,5,0,0,0,0,6,11
119394,9,77,70,1,1,0,0,99,171
55878,10,322,2,0,0,0,0,3,5
113057,7,892,4,0,0,0,0,6,10
78942,9,427,28,0,0,0,0,70,98
43419,10,816,3,0,0,0,0,2,5
114755,7,492,4,0,0,0,0,6,10
35619,7,578,8,1,0,0,0,27,36
91534,7,484,10,0,0,0,0,10,20
26971,7,484,9,0,0,0,0,16,25
84407,7,508,4,0,0,0,0,8,12
97515,4,36,3585,128,67,14,25,6671,10490
37043,5,263,1768,78,38,5,15,3214,5118
108596,5,235,30,1,1,0,0,45,77
11282,9,575,3,0,0,0,0,9,12
153279,10,242,2,0,0,0,0,3,5
129171,9,4,5,0,0,0,0,8,13
131275,11,214,22,0,0,0,0,23,45
111192,8,623,3,0,0,0,0,2,5
76956,7,861,17,0,0,0,0,34,51
77903,9,367,12,0,0,0,0,43,55
56458,9,367,4,1,0,0,0,5,10
56354,10,820,0,0,0,0,0,3,3
16732,7,861,132,0,0,0,0,233,365
166058,11,214,3,0,0,0,0,3,6
109214,7,312,2,0,0,0,0,2,4
4046,5,489,194,4,2,0,1,334,535
149872,10,413,4,0,0,0,0,7,11
21358,10,413,6,0,0,0,0,12,18
117196,7,508,2,0,0,0,0,3,5
69500,7,508,1,0,0,0,0,2,3
102298,9,828,6,1,0,0,0,6,13
83898,7,861,9,0,0,0,0,20,29
124535,5,263,1011,54,14,3,11,1611,2704
149426,9,353,10,2,0,0,0,32,44
131289,9,630,14,0,0,0,0,6,20
69808,10,413,3,0,0,0,0,8,11
4034,10,413,6,0,0,0,0,19,25
72514,7,472,5,0,0,0,0,7,12
96230,7,472,2,0,0,0,0,3,5
97558,10,413,1,0,0,0,0,1,2
20688,11,306,36,0,0,0,0,30,66
120170,9,532,4,0,0,0,0,3,7
167759,4,36,61,1,1,0,0,86,149
47549,10,66,5,0,0,0,0,12,17
9466,10,66,6,0,0,0,0,5,11
32754,11,545,1,0,0,0,0,0,1
91536,8,545,23,0,0,0,0,27,50
136356,10,81,9,0,0,0,0,14,23
111982,5,200,2,0,0,0,0,3,5
87497,6,124,150,4,2,0,2,231,389
46359,8,124,4,0,0,0,0,7,11
111950,9,693,12,0,0,0,0,18,30
122962,11,812,45,0,0,0,0,125,170
104865,6,885,2,0,0,0,0,0,2
69230,8,403,2325,44,13,1,13,3765,6161
49141,9,489,29,0,0,0,0,89,118
130665,8,623,8,0,0,0,0,8,16
114985,4,199,1,0,0,0,0,0,1
49473,5,893,11,0,0,0,0,17,28
81834,8,403,2,0,0,0,0,6,8
16847,9,367,96,4,1,0,0,129,230
148001,8,403,1777,48,16,5,7,3079,4932
111870,8,214,1,0,0,0,0,1,2
87831,7,56,1,0,0,0,0,1,2
100921,10,111,5,0,0,0,0,2,7
129078,10,111,2,0,0,0,0,4,6
92795,4,581,2508,60,21,6,18,4678,7291
96993,5,306,2,0,0,0,0,2,4
131683,7,570,0,0,0,0,0,135,135
155295,4,215,45,0,0,0,0,93,138
59798,9,842,86,3,0,0,1,78,168
131967,9,65,1,0,0,0,0,20,21
82618,9,842,95,0,0,0,0,147,242
143473,10,653,37,0,0,0,1,82,120
43641,11,403,27,2,0,0,0,32,61
124244,9,145,8,0,0,0,0,59,67
60359,9,469,1,0,0,0,0,1,2
3913,4,658,3,0,0,0,0,6,9
96340,9,630,128,6,0,5,0,160,299
86253,5,225,43,0,0,0,1,64,108
120713,9,243,14,0,0,0,1,21,36
153507,5,218,4,0,0,0,0,5,9
121530,7,74,2,0,0,0,0,2,4
25612,10,111,28,0,0,0,1,32,61
40283,7,484,33,0,0,0,1,55,89
107622,10,111,11,0,0,0,0,24,35
74416,10,334,2,0,0,0,0,3,5
73228,10,66,4,0,0,0,0,6,10
135078,9,65,21,0,0,0,0,29,50
101304,9,353,2,0,0,0,0,3,5
79813,6,514,2,0,0,0,0,5,7
28482,9,589,15,0,0,0,0,32,47
101946,7,100,4,0,0,0,0,4,8
154998,9,589,44,3,2,0,0,49,98
12726,9,483,1,0,0,0,0,0,1
88800,10,66,12,1,2,0,0,19,34
142516,4,159,2,0,0,0,0,1,3
35413,10,322,4,0,0,0,0,6,10
125882,4,679,87,0,0,0,0,138,225
161770,7,387,193,4,3,0,0,316,516
65970,7,658,57,3,0,1,0,87,148
142489,7,748,1,0,0,0,0,1,2
73725,10,818,6,0,0,0,0,6,12
61116,6,800,1,0,0,0,0,1,2
124680,10,111,23,1,0,0,0,56,80
147062,6,124,46,0,0,2,0,54,102
30715,10,111,4,0,0,0,0,5,9
43841,9,302,0,0,0,0,0,4,4
71909,9,302,11,0,0,0,0,31,42
30411,9,570,1,0,0,0,0,2,3
162862,7,489,3,0,0,0,0,1,4
78179,9,874,29,1,1,0,0,41,72
33543,11,214,4,0,0,0,0,5,9
94244,4,800,4,0,0,0,0,6,10
151910,9,147,1,0,0,0,0,1,2
69392,9,147,1,0,0,0,0,1,2
71469,6,78,17,0,0,0,0,36,53
85416,7,492,2,0,0,0,0,3,5
23661,11,214,42,0,0,0,0,51,93
29941,8,211,2,0,0,0,0,3,5
88708,9,158,4,0,0,0,0,3,7
36043,7,521,6,0,0,0,0,7,13
63715,11,214,27,3,0,0,0,28,58
165647,10,820,21,2,1,0,0,23,47
106044,10,642,9,0,0,0,0,15,24
55300,5,78,19,0,0,0,0,30,49
146479,9,100,9,0,0,0,0,3,12
83655,9,367,2,0,0,0,0,4,6
84996,8,214,37,0,0,0,0,83,120
11709,6,78,364,6,3,0,4,608,985
42166,6,78,34,0,0,0,1,59,94
137532,6,78,25,0,0,0,1,33,59
70159,9,714,1,0,0,0,0,1,2
67796,8,403,570,9,4,1,2,763,1349
118310,9,341,35,0,0,0,1,63,99
76531,5,306,2,0,0,0,0,0,2
152832,7,263,9,0,0,0,0,17,26
49605,9,483,6,0,0,0,0,7,13
115064,7,254,2,0,0,0,0,4,6
39269,10,628,10,0,0,0,0,18,28
115028,7,521,3,0,0,0,0,5,8
84747,10,29,14,0,0,0,0,38,52
85902,10,29,0,0,0,0,0,8,8
147528,9,367,8,0,0,0,0,12,20
86443,7,864,42,4,0,0,0,83,129
41872,7,587,33,0,0,0,0,42,75
22573,4,115,9,0,0,0,0,27,36
110437,4,453,1,0,0,0,0,2,3
38340,9,657,36,0,0,0,0,68,104
70974,4,159,2,0,0,0,0,3,5
170308,8,658,1,0,0,0,0,1,2
36729,5,821,2,0,0,0,0,3,5
1947,5,489,911,53,27,4,6,1480,2481
100156,10,29,4,0,0,0,0,6,10
152305,4,306,3,0,0,0,0,2,5
28309,9,65,9,0,0,0,0,14,23
10233,9,301,18,0,0,0,0,26,44
141628,9,535,4,0,0,0,0,5,9
67225,7,448,2,1,1,0,0,23,27
96696,10,66,10,0,0,0,0,23,33
160978,5,489,318,16,5,0,5,540,884
120208,7,367,960,20,11,3,3,1429,2426
73721,10,66,8,0,0,0,0,21,29
56588,7,56,9,0,0,0,0,30,39
49363,9,302,11,0,0,0,0,13,24
36125,9,570,31,0,0,0,0,38,69
161607,9,631,5,0,0,0,0,7,12
169685,9,78,660,0,0,0,3,925,1588
124196,4,658,8787,256,80,21,46,16442,25632
23170,4,453,2,0,0,0,0,1,3
122164,8,214,23,0,0,0,0,29,52
32264,10,519,46,0,0,0,0,84,130
120514,7,61,2,0,0,0,0,2,4
123338,7,484,2,0,0,0,0,2,4
11228,7,74,2,0,0,0,0,2,4
130978,7,864,2,0,0,0,0,2,4
167829,9,147,2,0,0,0,0,0,2
22903,9,360,2,0,0,0,0,0,2
110515,9,575,6,0,0,0,0,8,14
84465,8,214,3,0,0,0,0,2,5
94486,9,693,11,0,0,0,0,16,27
128124,9,510,2,0,0,0,0,4,6
98298,9,375,2,0,0,0,0,2,4
41086,9,575,9,1,0,0,0,22,32
73425,5,200,8,0,0,0,0,8,16
76959,8,306,2337,73,31,5,16,4254,6716
114463,10,797,5,0,0,0,0,12,17
537,7,387,11,0,0,0,0,8,19
74616,8,214,176,4,1,1,1,306,489
107141,9,538,4,0,0,0,0,13,17
151328,6,800,6,0,0,0,0,12,18
161193,8,306,4388,95,34,2,31,7239,11789
67004,5,200,34,0,0,0,0,49,83
8165,9,379,29,2,0,0,0,68,99
155950,9,462,2,0,0,0,0,3,5
122250,6,124,113,2,1,0,1,200,317
24959,7,56,57,1,0,0,0,118,176
146345,5,263,2,0,0,0,0,3,5
151428,9,367,18,1,1,0,0,15,35
101933,10,66,7,0,0,0,0,10,17
87715,10,917,4,0,0,0,0,5,9
2656,4,220,1,0,0,0,0,1,2
71121,4,658,975,7,7,4,2,1524,2519
160259,7,157,4,0,0,0,0,4,8
115099,10,917,12,0,0,0,0,31,43
4810,8,214,1,0,0,0,0,1,2
114418,7,508,26,0,0,0,1,62,89
68114,7,56,12,1,1,0,0,21,35
119703,7,508,4,0,0,0,0,4,8
115832,6,103,8,0,0,0,0,8,16
126853,7,508,4,0,0,0,1,9,14
38465,7,748,6,0,0,0,0,8,14
26876,9,469,1487,47,32,0,9,2081,3656
7879,7,80,20,1,0,0,0,28,49
160898,9,353,3,0,0,0,0,7,10
68666,9,750,6,0,0,0,0,9,15
122641,9,471,43,3,2,0,0,81,129
70975,11,623,2,0,0,0,0,2,4
18008,8,214,8,0,0,0,0,12,20
127420,4,174,1,0,0,0,0,0,1
46861,9,885,2,0,0,0,0,3,5
4997,9,885,4,0,0,0,0,6,10
5103,11,214,6,0,0,0,0,4,10
147991,9,301,2,0,0,0,0,10,12
139053,7,196,8,0,0,0,0,14,22
20891,7,741,2,0,0,0,0,4,6
59095,9,632,2,0,0,0,0,0,2
116784,5,655,17,0,0,0,0,26,43
152469,10,653,66,0,0,0,0,138,204
152714,4,200,11,0,0,0,0,17,28
49009,7,157,47,1,0,0,0,78,126
119025,5,306,3,0,0,0,0,6,9
62276,9,452,13,0,0,0,0,16,29
12055,10,917,2,0,0,0,0,3,5
79246,9,399,19,1,0,0,0,21,41
92491,9,399,2,0,0,0,0,2,4
105959,9,399,2,0,0,0,0,1,3
141496,11,214,12,0,0,0,0,11,23
112423,9,819,24,0,0,0,0,34,58
133629,5,78,1661,79,31,4,11,2728,4514
93137,5,238,5,0,0,0,0,10,15
143667,10,653,443,9,5,0,5,689,1151
98792,10,66,3,0,0,0,0,9,12
27755,10,66,10,0,0,0,0,16,26
165476,9,86,22,2,1,0,1,96,122
37638,8,306,9564,392,126,35,69,15802,25988
37647,6,375,25,0,0,0,0,37,62
57067,10,628,41,3,1,1,0,106,152
170364,10,628,6,2,1,0,0,13,22
114412,10,752,6,0,0,0,0,7,13
85985,7,741,9,0,0,0,0,13,22
164345,10,722,4,0,0,0,0,6,10
146315,7,909,20,0,0,0,0,31,51
69359,8,885,2,0,0,0,0,3,5
87874,7,535,35,0,0,0,0,53,88
157196,6,165,3,0,0,0,0,2,5
111832,4,124,1,0,0,0,0,0,1
163458,9,203,2,0,0,0,0,14,16
57087,6,78,36,0,0,0,1,50,87
154598,6,885,1,0,0,0,0,0,1
149708,9,315,10,0,1,0,0,14,25
46488,7,216,84,2,0,0,1,109,196
71254,7,379,12,1,0,1,0,19,33
107187,5,235,14,0,0,0,0,28,42
14824,9,8,7,0,0,0,0,9,16
33977,7,30,27,1,1,0,0,47,76
7750,9,684,2,0,0,0,0,3,5
89800,9,684,2,0,0,0,0,4,6
127505,10,917,6,0,0,0,0,10,16
48539,6,78,1157,43,17,0,9,1832,3058
74126,7,484,53,1,0,0,1,87,142
130598,6,296,6,0,0,0,0,6,12
84873,7,46,10,0,0,0,0,9,19
9903,7,46,28,0,0,2,0,40,70
67515,7,74,10,0,0,0,0,11,21
144058,9,78,349,0,0,0,1,488,838
51736,4,923,5,0,0,0,0,19,24
154961,5,561,2,0,0,0,0,0,2
124651,9,4,20,2,0,0,0,59,81
110094,9,399,3,0,0,0,0,4,7
99105,7,822,8,1,0,0,0,11,20
170125,8,214,55,2,0,0,0,90,147
67560,9,302,8,0,0,0,0,8,16
155738,9,632,2,0,0,0,0,3,5
56381,9,796,2,0,0,0,0,3,5
39934,7,46,52,0,0,4,0,63,119
99902,9,570,19,0,0,0,0,32,51
149162,8,812,40,0,1,0,0,67,108
11861,8,489,57,3,2,0,0,87,149
41358,9,471,9,1,1,0,0,36,47
157338,7,211,4,0,0,0,0,6,10
69321,4,365,2,0,0,0,0,4,6
163704,10,781,4,0,0,0,0,3,7
48101,10,781,4,0,0,0,0,5,9
82153,10,781,2,0,0,0,0,2,4
51152,10,781,8,1,1,0,0,11,21
22529,10,413,4,1,1,0,0,5,11
151180,10,413,7,0,0,0,0,13,20
63365,10,413,1,0,0,0,0,10,11
52688,10,413,6,0,0,0,0,13,19
67735,10,413,6,0,0,0,0,12,18
73597,10,413,0,0,0,0,0,5,5
112690,10,413,2,0,0,0,0,2,4
108511,9,100,10,0,0,0,0,13,23
133766,9,657,380,13,8,1,3,690,1095
163565,11,306,6,1,0,0,0,6,13
67105,9,42,0,0,1,0,0,0,1
75662,9,42,0,0,1,0,0,0,1
55605,9,42,0,0,1,0,0,0,1
70851,9,510,0,0,1,0,0,0,1
157077,9,175,0,0,1,0,0,0,1
6686,9,631,0,0,1,0,0,0,1
118738,9,909,4,0,1,0,0,4,9
13483,11,623,3,0,0,0,0,1,4
61158,8,214,319,7,4,0,2,584,916
162992,7,118,3,0,0,0,0,5,8
2808,10,200,1,0,0,0,0,1,2
75420,4,679,134,5,1,0,0,266,406
83271,5,489,441,28,16,7,1,666,1159
23440,8,214,752,6,4,1,2,1055,1820
39857,6,140,12,0,0,0,0,16,28
43590,4,453,1,0,0,0,0,0,1
87898,7,693,8,0,0,0,0,8,16
143146,4,679,73,0,0,0,1,62,136
85825,10,413,2,0,0,0,0,3,5
112378,4,375,2,0,0,0,0,0,2
36343,8,214,268,0,0,0,2,461,731
97076,4,800,3,0,0,0,0,5,8
27149,11,214,2,0,0,0,0,1,3
154064,11,214,2,0,0,0,0,1,3
23348,7,489,5,0,0,0,0,5,10
86343,5,821,40,2,1,0,0,57,100
118480,9,341,9,0,0,0,0,18,27
79627,7,367,5,0,0,0,0,7,12
160404,10,29,5,0,0,0,0,11,16
51788,4,885,89,1,1,0,0,113,204
12064,5,821,2,0,0,0,0,6,8
126512,11,214,10,0,0,0,0,10,20
166990,7,384,6,0,0,0,0,5,11
152986,8,214,507,21,11,2,4,935,1480
161734,8,214,979,31,3,0,5,1686,2704
159735,6,453,25,0,0,0,0,39,64
22734,7,508,3,0,0,0,0,3,6
64177,8,306,4136,181,59,23,18,7252,11669
143060,9,341,6,0,0,0,0,6,12
153541,5,381,6,0,0,0,0,9,15
67093,8,658,11,0,0,0,0,11,22
135774,7,306,2157,82,19,9,8,3771,6046
59249,8,306,1,0,0,0,0,3,4
152610,9,341,7,0,0,0,0,6,13
85033,11,214,1,0,0,0,0,1,2
47749,6,165,5,0,0,0,0,4,9
57240,6,140,16,0,0,0,0,22,38
7583,11,489,1,0,0,0,0,1,2
89425,4,220,4,0,0,0,0,16,20
88490,7,118,42,0,0,0,0,49,91
168078,7,226,3,0,0,0,0,5,8
13700,7,226,2,0,0,0,0,4,6
145396,7,226,2,0,0,0,0,3,5
45513,11,623,3,0,0,0,0,2,5
8595,5,306,1926,30,11,0,6,3187,5160
59889,6,901,6,0,0,0,0,8,14
23172,7,611,5,0,0,0,0,5,10
3508,7,367,2,0,0,0,0,2,4
170998,8,214,429,2,3,0,1,763,1198
124315,6,306,384,6,3,0,2,604,999
101584,11,489,72,7,0,1,0,71,151
10604,8,403,102,0,0,0,0,180,282
114787,5,505,10,0,0,0,0,13,23
141740,9,589,10,0,0,0,0,16,26
96528,6,922,1,0,0,0,0,1,2
281,8,214,5432,77,25,18,29,7611,13192
54696,10,66,0,0,0,0,0,1,1
33931,10,66,6,0,0,0,0,4,10
111484,8,427,32,0,0,0,0,56,88
30550,10,66,4,0,0,0,0,4,8
11532,9,706,2,0,0,0,0,5,7
24702,7,149,4,0,0,0,0,6,10
133246,9,4,19,0,0,0,0,25,44
163449,9,657,54,0,0,0,0,77,131
74277,7,484,2,0,0,0,0,3,5
170128,9,838,35,0,0,0,0,53,88
133362,7,489,44,1,0,0,0,102,147
86952,4,200,2,0,0,0,0,3,5
162556,10,322,1,0,0,0,0,1,2
37431,11,658,29,0,0,0,0,30,59
65064,5,699,16,0,0,0,0,17,33
129484,9,838,9,0,0,0,0,14,23
155097,7,864,7,0,0,0,0,14,21
67494,7,909,43,7,3,0,1,64,118
114843,10,289,1,0,0,0,0,0,1
162208,9,4,2,0,0,0,0,2,4
104806,9,819,6,0,0,0,1,8,15
77739,9,380,3,0,0,0,0,6,9
55280,7,144,2,0,0,0,0,4,6
118158,9,640,482,18,12,0,4,720,1236
66976,7,56,1732,21,13,1,11,2876,4654
73653,7,611,4,0,0,0,0,10,14
73566,7,163,69,0,0,1,0,56,126
93824,9,838,2,0,0,0,0,0,2
6216,9,838,8,0,0,0,0,5,13
33733,6,601,39,1,1,0,0,60,101
158212,10,413,4,0,0,0,0,4,8
75281,5,200,36,0,0,0,0,53,89
130165,7,741,16,0,0,0,0,20,36
9771,7,744,4,0,0,0,0,9,13
84632,7,896,2,0,0,0,0,8,10
27152,7,56,37,1,1,0,1,36,76
85889,10,841,33,0,0,0,0,48,81
158750,6,729,8,0,0,0,0,6,14
85216,5,200,730,27,5,3,8,1168,1941
157911,10,917,18,0,0,0,1,59,78
81500,10,781,11,0,0,0,1,22,34
28949,10,413,1,0,0,0,0,2,3
126667,9,429,2,0,0,0,0,2,4
103420,9,42,6,0,0,0,0,9,15
93467,9,302,2,0,0,0,1,8,11
11158,9,640,1,0,0,0,0,1,2
100296,7,460,2,0,0,0,0,2,4
151089,9,632,1,0,0,0,0,4,5
102527,8,214,2158,33,17,2,15,3611,5836
11493,10,653,1,0,0,0,0,0,1
55568,4,375,5,0,0,0,0,11,16
82610,7,892,4,0,0,0,0,6,10
120493,4,679,15,0,0,0,0,22,37
164739,9,341,35,0,0,0,0,88,123
16972,9,538,14,1,1,0,0,10,26
170319,10,914,0,0,0,0,0,28,28
145693,6,78,12,0,0,0,0,18,30
128823,9,302,2,0,0,0,0,2,4
82708,10,917,1,0,0,0,0,2,3
97692,7,551,9,0,0,0,0,22,31
34579,9,497,7,0,0,0,0,10,17
135404,9,158,4,0,0,0,1,7,12
87095,5,78,33,0,0,0,0,47,80
143391,9,107,12,0,0,0,0,21,33
86240,7,263,4,0,0,0,0,3,7
115710,9,175,3,0,0,0,0,9,12
114627,9,483,2,0,0,0,0,2,4
76167,11,214,2,0,0,0,0,0,2
169884,9,487,2,0,0,0,0,3,5
71282,8,214,906,31,15,2,9,1594,2557
108278,11,214,23,0,0,0,0,27,50
123697,9,175,2,0,0,0,0,3,5
74524,9,538,22,4,0,0,0,46,72
144820,7,508,6,1,0,0,1,13,21
109564,9,538,26,0,0,0,0,29,55
10614,9,79,30,0,1,0,0,53,84
156982,9,418,21,0,1,0,0,39,61
66935,7,741,11,0,0,0,1,27,39
26119,11,214,8,0,0,0,0,12,20
8739,6,200,2,0,0,0,0,3,5
31554,9,374,3,0,0,0,0,3,6
77672,9,909,6,0,0,0,0,12,18
23663,9,909,3,0,0,0,0,4,7
4654,9,909,1,0,0,0,0,1,2
108299,9,375,2,0,0,0,0,4,6
22930,9,483,4,0,0,0,0,7,11
74610,7,484,12,0,0,0,0,14,26
5566,7,157,1,0,0,0,0,0,1
147951,9,489,16,0,0,0,0,26,42
67104,9,353,6,0,0,0,0,6,12
70525,11,800,151,12,0,0,0,186,349
120126,10,722,20,2,1,0,0,26,49
49850,9,489,21,0,0,0,0,20,41
110456,4,115,2,0,0,0,0,3,5
38633,7,74,6,0,0,0,0,10,16
28768,7,56,1,0,0,0,0,0,1
124007,9,42,15,0,0,0,0,11,26
89318,7,56,18,1,1,0,0,40,60
100435,7,74,7,0,0,0,0,12,19
53014,9,65,34,0,0,0,0,21,55
147436,6,514,27,0,0,0,0,50,77
124789,4,678,34,0,0,0,0,22,56
154713,7,56,13,0,0,0,1,27,41
35020,9,341,6,0,0,0,0,10,16
82121,9,341,12,0,0,0,0,16,28
93480,4,679,21,0,0,0,0,30,51
2101,6,78,521,18,3,0,8,1258,1808
38412,7,384,4,0,0,0,0,4,8
105805,9,315,8,0,0,0,0,17,25
33526,10,36,155,10,2,0,3,309,479
148950,7,648,2,0,0,0,0,2,4
16017,9,314,12,0,0,0,0,13,25
26773,9,8,6,0,0,0,0,11,17
71759,9,54,2,0,0,0,0,3,5
118569,7,387,218,6,0,35,0,318,577
99214,9,89,9,0,0,0,0,9,18
43554,9,452,6,0,0,0,0,7,13
104480,9,909,13,0,0,0,0,28,41
113599,9,909,4,0,0,0,0,16,20
7725,9,243,25,0,1,0,0,37,63
108010,9,909,42,1,3,0,2,88,136
138337,7,864,10,0,0,0,0,10,20
168283,7,864,4,0,0,0,0,8,12
63818,9,314,12,0,0,0,0,16,28
5113,9,379,12,1,0,0,0,24,37
12717,9,842,10,1,0,0,0,9,20
3469,9,532,2,0,0,0,0,3,5
104042,9,489,3,0,0,0,0,8,11
45164,9,589,10,0,0,0,0,10,20
21751,7,587,14,0,0,0,0,15,29
107284,7,391,2,0,0,0,0,3,5
131801,6,209,2,0,0,0,0,2,4
55420,9,545,15,0,0,0,0,31,46
37296,9,184,16,0,0,0,0,29,45
88041,7,741,12,5,1,0,1,28,47
37308,7,669,2,0,0,0,0,3,5
157571,6,785,11,0,0,0,0,22,33
4581,5,489,519,27,14,9,1,763,1333
122530,9,367,234,6,6,0,2,333,581
6890,9,640,1,0,0,0,0,0,1
53041,5,489,12,0,0,0,0,15,27
55251,10,653,84,6,0,0,1,208,299
121496,5,306,2862,42,17,8,25,4312,7266
94210,9,570,2,0,0,0,0,6,8
112240,7,157,6,0,0,0,0,0,6
27644,9,622,8,0,0,0,0,13,21
158179,7,896,9,0,0,0,0,12,21
45366,9,302,18,0,0,0,0,45,63
14141,10,334,6,0,0,0,0,5,11
136961,10,334,2,0,0,0,0,3,5
16586,10,334,6,0,0,0,0,5,11
20806,6,124,168,6,4,0,2,255,435
65137,9,78,1,0,0,0,0,0,1
71466,6,375,49,0,0,0,0,110,159
164327,9,145,24,2,0,0,1,72,99
52379,7,391,8,0,0,0,0,10,18
134699,9,8,4,0,0,0,0,4,8
109261,9,842,4,0,0,0,0,7,11
115698,9,873,2,0,0,0,0,3,5
83267,7,126,10,0,0,0,0,16,26
99255,9,570,9,0,0,0,0,15,24
161250,6,165,23,0,0,0,0,29,52
127905,7,741,8,0,0,0,0,12,20
138674,8,214,524,5,2,0,2,1066,1599
27003,9,452,36,0,0,0,1,43,80
66047,9,100,9,0,0,0,0,18,27
156185,9,487,8,0,0,0,0,17,25
133298,11,214,7,0,0,0,0,6,13
24132,10,917,0,0,0,0,1,17,18
55120,9,43,2,0,0,0,0,2,4
162967,9,909,2,0,0,0,0,3,5
158749,9,719,9,1,1,0,0,19,30
83411,7,660,7,0,0,0,0,11,18
103867,9,640,11,0,0,0,0,15,26
53296,7,521,8,0,0,0,0,13,21
157318,7,487,4,0,0,0,0,4,8
127524,7,100,33,2,1,0,0,68,104
66355,7,484,6,0,0,0,0,13,19
77152,9,630,87,0,0,0,0,141,228
114133,7,79,4,0,0,0,0,11,15
146549,7,79,0,0,0,0,0,7,7
111789,5,489,5,0,0,0,0,5,10
89656,5,489,4,0,0,0,0,7,11
23246,7,755,17,0,0,0,0,18,35
117497,9,367,2,0,0,0,0,3,5
116192,9,367,10,0,0,0,0,15,25
19739,9,452,6,2,1,0,0,11,20
33403,7,56,13,0,0,0,0,7,20
14933,8,545,20,0,0,0,0,32,52
16961,7,484,11,0,0,3,0,16,30
58560,9,842,2,0,0,0,0,0,2
114312,4,159,74,0,0,0,0,74,148
98707,10,66,0,0,0,0,0,4,4
55010,10,66,0,0,0,0,0,4,4
159228,9,570,6,0,0,0,0,8,14
48125,7,521,9,0,0,0,0,10,19
47579,4,890,29,0,0,0,0,37,66
129644,9,8,3,0,0,0,0,6,9
35449,7,535,10,0,0,0,1,29,40
166050,4,923,13,0,0,0,0,36,49
106427,9,489,19,0,0,0,0,33,52
76776,9,658,4,0,0,0,0,15,19
83915,10,917,0,0,0,0,0,20,20
31636,9,741,32,0,0,0,0,61,93
24699,9,719,2,0,0,0,0,4,6
35859,5,181,2,0,0,0,0,2,4
153427,7,741,4,0,0,0,0,4,8
142704,9,302,10,0,1,0,0,10,21
123231,6,570,2,0,0,0,0,3,5
12748,10,781,4,0,0,0,0,5,9
12456,5,159,30,0,0,0,0,50,80
17572,5,159,23,0,0,0,0,41,64
65851,5,159,7,0,0,0,0,8,15
7061,9,630,0,0,0,0,0,14,14
140415,10,917,11,0,0,0,0,23,34
132182,6,103,10,2,1,0,0,18,31
102296,4,679,33,1,1,0,0,70,105
145003,11,124,1,0,0,0,0,1,2
112064,9,469,3,0,0,0,0,5,8
97032,9,399,6,0,0,0,0,8,14
118387,6,585,18,0,0,0,0,29,47
94143,6,585,16,0,0,0,0,25,41
155757,4,679,65,2,1,0,0,108,176
76825,8,306,2,0,0,0,0,1,3
105553,5,479,3,0,0,0,0,0,3
152554,10,820,0,2,0,0,0,0,2
105441,9,796,8,1,0,0,0,3,12
102045,9,202,4,1,1,0,0,8,14
20312,9,353,4,0,0,0,0,11,15
9502,9,367,14,1,1,0,0,25,41
56982,11,489,4,0,0,0,0,3,7
74600,5,200,1,0,0,0,0,2,3
74580,9,367,12,1,1,0,0,53,67
18347,8,403,4,0,0,0,0,0,4
152224,4,159,2,0,0,0,0,0,2
151150,9,65,2,0,0,0,0,2,4
161492,4,159,1,0,0,0,0,0,1
75412,8,489,53,0,0,0,1,73,127
48865,9,367,35,1,0,0,0,85,121
90416,9,367,93,2,0,0,1,162,258
17241,9,622,4,0,0,0,0,7,11
169361,6,785,36,1,0,0,0,61,98
129837,11,214,2,0,0,0,0,2,4
127847,9,492,2,0,0,0,0,2,4
31618,9,302,1,0,0,0,0,0,1
50946,8,214,147,1,1,0,1,275,425
101674,7,384,1,0,0,0,0,2,3
61449,6,269,23,0,0,0,1,55,79
122730,7,492,2,0,0,0,0,4,6
124730,7,228,15,0,0,0,0,25,40
161800,4,800,1,0,0,0,0,1,2
53887,9,374,10,0,0,0,0,19,29
127950,9,510,20,0,1,0,0,33,54
164622,8,801,88,3,1,0,0,140,232
105729,9,314,13,0,0,0,1,24,38
113021,9,100,5,0,0,0,0,11,16
149806,5,821,5,0,0,0,0,10,15
46550,7,74,11,0,0,0,0,15,26
102809,4,581,12,0,0,0,0,27,39
52746,9,243,3,0,0,0,0,13,16
113300,9,630,102,2,0,1,0,149,254
171033,11,214,2,0,0,0,0,2,4
114158,10,36,2,0,0,0,0,6,8
14060,9,427,4,0,0,0,0,6,10
17392,7,312,4,0,0,0,0,3,7
159890,10,355,2,0,0,0,0,3,5
12143,10,743,12,0,0,0,0,14,26
21834,9,489,4,0,0,0,0,10,14
37385,10,743,16,0,0,0,0,19,35
104167,10,743,0,0,0,0,0,7,7
20222,10,881,11,0,0,0,0,19,30
21885,8,214,7,3,0,0,0,7,17
169900,4,36,4,0,0,0,0,6,10
107473,7,56,5,0,0,0,0,10,15
95551,6,78,141,3,0,0,0,200,344
44572,7,56,1,0,0,0,0,1,2
82825,7,211,3,0,0,0,0,8,11
83588,9,184,6,0,1,0,0,12,19
74033,9,184,0,0,1,0,0,0,1
49165,9,469,6,0,0,0,0,6,12
33452,9,469,6,0,0,0,0,7,13
97502,8,214,633,11,1,0,0,1127,1772
111327,9,545,2,0,0,0,0,3,5
107088,8,214,270,0,0,0,1,391,662
163949,8,214,1426,49,16,3,15,2295,3804
28402,9,353,4,0,0,0,0,4,8
142717,9,78,257,0,0,0,2,424,683
60498,4,908,1,0,0,0,0,1,2
68661,7,79,2,0,0,0,0,2,4
109912,8,214,2002,7,3,0,5,3173,5190
147373,10,104,20,1,1,0,0,39,61
57381,9,457,7,0,0,0,0,8,15
61876,9,800,3,0,0,0,0,5,8
157038,10,289,2,0,0,0,0,2,4
106171,4,215,7,0,0,0,0,9,16
70191,7,448,14,2,1,0,0,48,65
135069,9,367,8,0,0,0,0,17,25
91786,9,65,12,0,0,0,0,12,24
129843,8,214,1930,24,11,0,6,3307,5278
36017,7,521,6,0,0,0,0,8,14
102123,9,302,18,0,0,0,0,35,53
32906,6,117,2,0,0,0,0,3,5
17797,9,95,12,0,0,0,0,28,40
150187,9,95,10,0,0,0,0,18,28
28412,7,263,18,4,0,0,0,31,53
49890,9,469,2,0,0,0,0,2,4
55968,9,353,4,0,0,0,0,7,11
133730,8,623,785,20,12,2,11,1344,2174
54122,8,214,68,0,0,0,0,114,182
48186,8,623,2,0,0,0,0,4,6
142411,7,521,20,0,0,0,0,47,67
115281,9,353,5,0,0,0,0,5,10
68594,5,124,14,0,0,0,0,24,38
17918,6,51,27,0,0,0,0,47,74
113105,4,174,3,0,0,0,0,2,5
76272,5,200,11,0,0,0,0,17,28
125682,9,452,10,0,0,0,0,12,22
26709,8,214,148,1,0,0,0,242,391
151674,9,706,24,1,1,0,0,51,77
7787,10,831,2,0,0,0,0,12,14
81599,11,306,2,0,0,0,0,2,4
12974,4,658,6383,211,69,27,39,12554,19283
168258,5,783,12,0,0,0,0,21,33
1890,8,214,135,1,1,0,1,216,354
30702,6,301,23,2,0,0,0,41,66
110960,9,77,121,3,2,0,0,194,320
150266,5,200,5,0,0,0,0,6,11
127835,9,6,2,0,0,0,0,4,6
29158,8,214,96,0,0,0,1,197,294
13490,7,611,2,0,0,0,0,2,4
71989,7,611,6,0,0,0,0,11,17
132634,7,611,2,0,0,0,0,2,4
30755,10,322,2,0,0,0,0,6,8
112230,10,66,10,0,0,0,0,15,25
26490,7,74,6,0,0,0,0,14,20
167530,8,214,22,0,0,0,0,38,60
120157,9,560,12,0,0,0,0,22,34
41303,5,225,3,0,0,0,0,1,4
129724,9,8,14,2,2,0,0,22,40
82640,9,8,9,0,0,0,0,16,25
12215,9,622,2,0,0,0,0,3,5
63551,8,214,1087,24,6,1,3,1794,2915
60330,8,214,807,18,5,2,5,1389,2226
43256,6,301,78,2,1,0,0,146,227
161407,9,607,2,0,0,0,0,3,5
70387,9,367,21,0,0,0,0,34,55
47562,9,117,13,0,0,0,0,16,29
51240,9,367,7,0,0,0,0,11,18
62145,7,487,4,0,0,0,0,9,13
116890,6,269,81,0,0,0,0,141,222
82144,10,917,1,0,0,0,0,3,4
166692,10,831,1,0,0,0,0,2,3
48525,10,917,1,0,0,0,0,1,2
58066,10,413,1,0,0,0,0,2,3
16220,5,78,14,0,0,0,0,19,33
25465,8,214,466,5,4,1,2,775,1253
124264,9,367,32,1,1,0,0,57,91
125918,9,367,10,0,0,0,0,20,30
135348,7,254,2,0,0,0,0,2,4
35819,10,549,10,0,0,0,0,24,34
146478,10,208,3,0,0,0,0,8,11
86294,10,208,2,0,0,0,0,4,6
128339,10,208,2,0,0,0,0,4,6
30926,4,885,1,1,0,0,0,1,3
95013,4,752,1,0,0,0,0,0,1
165296,9,202,5,0,0,0,0,6,11
91289,8,214,146,3,1,0,1,319,470
93571,5,78,31,0,0,0,0,33,64
56323,8,885,15,1,0,0,0,24,40
153607,8,214,270,15,3,0,3,484,775
148992,7,521,13,0,0,0,0,18,31
72642,7,521,46,0,0,0,0,68,114
73796,10,781,1,0,0,0,0,1,2
12683,9,360,2,0,0,0,0,3,5
83667,10,208,11,0,0,0,0,19,30
128736,7,404,16,6,0,0,0,31,53
112703,7,587,13,0,0,0,0,22,35
96695,4,36,34,0,0,0,0,69,103
36672,10,81,9,0,0,0,0,31,40
98647,9,203,24,1,1,0,0,38,64
90280,10,81,6,0,0,0,0,7,13
144689,8,545,1,0,0,0,0,0,1
8416,9,630,68,0,0,0,0,90,158
94036,10,868,1,0,0,0,0,3,4
155918,10,81,1,0,0,0,0,3,4
166682,9,157,2,0,0,0,0,2,4
33286,5,306,8477,146,50,7,50,13629,22359
102361,7,379,24,1,1,0,0,43,69
132873,10,722,4,0,0,0,0,6,10
25497,10,549,5,0,0,0,0,10,15
72874,8,30,12,0,0,0,0,17,29
18030,7,575,5,0,0,0,0,15,20
37934,7,306,1160,47,18,1,6,2172,3404
115309,11,545,4,0,0,0,0,4,8
79075,4,159,2,1,0,0,0,3,6
19879,10,917,60,0,0,0,1,81,142
101573,9,353,4,0,0,0,0,6,10
122650,9,456,15,0,0,0,0,38,53
155482,10,917,7,0,0,0,0,21,28
12171,10,917,9,0,0,0,0,20,29
35498,9,313,5,0,0,0,0,25,30
132252,9,800,50,2,1,0,1,117,171
11296,9,78,232,0,0,0,0,343,575
46425,9,313,2,0,0,0,0,4,6
8389,4,220,4,0,0,0,0,20,24
158808,9,314,22,1,1,0,0,37,61
7649,9,489,5,0,0,0,0,7,12
150291,8,214,0,0,0,0,0,3,3
61334,11,545,24,0,0,0,0,28,52
40677,9,657,5,0,0,0,0,7,12
42016,5,78,57,1,0,0,0,101,159
73342,7,669,4,0,0,0,0,5,9
49301,5,78,2,0,0,0,0,0,2
124203,9,313,57,1,0,0,0,72,130
135305,9,313,136,2,0,1,1,266,406
19949,8,214,8,0,0,0,0,13,21
74083,9,315,6,0,0,0,0,10,16
134032,9,315,18,1,0,1,0,28,48
44608,9,315,10,0,0,0,0,12,22
69081,9,315,2,0,0,0,0,3,5
141079,10,743,3,0,0,0,0,6,9
23178,10,87,4,0,0,0,0,6,10
151930,10,87,5,1,0,0,0,13,19
131061,5,200,14,1,0,0,0,14,29
76372,10,87,1,0,0,0,0,3,4
56451,10,87,2,0,0,0,0,2,4
84602,10,743,4,0,0,0,0,7,11
106411,10,743,1,0,0,0,0,0,1
84288,8,545,457,27,12,0,4,798,1298
20771,10,743,7,0,0,0,0,9,16
56256,10,743,1,0,0,0,0,0,1
135785,9,762,5,0,0,0,0,8,13
23142,6,78,86,1,1,0,0,162,250
117186,9,405,6,0,0,0,0,13,19
130344,9,909,6,0,0,0,0,23,29
154072,9,353,6,0,0,0,0,9,15
84105,9,353,10,1,1,0,0,4,16
85108,8,214,5,0,0,0,0,5,10
10539,9,306,24,0,0,0,0,46,70
104836,9,575,76,4,4,0,2,183,269
143049,9,314,12,1,1,0,0,18,32
168729,9,632,2,0,0,0,0,2,4
7541,9,380,2,0,0,0,0,3,5
21654,10,525,8,0,0,0,0,24,32
116534,9,380,1,0,0,0,0,1,2
107946,9,380,3,0,0,0,0,5,8
96428,9,175,8,2,0,0,0,11,21
95597,9,658,2,0,0,0,0,2,4
136997,9,46,2,0,0,0,0,3,5
123720,9,46,4,0,0,0,0,5,9
123989,10,798,0,0,0,0,0,4,4
52636,9,575,4,0,0,0,0,10,14
100792,9,719,6,0,0,0,0,9,15
47481,9,589,4,0,0,0,0,6,10
86206,10,701,14,0,0,0,0,28,42
51777,10,289,9,0,0,0,0,15,24
76796,10,104,15,0,0,0,0,18,33
89641,9,545,14,0,0,0,0,25,39
31279,10,63,2,0,0,0,0,3,5
72107,6,514,4,0,0,0,0,3,7
64280,6,514,4,0,0,0,0,3,7
18722,4,679,14,0,1,0,0,51,66
13653,7,77,44,0,0,0,0,49,93
30261,7,508,7,0,0,0,0,7,14
112303,7,207,8,0,0,0,0,13,21
169247,9,469,10,0,0,0,0,7,17
72436,7,77,12,0,0,0,0,20,32
108981,7,508,9,0,0,0,0,57,66
36724,7,748,13,0,0,0,0,22,35
22875,9,575,5,0,0,0,0,12,17
2472,9,452,6,0,0,0,0,12,18
145991,9,452,10,0,0,0,0,11,21
140371,10,653,9,0,0,0,0,28,37
92615,9,341,35,0,0,0,0,40,75
29325,5,200,52,0,0,0,0,87,139
149048,11,812,5,0,0,0,0,4,9
144521,9,341,14,0,0,0,0,28,42
125397,9,684,2,0,0,0,0,2,4
111896,6,800,10,1,0,0,0,15,26
53758,7,226,4,0,0,0,0,4,8
106704,8,214,758,27,7,0,1,1330,2123
55291,9,469,42,1,1,0,0,63,107
168924,9,489,15,0,0,0,0,18,33
116831,9,147,6,0,0,0,0,8,14
44648,11,214,6,0,0,0,0,8,14
35127,8,214,9,0,0,0,0,15,24
73150,7,492,18,1,0,0,0,30,49
52088,7,492,6,0,0,0,0,8,14
6985,9,535,10,0,0,0,0,18,28
143369,9,65,3,0,0,0,0,6,9
85903,9,65,2,0,0,0,0,2,4
25735,9,302,2,0,0,0,0,3,5
64192,10,752,62,1,3,0,0,116,182
64257,9,65,2,0,0,0,0,7,9
113544,7,611,2,0,0,0,0,4,6
51416,9,874,4,0,0,0,0,6,10
46007,9,314,5,0,0,0,0,9,14
167069,9,497,2,0,0,0,0,3,5
129685,10,322,19,0,0,0,0,21,40
31106,4,679,6,0,0,0,0,17,23
59843,9,764,2,0,0,0,0,4,6
57079,9,379,2,0,1,0,0,4,7
40741,7,379,12,1,0,0,0,20,33
127857,7,669,8,0,0,0,0,19,27
22464,7,669,2,0,0,0,0,3,5
101673,7,669,10,0,0,0,0,14,24
69758,4,159,130,4,1,0,0,233,368
33566,7,551,1,0,0,0,0,7,8
59481,7,521,15,0,0,0,0,24,39
46789,7,126,3,0,0,0,0,4,7
79102,8,214,555,17,4,0,5,1024,1605
81076,5,106,6,0,0,0,0,5,11
45432,9,30,6,0,0,0,0,8,14
67197,11,214,1,0,0,0,0,0,1
127809,8,658,3,0,0,0,0,6,9
148844,4,885,2,0,0,0,0,11,13
129100,6,885,27,0,0,0,0,37,64
114923,9,640,6,0,0,0,0,5,11
114762,10,111,5,0,0,0,0,9,14
38421,6,174,2,0,0,0,0,0,2
152542,7,157,3,0,0,0,0,4,7
99796,10,322,1,0,0,0,0,1,2
167856,5,800,1,0,0,0,0,2,3
57255,4,519,23,0,0,0,0,50,73
97151,9,607,108,1,0,1,0,17,127
103861,10,66,8,0,0,0,0,13,21
86220,4,231,16314,565,247,27,85,31951,49189
20035,9,489,1,0,0,0,0,0,1
634,8,403,5,0,0,0,0,2,7
123162,8,214,504,26,10,3,6,1022,1571
20153,5,106,5,0,0,0,0,14,19
65850,8,214,8,0,0,0,0,15,23
113393,9,367,29,0,0,0,0,29,58
54557,11,427,43,1,0,0,0,40,84
150563,9,313,5,0,0,0,0,8,13
143036,6,78,67,1,0,0,0,118,186
140464,4,658,71,3,0,0,0,118,192
123636,9,306,1,1,0,0,0,0,2
125022,9,341,4,0,1,0,0,8,13
125545,9,341,6,1,0,0,0,12,19
156336,4,658,27,0,0,0,0,42,69
111668,8,403,2,0,0,0,0,0,2
169228,8,812,130,3,1,0,1,177,312
35487,7,353,2,0,0,0,0,6,8
82807,8,693,1,0,0,0,0,0,1
125877,10,413,3,0,0,0,0,3,6
132741,8,214,406,5,4,0,3,751,1169
57915,9,452,6,0,0,0,0,10,16
76354,9,575,10,0,0,0,0,26,36
130397,10,917,0,0,0,0,0,1,1
41172,9,42,2,0,0,0,0,3,5
149983,9,42,4,2,0,1,0,9,16
43372,10,628,8,0,0,0,0,7,15
161655,9,42,3,0,0,0,0,5,8
74303,7,556,1,0,0,0,0,4,5
16321,8,545,9,1,0,0,0,14,24
38310,10,831,2,0,0,0,0,2,4
89946,8,30,1,0,0,0,0,1,2
130144,10,29,38,1,0,0,0,53,92
49356,10,413,3,0,0,0,0,11,14
118730,10,917,0,0,0,1,0,116,117
15565,5,218,11,0,0,0,1,25,37
64960,4,519,2,0,0,0,0,9,11
64916,4,890,6,0,0,0,0,10,16
27213,5,78,138,3,1,0,0,227,369
5053,4,220,201,6,3,0,0,378,588
31829,7,492,2,0,0,0,0,3,5
38550,9,184,3,0,0,0,0,5,8
116216,7,126,36,0,0,0,0,33,69
11764,8,214,2,0,0,0,0,6,8
46155,9,489,1,0,0,0,0,2,3
80811,9,405,6,0,0,0,0,7,13
149127,4,658,33,0,0,0,0,46,79
72743,9,405,5,0,0,0,0,10,15
80834,7,912,0,0,0,0,0,10,10
84597,7,367,14,0,0,0,0,18,32
92522,8,214,3,0,0,0,0,4,7
53481,8,214,41,0,0,0,0,59,100
6420,8,30,2,0,0,0,0,5,7
148983,7,484,0,0,0,0,0,5,5
116065,7,521,1,0,0,0,0,1,2
170656,8,214,1,0,0,0,0,1,2
36976,4,678,8411,223,89,11,35,15786,24555
18136,10,322,7,0,0,0,0,13,20
53582,8,214,70,0,0,0,1,81,152
98099,4,678,6989,197,75,23,39,14232,21555
169445,10,653,124,2,1,0,2,290,419
38288,6,729,13,0,1,0,0,22,36
76728,10,413,0,0,1,0,0,0,1
168355,9,325,6,0,0,0,0,9,15
140889,4,752,2,0,0,0,0,1,3
129474,5,479,76,0,0,0,0,136,212
109899,7,508,108,4,2,0,0,184,298
145326,9,452,12,2,1,0,0,16,31
69730,9,145,2,0,0,0,0,3,5
72008,7,492,1,0,0,0,0,1,2
162317,11,214,3,0,0,0,0,1,4
105626,4,174,497,7,5,0,1,947,1457
74078,11,214,4,0,0,0,0,4,8
141667,4,908,2,0,0,0,0,2,4
44393,5,159,1,0,0,0,0,7,8
156069,4,453,3,0,0,0,0,3,6
167528,5,159,2,0,0,0,0,4,6
7405,4,174,1,0,0,0,0,0,1
20592,9,800,8,0,0,0,0,20,28
166186,8,214,11,0,0,0,0,11,22
154314,7,211,8,1,0,1,0,18,28
165557,9,100,5,0,0,0,0,3,8
55578,6,693,9,0,0,0,0,11,20
169008,6,693,10,0,0,0,0,10,20
152599,9,157,1,0,0,0,0,0,1
166323,4,159,3,0,0,0,0,5,8
150334,6,693,2,0,0,0,0,1,3
128924,10,807,8,0,0,0,0,79,87
170270,4,519,43,1,0,0,0,77,121
81488,7,748,7,0,0,0,0,14,21
113710,6,103,2,0,0,0,0,3,5
73757,5,408,47,1,1,0,1,106,156
114887,8,214,8,0,0,0,0,13,21
45519,8,812,5,0,0,0,0,8,13
170817,8,214,4,0,0,0,0,7,11
18210,9,487,3,0,0,0,0,8,11
149096,9,117,5,0,0,0,0,3,8
168456,10,519,0,0,0,0,0,63,63
155052,9,575,25,1,1,0,0,23,50
94649,8,658,5,0,0,0,0,5,10
132514,9,314,2,0,0,0,0,2,4
14597,9,302,162,0,0,0,1,543,706
49640,9,89,8,0,0,0,0,21,29
25599,6,585,2,0,0,0,0,3,5
108408,4,658,35,1,1,0,0,50,87
126698,4,800,3,0,0,0,0,5,8
125362,9,353,10,0,0,0,0,18,28
104631,9,630,159,9,0,0,0,180,348
9230,9,65,7,0,0,0,0,7,14
114495,6,922,14,0,0,0,0,21,35
15028,4,658,39,0,0,0,0,71,110
107715,4,36,111,0,0,0,0,206,317
2412,6,78,4,0,0,0,0,9,13
148696,9,302,2,0,0,0,0,0,2
69262,4,230,21065,459,203,50,85,40269,62131
79718,9,483,2,0,0,0,0,4,6
46010,11,214,16,0,0,0,0,10,26
151977,4,174,601,21,8,3,4,903,1540
89077,4,174,428,10,3,1,2,673,1117
1194,5,218,1,0,0,0,0,0,1
88428,10,289,6,0,0,0,0,6,12
128240,4,800,2,0,0,0,0,4,6
21721,9,489,10,0,0,0,0,15,25
169624,7,611,2,0,0,0,0,3,5
126163,7,508,2,0,0,0,0,6,8
56157,5,78,14,0,0,0,0,20,34
49369,10,111,4,0,0,0,0,3,7
56928,8,214,36,1,1,0,0,60,98
118412,4,174,217,5,2,1,1,474,700
164286,8,214,7,0,0,0,0,10,17
129802,9,885,15,0,0,0,0,15,30
113686,9,874,8,0,0,0,0,15,23
21520,9,457,2,0,0,0,0,3,5
128392,9,471,14,0,0,0,0,26,40
69644,9,909,4,0,0,0,0,2,6
94894,4,519,27,0,0,0,0,34,61
46400,9,78,2,0,0,0,0,0,2
4441,8,623,26,0,0,0,0,53,79
129645,7,263,2,0,0,0,0,2,4
34142,7,263,1,0,0,0,0,1,2
10447,7,263,3,0,0,0,0,3,6
50775,9,6,1,0,0,0,0,1,2
9284,5,200,119,2,0,0,0,289,410
31246,5,200,315,13,4,1,3,626,962
30981,8,545,6,0,0,0,0,10,16
135658,6,728,1,0,0,0,0,0,1
152476,7,755,21,0,0,0,0,35,56
50682,5,821,58,3,1,0,0,96,158
108955,9,589,31,0,1,0,0,37,69
80625,5,78,10,0,0,0,0,14,24
104327,7,77,60,0,0,0,0,81,141
61709,9,885,31,0,0,0,0,52,83
166981,7,157,5,0,1,0,0,9,15
6154,7,641,5,0,0,0,0,9,14
165312,11,545,1,0,0,0,0,1,2
137796,4,375,6,3,0,0,0,8,17
47235,6,124,18,0,0,0,0,11,29
9040,6,124,10,2,1,0,0,17,30
77017,7,489,25,1,1,0,0,50,77
2484,9,622,2,0,0,0,0,2,4
47240,9,622,2,0,0,0,0,2,4
32874,9,622,23,0,0,0,0,39,62
104901,9,622,2,0,0,0,0,0,2
86325,7,741,14,0,0,0,0,23,37
38897,9,469,4,0,0,0,0,5,9
135905,4,780,294,0,0,0,1,501,796
97810,8,812,32,1,1,0,1,25,60
47709,10,841,32,0,0,0,0,46,78
149867,9,374,2,0,0,0,0,5,7
10698,9,469,10,0,0,0,0,16,26
111952,9,145,2,0,0,0,0,12,14
81617,7,634,4,0,0,0,0,4,8
18717,9,145,0,0,0,0,0,3,3
8770,10,555,2,0,0,0,0,3,5
77259,4,200,11,0,0,0,0,24,35
9378,9,78,40,0,0,0,0,53,93
100725,6,821,14,2,0,0,1,10,27
52508,9,353,2,0,0,0,0,6,8
42513,6,505,15,0,0,0,0,27,42
104565,9,353,1,0,0,0,0,4,5
54432,7,312,2,0,0,0,0,0,2
119616,7,312,1,0,0,0,0,0,1
130250,9,353,2,1,0,0,0,9,12
144965,9,657,8,0,0,0,0,9,17
103328,9,657,47,1,1,0,0,116,165
126776,4,174,587,26,10,0,3,1070,1696
155892,9,632,2,0,0,0,0,3,5
1031,6,585,21,0,0,0,1,30,52
69836,9,353,1,0,0,0,0,2,3
156606,9,497,3,0,0,0,0,3,6
168117,4,36,42,0,0,0,0,65,107
86938,9,353,6,0,0,0,0,11,17
54135,9,302,3,0,0,0,0,1,4
112390,10,111,87,0,0,0,0,119,206
19603,7,77,2,0,0,0,0,2,4
16325,7,77,5,0,0,0,0,9,14
5670,7,61,14,0,0,0,1,18,33
128568,9,570,11,0,0,0,0,18,29
165543,9,456,2,0,0,0,0,3,5
43278,5,78,66,1,0,0,0,102,169
13075,9,456,4,0,0,0,0,7,11
90546,5,655,215,3,2,0,1,376,597
17658,9,469,106,5,1,0,2,216,330
118055,9,842,3950,51,32,3,14,4701,8751
15607,9,497,4,0,0,0,0,8,12
40964,4,230,8870,177,100,15,43,17187,26392
36504,4,691,17255,266,87,26,83,29736,47453
103430,5,78,9,0,0,0,0,15,24
108502,8,214,2,0,0,0,0,4,6
134390,10,658,0,0,0,0,1,590,591
159496,11,244,4,1,0,0,0,7,12
170313,7,648,2,0,0,0,0,2,4
1823,7,126,17,1,0,0,0,16,34
14081,9,828,13,0,0,0,0,38,51
120332,10,66,6,0,0,0,0,6,12
136326,10,66,6,0,0,0,0,9,15
36037,7,660,14,2,0,0,0,27,43
48188,10,917,6,0,0,0,0,19,25
86105,9,693,72,1,1,0,0,132,206
113808,10,797,2,0,0,0,0,3,5
157144,9,302,19,0,0,0,1,19,39
64667,9,145,4,0,0,0,0,4,8
24670,9,100,8,0,0,0,0,18,26
142310,9,243,4,0,0,0,0,7,11
9102,7,762,1,0,0,0,0,5,6
109817,9,380,5,0,0,0,0,6,11
66611,7,312,4,0,0,0,0,10,14
158333,10,917,6,0,0,0,0,7,13
140730,6,537,12,0,0,0,0,18,30
107713,6,232,6,0,0,0,0,8,14
6738,9,107,11,1,1,0,0,18,31
100628,9,828,4,0,0,0,0,6,10
67921,9,693,6,0,0,0,0,13,19
127841,5,479,1108,45,22,3,9,1862,3049
39981,11,306,11,0,0,0,0,9,20
148053,8,214,4,0,0,0,0,7,11
167206,11,306,28,0,0,0,0,22,50
31977,10,903,11,0,1,0,0,57,69
16416,10,628,44,1,0,0,0,115,160
153158,9,457,3,0,0,0,0,4,7
164064,9,658,2,0,0,0,0,0,2
10678,9,6,2,0,0,0,0,0,2
43588,9,6,1,0,0,0,1,0,2
23272,9,640,5,0,0,0,0,4,9
2612,11,214,17,2,0,0,0,19,38
51949,7,578,29,1,1,0,0,39,70
66859,7,306,141,1,1,0,0,278,421
136251,10,722,1,0,0,0,0,4,5
111859,10,722,1,0,0,0,0,0,1
51016,10,722,1,0,0,0,0,3,4
52707,9,640,128,0,0,0,1,132,261
61834,10,722,1,0,0,0,0,0,1
46933,6,124,15,0,0,0,0,37,52
163414,9,575,10,0,0,0,1,25,36
128073,4,658,28,0,0,0,0,30,58
79517,8,214,692,2,0,0,1,1287,1982
36590,8,306,4,0,0,0,0,29,33
80508,5,200,73,3,2,0,0,102,180
44666,9,657,236,9,2,1,1,410,659
142544,7,660,3,0,0,0,0,3,6
47244,7,295,5,0,0,0,0,9,14
75862,9,589,78,2,1,0,0,128,209
67604,8,489,5,0,0,0,0,8,13
109509,8,489,1,0,0,0,0,1,2
120460,10,217,10,0,0,0,0,16,26
131792,10,653,1,0,0,0,0,0,1
104198,4,885,11,0,0,0,0,20,31
112407,4,800,2,0,0,0,0,4,6
159060,5,200,12,0,0,0,0,27,39
77936,10,793,3,0,0,0,0,9,12
103101,4,752,8,0,0,0,0,10,18
10693,11,214,5,1,0,0,0,5,11
75145,8,214,1535,1,0,0,3,2168,3707
20329,4,885,5,0,0,0,0,0,5
119598,4,885,5,0,0,0,0,11,16
69633,9,243,1,0,0,0,0,1,2
32228,4,200,6,0,0,0,0,35,41
31712,9,100,1,0,0,0,0,1,2
111656,8,489,1,0,0,0,0,0,1
60382,9,379,127,2,1,0,1,209,340
96362,4,679,224,6,4,1,0,402,637
165374,7,310,10,0,0,0,0,4,14
112737,6,78,6,0,0,0,0,7,13
158917,6,885,1107,24,10,1,10,1716,2868
155964,8,885,215,3,1,0,0,341,560
154412,11,427,7,0,0,0,0,8,15
145887,8,214,0,0,0,0,0,10,10
159982,8,214,26,0,0,0,0,76,102
59959,8,214,21,0,0,0,0,63,84
16067,8,214,0,0,0,0,0,40,40
22848,8,214,129,0,0,0,0,213,342
35252,7,100,2,0,0,0,0,4,6
77960,7,100,2,0,0,0,0,3,5
100344,8,214,0,0,0,0,0,10,10
89226,11,623,6,0,0,0,0,6,12
143956,6,514,37,1,0,0,0,82,120
134804,10,820,3,0,0,0,0,5,8
66592,8,214,125,1,0,0,0,264,390
36627,8,214,74,0,0,0,1,170,245
26002,11,214,2,0,0,0,0,1,3
53718,6,479,28,1,0,0,0,46,75
68597,7,374,2,0,0,0,0,2,4
2909,8,214,716,1,1,0,2,1236,1956
24874,9,8,13,0,0,0,0,19,32
37698,4,300,2,0,0,0,0,2,4
30282,7,587,307,4,2,0,2,483,798
74141,8,658,3056,138,55,11,26,5654,8940
98726,9,538,11,0,0,0,0,31,42
131988,9,842,2,0,0,0,0,3,5
123618,7,216,7003,151,56,18,28,14041,21297
100744,8,214,494,6,0,0,2,790,1292
148814,11,545,4,0,0,0,0,4,8
29389,9,597,1,0,0,0,0,3,4
114789,9,657,6,0,0,0,0,9,15
55882,5,821,2,0,0,0,0,3,5
103401,6,306,1,0,0,0,0,2,3
57447,4,519,177,0,0,0,0,343,520
24366,8,214,10,0,0,0,0,19,29
166075,10,917,4,2,1,0,0,8,15
30190,9,158,2,0,0,0,0,2,4
55400,9,158,42,1,2,0,0,78,123
143644,9,909,6,1,0,1,0,13,21
156960,7,611,3,0,0,0,0,5,8
953,7,611,16,0,0,0,0,21,37
13205,7,872,9,0,0,0,0,15,24
81631,6,103,6,0,0,0,0,9,15
163150,7,626,2,0,0,0,0,0,2
154227,7,216,4059,101,37,9,13,8195,12414
34695,7,216,1673,43,15,4,9,3827,5571
48596,7,216,1359,39,17,6,4,2724,4149
73604,7,484,18,0,0,0,0,28,46
120937,8,214,3,0,0,0,0,1,4
97929,11,214,3,0,0,0,0,2,5
162839,5,124,454,12,4,0,4,730,1204
144956,5,124,113,1,0,0,1,155,270
63664,4,453,1,0,0,0,0,3,4
99596,5,200,49,0,0,0,0,59,108
72537,7,741,29,3,2,0,0,65,99
79241,7,611,2,0,0,0,0,6,8
137876,7,611,4,0,0,0,0,4,8
17280,7,611,1,0,0,0,0,1,2
100981,6,200,18,0,0,0,0,24,42
53162,7,611,1,0,0,0,0,1,2
70602,7,611,2,0,0,0,0,4,6
169319,7,611,1,0,0,0,0,1,2
63814,11,30,133,33,0,0,0,160,326
7895,8,403,171,11,2,0,3,348,535
169671,8,214,0,0,0,0,0,11,11
168834,8,214,0,0,0,0,0,18,18
22049,9,489,95,2,1,0,1,152,251
89068,8,403,216,16,2,0,2,391,627
47195,4,752,125,4,4,0,1,249,383
89793,8,812,15,0,0,0,0,30,45
140686,8,489,341,3,2,0,3,560,909
112995,7,489,163,0,0,0,1,265,429
41877,7,353,2,0,0,0,0,2,4
100237,7,353,11,1,1,0,1,20,34
98524,7,263,37,0,0,0,0,62,99
115861,5,71,2,0,0,0,0,4,6
65872,8,885,4,0,0,0,0,4,8
32983,6,514,10,0,0,0,0,15,25
155463,4,458,419,5,1,0,2,732,1159
5279,4,199,3,0,0,0,0,4,7
116713,8,30,3,0,0,0,0,3,6
120204,4,174,4,0,0,0,0,10,14
110936,11,214,19,0,0,0,0,13,32
18252,8,693,1,0,0,0,0,0,1
42052,4,36,53,1,0,0,0,69,123
144327,8,214,1,0,0,0,0,0,1
61938,10,917,2,0,0,0,0,2,4
120067,10,917,4,0,0,0,0,4,8
88657,11,214,1,0,0,0,0,0,1
13491,5,561,4,0,0,0,0,5,9
53463,8,214,571,0,0,0,2,1011,1584
13196,10,81,2,0,0,0,0,3,5
156671,4,885,166,2,2,0,0,271,441
136116,9,575,2,0,0,0,0,3,5
95676,10,81,2,0,0,0,0,3,5
96447,8,214,210,0,0,0,0,317,527
84523,7,157,58,0,0,0,0,96,154
136410,8,214,142,0,0,0,0,244,386
69969,9,245,12,0,0,0,0,9,21
40543,9,79,1,0,0,0,0,1,2
121276,9,909,4,0,0,0,0,9,13
44346,7,669,6,0,0,0,0,6,12
151303,9,597,29,3,2,0,0,72,106
125843,9,487,32,2,0,1,0,50,85
48884,4,678,4,0,0,0,0,5,9
147162,9,632,2,0,0,0,0,2,4
44294,9,65,11,0,0,0,0,14,25
144384,9,842,12,1,0,0,0,17,30
142876,9,184,12,0,0,0,0,20,32
136750,10,653,29,0,0,0,0,45,74
142399,9,570,6,0,0,0,0,7,13
75683,7,126,64,1,0,0,0,153,218
59190,10,66,3,0,0,0,0,4,7
19989,7,126,9,0,0,0,0,13,22
45630,9,838,4,0,0,0,0,6,10
144534,7,489,296,0,0,0,1,402,699
139525,11,812,5,0,0,0,0,4,9
140276,7,79,4,0,0,0,0,3,7
10176,9,838,4,0,0,0,0,7,11
13696,7,79,12,0,0,0,0,20,32
92602,5,124,17,0,0,0,0,27,44
12670,9,741,2,0,0,0,0,3,5
138922,7,648,38,0,0,0,0,76,114
82381,8,214,129,0,0,0,0,230,359
82407,4,658,26,1,0,0,0,44,71
115148,6,854,2,0,0,0,0,0,2
15557,8,214,0,0,0,0,0,2,2
18700,9,30,10,0,0,0,0,13,23
61850,6,514,13,0,0,0,0,21,34
44658,9,374,32,0,0,0,0,77,109
55465,9,640,8,0,0,0,0,10,18
124131,8,489,1,0,0,0,0,0,1
39907,7,641,16,0,0,0,0,17,33
120991,8,214,3839,4,3,0,3,6067,9916
53726,8,214,434,7,1,1,4,886,1333
10123,4,270,1,0,0,0,0,0,1
23966,8,214,523,0,0,0,0,777,1300
20448,8,214,1108,0,0,0,1,1562,2671
168384,10,917,3,0,0,0,0,13,16
83783,7,521,89,1,1,0,0,89,180
55277,6,514,132,0,1,1,0,155,289
58230,10,322,16,0,0,0,0,44,60
74659,10,798,6,0,0,0,0,9,15
10000,9,243,4,0,0,0,0,9,13
119876,9,243,10,0,0,0,0,19,29
67321,10,413,7,0,0,0,0,12,19
109029,4,453,4,0,0,0,0,3,7
128773,9,302,18,4,1,0,1,37,61
143531,9,575,8,0,0,0,0,13,21
137888,9,640,1,0,0,0,0,0,1
148799,9,145,2,0,0,0,0,3,5
110311,9,145,2,0,0,0,0,3,5
24464,9,145,14,0,0,0,0,8,22
163663,6,232,1,0,0,0,0,0,1
88981,9,762,51,3,2,0,1,90,147
167544,9,487,3,0,0,0,0,4,7
70891,7,710,2,0,0,0,0,2,4
28173,9,828,6,0,0,0,0,9,15
18946,5,200,77,2,1,0,1,123,204
116101,9,657,49,6,1,0,1,62,119
160283,9,367,10,0,0,0,0,7,17
154730,9,631,2,0,0,0,0,2,4
2445,7,556,4,0,0,0,0,4,8
119155,9,800,4,0,0,0,0,4,8
114962,9,556,5,0,0,0,1,13,19
120497,10,29,3,0,0,0,0,2,5
78432,10,29,3,0,0,0,0,4,7
113989,9,575,10,0,0,0,0,14,24
132513,9,657,28,1,0,0,0,42,71
32438,9,314,1,0,0,0,0,0,1
114059,4,519,8,0,0,0,0,30,38
136119,4,519,2,0,0,0,0,10,12
128675,4,519,4,0,0,0,0,4,8
67823,6,232,13,0,0,0,0,27,40
94437,9,95,17,0,0,0,0,12,29
144834,9,95,10,0,0,0,0,13,23
129928,9,314,6,0,0,0,0,8,14
5853,5,225,12,0,0,0,0,18,30
63104,9,452,4,0,0,0,0,0,4
134442,5,78,363,0,0,0,1,598,962
144604,7,157,106,4,2,0,1,227,340
27953,6,785,6,0,0,0,0,4,10
51893,7,157,175,3,1,0,1,261,441
7288,8,174,2754,47,19,2,6,4372,7200
64101,9,640,16,0,0,0,0,21,37
33220,9,489,302,1,0,8,0,440,751
99302,7,626,10,0,0,0,0,16,26
58454,9,6,6,0,0,0,0,13,19
71575,9,538,36,1,1,0,1,74,113
118659,9,838,2,0,0,0,1,4,7
4379,9,838,1,0,0,0,0,1,2
68839,9,762,17,0,0,0,0,24,41
51396,9,457,1,0,0,0,0,1,2
61748,9,456,2,0,0,0,0,3,5
108878,9,158,24,1,1,0,0,56,82
28142,9,158,1,0,0,0,0,2,3
54471,9,632,25,1,0,0,0,55,81
76221,7,551,10,0,0,0,0,14,24
105252,8,214,85,0,0,0,0,132,217
92030,8,214,145,0,0,0,2,193,340
25156,9,750,2,0,0,0,0,3,5
81735,10,653,80,0,0,0,1,103,184
312,8,214,582,2,1,0,12,922,1519
49807,7,508,2,0,0,0,0,3,5
135643,10,917,10,0,0,0,0,26,36
161308,7,74,10,1,0,0,0,27,38
35393,8,812,22,0,0,0,0,67,89
45129,7,74,6,0,0,0,0,13,19
45969,9,556,2,0,0,0,0,4,6
28136,9,556,42,1,1,0,1,56,101
124994,7,74,14,0,0,0,0,33,47
91207,7,74,2,0,0,0,0,4,6
22711,9,630,4,0,0,0,0,4,8
93513,9,838,2,0,0,0,0,4,6
91619,5,124,19,0,0,0,0,23,42
95410,8,658,0,1,0,0,0,0,1
127462,6,103,12,0,0,0,0,11,23
117401,7,489,95,3,3,0,1,170,272
82032,7,427,3,0,0,0,0,4,7
107945,9,489,27,0,0,0,0,44,71
133374,5,693,151,1,0,5,0,245,402
10311,5,821,9,0,0,0,0,18,27
29297,5,263,87,3,2,0,0,128,220
151786,5,78,552,0,0,0,10,936,1498
75851,4,375,4283,87,37,5,30,7222,11664
65686,7,508,9,0,0,0,0,9,18
93605,9,375,3,0,0,0,0,5,8
73145,4,200,15,0,0,0,0,26,41
148247,7,741,161,0,0,0,1,227,389
2247,9,314,1,0,0,0,0,2,3
79871,9,873,16,0,0,0,0,10,26
1672,7,384,2,0,0,0,0,2,4
89695,4,658,65,0,0,0,1,149,215
29773,9,380,3,0,0,0,0,6,9
98007,9,489,113,2,2,0,1,196,314
126178,7,384,8,0,0,0,0,10,18
163304,7,226,4,0,0,0,0,5,9
131644,7,226,4,0,0,0,0,9,13
45205,7,196,4,0,0,0,0,4,8
27808,4,752,283,8,5,0,1,510,807
102741,9,243,12,0,0,0,0,11,23
163794,9,6,1,0,0,0,0,9,10
146922,7,641,7,0,0,0,0,11,18
62278,9,367,4,0,0,0,0,6,10
28490,8,545,1,0,0,0,0,1,2
29435,9,909,4,0,0,0,0,8,12
40966,9,301,13,0,0,0,0,20,33
142702,9,301,4,0,0,0,0,7,11
55922,8,214,0,0,0,0,0,17,17
154442,9,909,3,0,0,0,0,5,8
64231,8,214,323,2,2,0,1,565,893
138465,4,174,328,7,4,0,2,615,956
72349,10,36,384,9,3,1,2,638,1037
86672,5,235,54,2,1,0,0,89,146
9828,9,30,22,1,1,0,0,30,54
98997,7,306,1,0,0,0,0,0,1
700,4,458,389,3,1,0,1,714,1108
55045,11,214,14,1,0,0,0,16,31
53214,9,819,440,18,4,2,0,729,1193
11627,9,374,2,0,0,0,0,13,15
44472,7,489,98,0,0,0,0,183,281
114148,8,214,1,0,0,0,0,13,14
25759,9,575,6,1,1,0,0,15,23
111497,11,214,19,0,0,0,0,14,33
112329,11,214,3,0,0,0,0,2,5
109023,4,174,93,2,2,0,1,156,254
98599,7,175,42,2,0,0,0,56,100
35083,7,384,14,1,0,0,0,23,38
17299,7,254,6,0,0,0,0,13,19
119106,9,838,2,0,0,0,0,4,6
142428,4,174,5,0,0,0,0,7,12
152320,10,66,34,0,0,0,0,34,68
75609,11,244,8,1,0,0,0,13,22
133861,7,196,9,0,0,0,0,21,30
166653,9,301,2,0,0,0,0,9,11
118525,9,216,2,0,0,0,0,3,5
141546,9,693,5,0,0,0,0,10,15
131038,9,78,2,0,0,0,0,2,4
143030,9,30,14,0,0,0,0,17,31
156861,6,165,5,0,1,0,0,10,16
154933,10,682,9,0,0,0,0,23,32
95978,10,357,24,0,0,0,1,39,64
46541,5,238,8,0,0,0,0,14,22
48484,5,200,14,0,0,0,0,19,33
30823,7,488,2,0,0,0,0,3,5
105867,9,452,3,0,0,0,1,5,9
58532,9,796,2,0,0,0,0,2,4
6712,9,796,2,0,0,0,0,2,4
144225,7,228,194,2,2,1,0,271,470
19071,9,43,2,0,0,0,0,2,4
91898,10,111,25,0,0,0,0,29,54
46039,10,111,3,0,0,0,0,22,25
165839,10,628,12,0,0,0,0,21,33
132753,10,628,4,1,0,0,0,17,22
122879,4,36,5,0,0,0,0,9,14
141600,5,124,12,0,0,0,1,18,31
27855,7,228,28,4,0,1,0,69,102
144783,5,78,174,5,1,0,2,261,443
676,5,78,18,0,0,0,0,26,44
27567,8,812,27,0,0,0,0,50,77
48656,9,657,1713,52,29,3,9,2122,3928
2862,5,159,4,0,0,0,0,10,14
23378,4,908,5,0,0,0,0,5,10
39839,9,909,5,0,0,0,0,11,16
90287,9,314,14,0,0,0,0,33,47
113877,9,314,21,0,0,0,0,39,60
106733,9,314,10,0,0,0,0,15,25
82457,9,314,7,3,0,0,0,13,23
148329,9,314,2,0,0,0,0,3,5
84536,10,716,8,0,0,0,0,9,17
51243,7,748,14,0,0,0,1,21,36
52446,11,306,8,0,0,0,0,10,18
15094,6,165,424,4,3,0,2,824,1257
132322,4,200,1,0,0,0,0,2,3
45224,7,56,7,0,0,0,0,13,20
97717,9,353,5,0,0,0,0,8,13
120329,5,800,2,0,0,0,0,3,5
136853,4,159,1,0,0,0,0,0,1
1989,9,100,12,0,0,0,0,19,31
141694,9,912,8,0,0,0,0,8,16
82055,9,158,45,0,0,0,0,101,146
102692,9,65,11,0,0,0,0,23,34
145584,8,214,24,1,1,0,0,16,42
32732,5,225,2,0,0,0,0,1,3
134928,4,658,3,0,0,0,0,5,8
86358,10,111,15,0,0,0,0,11,26
145602,6,514,16,1,1,0,0,39,57
169505,6,514,6,0,0,0,0,22,28
57641,4,458,83,0,0,0,1,124,208
78372,9,538,6,0,0,0,0,6,12
83990,8,693,3,0,0,0,0,0,3
79902,6,785,2,0,0,0,0,2,4
144691,8,214,8,0,0,0,0,53,61
136665,8,545,2,0,0,0,0,0,2
113359,7,263,10,0,0,0,0,17,27
103154,11,489,2,0,0,0,0,2,4
123713,4,658,2,0,0,0,0,5,7
118742,10,66,31,1,1,0,0,74,107
146243,6,296,18,0,0,0,0,28,46
21434,11,677,6,0,0,0,0,12,18
8717,8,214,10,0,0,0,0,9,19
110480,7,24,3,0,0,0,0,0,3
62656,4,458,24,0,0,0,0,34,58
85271,4,581,1,0,0,0,0,1,2
54367,8,214,3,0,0,0,0,5,8
44998,4,885,101,0,0,0,0,196,297
92606,6,78,30,0,0,0,0,43,73
20706,6,124,31,2,0,0,0,43,76
95893,7,79,2,0,0,0,0,0,2
117505,7,79,6,0,0,0,0,7,13
135558,8,403,2,0,0,0,0,3,5
94403,5,408,36,1,1,0,1,89,128
87265,10,29,11,0,0,0,0,21,32
78039,10,29,3,0,0,0,0,9,12
83575,9,184,6,0,0,0,0,11,17
24980,9,184,22,0,0,0,0,29,51
154835,9,184,22,0,0,0,1,21,44
128872,10,628,17,3,0,0,0,62,82
157553,9,184,2,0,0,0,0,2,4
34079,5,4,1,0,0,0,0,4,5
93570,11,489,1,0,0,0,0,0,1
104512,7,163,2,0,0,0,0,5,7
111550,7,163,0,0,0,0,0,4,4
170829,9,873,16,0,0,2,0,24,42
128894,10,111,4,0,1,0,0,7,12
45627,4,174,54,0,0,0,0,84,138
16801,4,174,64,1,2,0,0,127,194
68693,4,174,189,2,1,0,2,385,579
54138,7,660,5,0,0,0,0,4,9
153021,6,514,14,0,0,0,0,28,42
71855,8,800,121,2,0,0,1,217,341
5632,9,203,4,0,0,0,0,3,7
16887,9,706,2,0,0,0,0,3,5
110279,8,214,1158,20,5,0,9,2009,3201
137202,8,214,220,2,1,0,1,377,601
141224,9,360,1,0,0,0,0,1,2
124628,9,202,30,0,0,0,0,41,71
14639,11,214,4,1,0,0,0,4,9
955,10,841,26,2,1,0,0,39,68
18299,10,917,4,0,0,0,0,5,9
35364,9,399,10,0,0,0,0,17,27
3117,7,226,8,0,0,0,0,22,30
130871,8,790,4,0,0,0,0,8,12
45723,4,453,2,0,0,0,0,4,6
105845,7,126,8,1,1,0,0,12,22
31256,4,270,5,0,0,0,0,6,11
10011,8,214,6,0,0,0,0,11,17
170671,7,487,4,0,0,0,0,4,8
89685,10,66,3,0,0,0,0,4,7
146160,10,550,6,0,0,0,0,23,29
7067,8,623,1,0,0,0,0,0,1
122573,10,550,5,0,0,0,0,9,14
47537,8,214,1,0,0,0,0,0,1
49624,8,214,2,0,0,0,0,0,2
16123,8,214,1,0,0,0,0,0,1
52738,8,214,2,0,0,0,0,0,2
110288,8,214,2,0,0,0,0,0,2
43093,8,214,1,0,0,0,0,0,1
170566,8,916,1,0,0,0,0,0,1
138941,4,885,4,0,0,0,0,5,9
79229,8,214,2,0,0,0,0,2,4
116780,8,214,1,0,0,0,0,0,1
159816,8,214,1,0,0,0,0,0,1
24713,9,8,9,0,0,0,0,8,17
136723,7,30,5,0,0,0,0,12,17
121658,7,489,119,0,0,0,0,253,372
96141,10,743,4,0,0,0,0,5,9
55925,4,174,1,0,0,0,0,1,2
97611,6,514,10,0,0,0,0,21,31
111185,7,144,3,0,0,0,0,3,6
160420,9,427,18,0,0,0,0,26,44
7798,4,658,17,0,0,0,0,29,46
8568,9,6,42,0,0,0,0,33,75
22579,8,885,5,0,0,0,0,2,7
11920,4,124,4,0,0,0,0,6,10
121249,10,628,10,0,0,0,0,21,31
159404,4,200,128,2,1,0,1,230,362
20520,11,124,4,1,0,0,0,5,10
65825,7,4,23,0,0,0,0,26,49
16886,7,367,16,2,0,1,0,18,37
79809,9,714,2,0,0,0,0,0,2
54971,10,781,25,0,0,0,0,34,59
65797,11,214,29,1,0,0,0,42,72
105740,11,489,2,0,0,0,0,1,3
130792,9,158,0,0,0,0,0,20,20
116110,9,575,23,0,0,0,0,35,58
109206,7,521,7,0,0,0,1,12,20
113510,7,46,28,0,0,0,1,26,55
72308,9,575,25,0,0,0,0,47,72
32354,9,589,11,0,0,0,0,56,67
162279,5,200,66,0,0,2,0,65,133
119761,4,591,1,0,0,0,0,2,3
123698,10,22,2,0,0,0,0,4,6
139209,10,903,5,0,0,0,0,10,15
25146,8,214,0,0,0,0,0,5,5
85441,4,174,1,0,0,0,0,1,2
50092,7,216,1521,57,20,1,6,2645,4250
38389,5,200,18,0,0,0,1,27,46
55729,11,214,6,0,0,0,0,6,12
123374,7,864,22,0,0,0,0,42,64
81089,9,570,5,0,0,0,0,7,12
160775,10,917,4,2,1,0,0,8,15
126012,9,427,479,34,19,4,4,1379,1919
53987,4,458,13,0,0,0,0,15,28
75945,6,355,4,0,0,0,0,3,7
146494,7,693,1,0,0,0,0,0,1
119760,7,741,7,0,0,0,0,13,20
75626,7,74,4,0,0,0,0,11,15
133635,6,124,33,0,0,0,1,58,92
35851,9,497,4,0,0,0,0,6,10
170136,6,215,10,0,0,0,0,4,14
156519,4,159,1,0,0,0,0,0,1
41056,4,159,1,0,0,0,0,0,1
63619,9,341,0,0,0,0,0,4,4
167033,8,214,0,0,0,0,0,3,3
21911,6,885,2,0,0,0,0,4,6
118291,7,374,6,0,0,0,0,13,19
78981,4,458,308,7,4,0,1,494,814
166524,4,200,146,4,2,0,0,277,429
39838,9,243,2,0,0,0,0,3,5
84741,9,469,12,0,0,0,0,15,27
78307,9,535,16,0,0,0,0,25,41
15315,9,175,2,0,0,0,0,3,5
33400,7,312,1,0,0,0,0,2,3
98758,7,872,12,0,0,0,0,26,38
30878,8,244,134,0,0,0,0,208,342
158775,8,244,59,0,0,0,0,70,129
94902,5,124,74,4,0,0,0,113,191
156904,4,174,3,0,0,0,0,5,8
15301,11,214,8,0,0,0,0,13,21
136077,8,658,4,0,0,0,0,8,12
9232,9,570,9,0,0,0,0,9,18
58047,4,36,110,2,2,0,0,194,308
29829,4,458,104,1,1,0,0,169,275
152819,4,752,106,1,1,0,0,164,272
69951,4,800,8,0,0,0,0,20,28
108770,7,310,2,0,0,0,0,5,7
42668,9,65,2,0,0,0,0,3,5
24622,9,560,5,0,0,0,0,6,11
150806,10,66,5,0,0,0,0,6,11
103060,11,214,9,0,0,0,0,6,15
121456,5,140,10,0,0,0,0,22,32
134734,7,306,2,0,0,0,0,3,5
72287,9,30,11,1,1,0,0,20,33
127710,6,800,1,0,0,0,0,1,2
162801,4,458,87,2,2,0,0,115,206
69661,4,200,46,1,1,0,0,95,143
103329,9,314,3,0,0,0,0,6,9
65885,8,244,100,0,0,0,1,143,244
27316,8,244,42,0,0,0,0,58,100
27382,9,314,5,0,0,0,0,9,14
117916,9,762,4,1,0,0,0,6,11
62353,9,570,2,0,0,0,0,6,8
137836,9,147,0,0,0,0,0,7,7
66854,9,147,0,0,0,0,0,3,3
39283,7,492,2,0,0,0,0,2,4
112151,5,885,18,0,0,0,0,23,41
160434,10,653,1,0,0,0,0,3,4
1212,9,873,4,0,0,0,1,11,16
86987,9,873,2,0,0,0,0,5,7
134976,9,374,2,0,0,0,0,3,5
101380,7,535,14,1,1,0,0,19,35
14579,10,798,6,0,0,0,0,8,14
47528,6,200,82,2,0,0,0,128,212
55025,7,118,13,0,0,0,0,10,23
110529,7,488,9,0,0,0,0,12,21
38311,7,488,35,1,1,0,0,53,90
7666,8,244,99,0,0,0,0,133,232
115400,9,842,22,0,0,0,0,15,37
100509,5,176,49,2,0,2,0,71,124
146946,9,325,2,0,0,0,0,7,9
137272,9,472,14,0,0,0,0,14,28
12498,6,368,2,0,0,0,0,3,5
171035,9,302,38,0,0,0,1,78,117
151744,4,453,82,0,0,0,0,134,216
149642,7,460,6,0,0,0,0,11,17
78120,9,360,4,1,1,0,0,4,10
115945,9,706,0,1,1,0,0,0,2
130601,6,159,148,2,1,0,0,249,400
780,6,159,139,2,1,0,0,200,342
10190,4,752,108,3,0,0,0,159,270
39456,6,159,197,7,4,0,0,379,587
66792,11,427,28,3,0,0,0,24,55
45045,5,159,33,0,0,0,1,49,83
142569,7,484,20,0,0,0,0,45,65
78437,9,302,0,0,0,0,0,5,5
160189,9,302,36,0,0,0,1,86,123
105930,8,489,2,0,0,0,0,2,4
124989,9,838,0,0,0,0,0,5,5
10833,9,838,1,0,0,0,0,15,16
51132,9,838,0,0,0,0,0,6,6
55077,9,838,6,0,0,0,0,24,30
34116,9,838,0,0,0,0,0,10,10
124479,10,523,4,0,0,0,0,47,51
78905,8,214,39,0,0,0,0,58,97
128580,9,184,4,0,0,0,0,4,8
28266,9,184,2,0,0,0,0,3,5
71344,9,842,67,2,1,0,0,126,196
65591,9,873,2,0,0,0,0,41,43
119849,9,873,7,0,0,0,0,23,30
33825,9,145,2,0,0,0,0,6,8
72002,7,157,28,0,0,0,0,57,85
16787,8,214,3,0,0,0,0,7,10
75202,8,800,1,0,0,0,0,0,1
131225,6,200,79,0,0,0,0,132,211
150625,5,479,222,1,1,0,1,356,581
164492,9,589,6,0,0,0,0,3,9
167169,9,145,7,0,0,0,0,11,18
24429,6,585,46,3,1,0,0,102,152
149281,5,821,34,0,0,0,1,63,98
168525,9,380,4,0,0,0,0,8,12
150288,9,380,4,0,0,0,0,6,10
123900,4,174,166,2,1,0,0,369,538
26642,6,729,23,1,0,0,0,50,74
97363,9,399,3,0,0,0,0,3,6
87201,11,812,6,0,0,0,0,6,12
98409,7,741,12,1,0,0,0,18,31
9633,10,555,6,0,0,0,0,22,28
72093,10,555,0,0,0,0,0,3,3
95645,10,820,2,0,0,0,0,14,16
84863,5,355,50,0,0,0,0,74,124
50757,8,214,10,0,0,0,0,15,25
93221,7,216,234,8,3,0,0,361,606
156414,9,684,2,0,0,0,0,5,7
12491,9,30,3,0,0,0,0,6,9
130049,6,693,13,0,0,0,0,15,28
66690,4,375,1,0,0,0,0,1,2
3728,4,200,2,0,0,0,0,3,5
14459,9,570,38,0,0,0,1,85,124
73470,7,56,4,0,0,0,0,11,15
150212,10,66,4,0,0,0,0,9,13
14714,10,66,15,0,0,0,0,31,46
162406,9,100,15,0,0,3,0,20,38
65603,10,66,4,0,0,0,0,13,17
162219,4,885,2,0,0,0,0,9,11
26228,7,202,2,0,0,0,0,4,6
78657,8,800,2,0,0,0,0,4,6
79166,9,575,10,0,0,0,0,25,35
140763,9,575,8,1,0,0,0,31,40
105794,7,657,2,0,0,0,0,2,4
22999,10,66,5,0,0,0,0,7,12
88645,6,290,14,1,1,0,0,23,39
168358,9,79,4,0,0,0,0,6,10
62178,8,214,4,0,0,0,0,3,7
159683,4,800,1,0,0,0,0,1,2
34175,9,657,34,0,0,0,0,80,114
26115,11,545,12,3,0,0,0,12,27
90979,4,458,359,11,6,1,0,699,1076
134418,4,890,1,0,0,0,0,1,2
166362,7,521,11,0,0,0,0,12,23
29231,9,65,2,0,0,0,0,4,6
58801,9,158,0,0,0,0,0,21,21
11445,9,65,1,0,0,0,0,12,13
131175,9,65,3,0,0,0,0,13,16
87464,9,65,2,0,0,0,0,5,7
45785,9,65,6,0,0,0,0,8,14
170944,9,630,1,0,0,0,0,0,1
129018,8,812,19,0,0,0,0,32,51
156206,5,78,1,0,0,0,0,0,1
85797,7,489,104,0,0,0,0,171,275
50453,6,922,1,0,0,0,0,0,1
57083,9,78,2,0,0,0,0,1,3
80478,7,207,17,0,0,0,0,43,60
72846,11,306,6,0,0,0,0,3,9
68552,4,581,1,0,0,0,0,1,2
122357,10,628,9,0,0,0,0,28,37
88435,7,126,9,0,0,0,0,12,21
88417,4,458,20,0,0,0,0,25,45
10514,5,200,552,5,2,0,3,977,1539
169340,9,374,1,0,0,0,0,6,7
53386,6,885,1,0,0,0,0,0,1
158788,5,78,1,0,0,0,0,5,6
124016,4,36,42,0,0,1,0,67,110
84147,7,306,55,0,0,0,1,146,202
158978,9,885,2,0,0,0,0,4,6
69115,9,560,4,0,0,0,0,5,9
49967,9,560,2,0,0,0,0,2,4
136594,9,560,5,0,0,0,0,6,11
131812,9,43,1,0,0,0,0,0,1
104696,7,196,14,0,0,0,0,26,40
161447,9,630,6,0,0,0,0,11,17
165957,9,43,1,0,0,0,0,2,3
73830,7,196,9,0,1,0,0,28,38
130888,11,812,1,0,0,0,0,1,2
32506,10,322,1,0,0,0,0,1,2
89470,7,56,4,0,0,0,0,8,12
97583,7,864,5,0,0,0,0,10,15
16879,7,864,4,0,0,0,0,6,10
33758,9,456,13,0,0,0,0,22,35
170591,7,864,15,0,0,0,0,16,31
61911,6,200,7,0,0,0,0,8,15
108615,5,159,3,0,0,0,0,3,6
50490,9,380,6,0,0,0,0,7,13
103259,9,85,9,0,0,0,0,9,18
18224,9,405,18,1,0,5,0,29,53
149613,10,242,1,0,0,0,0,7,8
114202,8,214,830,32,10,1,2,1482,2357
156701,5,479,1,0,0,0,0,1,2
55919,11,214,7,0,0,0,0,6,13
132556,9,158,55,1,1,0,0,103,160
124413,6,232,732,31,11,6,6,1224,2010
148230,8,124,1,0,0,0,0,0,1
100033,9,909,10,0,0,0,0,14,24
113508,10,798,2,0,0,0,0,2,4
76362,11,306,16,1,0,0,0,14,31
55321,7,864,9,0,0,0,0,23,32
2300,6,159,66,0,0,0,1,105,172
44424,4,885,1,0,0,0,0,0,1
29942,9,367,16,0,0,0,0,22,38
123154,7,56,3,0,0,0,0,2,5
132684,7,484,2,0,0,0,0,6,8
42346,7,46,2,0,0,0,0,3,5
97524,9,575,4,0,0,0,0,4,8
129192,8,489,2,0,0,0,0,2,4
31225,7,56,3,0,0,0,0,2,5
136048,11,545,6,0,0,0,0,3,9
36209,9,367,1,0,0,0,0,1,2
143576,9,489,145,3,2,0,0,211,361
10227,11,124,1,0,0,0,0,1,2
169267,8,124,1,0,0,0,0,2,3
24816,9,469,3,0,0,0,0,2,5
66036,7,56,12,1,0,0,0,15,28
121938,8,214,222,2,0,0,0,328,552
66960,7,306,1,0,0,0,0,0,1
109853,11,214,9,0,0,0,0,9,18
18551,10,29,4,0,0,0,0,6,10
85289,9,6,1,0,0,0,0,2,3
165037,9,658,7,2,1,1,0,14,25
82134,9,640,0,1,0,0,0,0,1
10306,9,65,11,0,0,0,0,21,32
136009,9,65,0,0,0,0,0,6,6
121205,9,65,0,0,0,0,0,3,3
84615,9,65,2,0,0,0,0,5,7
101562,9,65,0,0,0,0,0,3,3
70551,9,65,0,0,0,0,0,8,8
66168,9,65,0,0,0,0,0,3,3
18826,9,912,7,0,0,0,0,75,82
57489,9,469,1,0,0,0,0,0,1
101862,9,65,0,0,0,0,0,5,5
72903,8,174,160,4,1,0,0,319,484
143027,8,174,235,2,1,0,0,466,704
65718,4,890,5,0,0,0,0,7,12
43771,10,917,20,0,0,0,0,31,51
428,7,367,88,3,1,1,1,133,227
114960,7,488,7,0,0,0,0,10,17
19133,7,611,37,0,0,0,1,56,94
81716,6,200,296,6,1,0,1,459,763
102017,9,380,3,0,0,0,0,9,12
9135,9,380,0,0,0,0,0,4,4
8030,5,800,4,0,0,0,0,5,9
48054,11,124,1,0,0,0,0,0,1
2234,10,289,1,0,0,0,0,1,2
115752,4,458,249,10,3,0,1,430,693
55218,8,214,328,4,3,0,2,605,942
114265,11,306,8,0,0,0,0,12,20
140598,8,214,615,20,8,4,0,1167,1814
165418,9,374,0,0,0,0,0,5,5
82842,10,798,2,0,0,0,0,3,5
58168,10,66,8,0,0,0,0,8,16
45834,8,214,279,1,0,0,1,414,695
53906,4,885,8642,140,43,13,60,15398,24296
59824,7,578,47,3,0,0,1,89,140
61347,7,578,5,0,0,0,0,4,9
19934,7,578,25,0,0,0,0,36,61
46320,5,306,57,2,0,0,0,104,163
106465,9,145,7,2,1,0,0,16,26
9572,9,145,1,0,0,0,0,1,2
112731,9,145,3,0,0,0,0,5,8
125794,9,243,13,1,1,0,0,23,38
133911,8,214,593,2,1,0,1,988,1585
160432,9,489,3,0,0,0,0,5,8
60395,8,214,623,13,5,0,4,1059,1704
101554,9,158,3,0,1,0,0,8,12
32677,10,474,2,0,0,0,0,3,5
20225,8,306,2,0,0,0,0,2,4
13493,10,903,8,0,0,0,0,20,28
164406,10,355,3,0,0,0,0,5,8
91505,9,842,31,0,0,0,0,49,80
27618,7,489,67,0,0,0,0,82,149
99410,8,214,315,3,3,0,2,535,858
154751,4,453,0,0,0,0,0,3,3
102164,6,103,11,0,0,0,0,17,28
167980,8,214,599,0,0,0,1,1018,1618
130378,9,489,4,0,0,0,0,4,8
88108,7,306,4,0,0,0,0,4,8
162437,9,575,11,1,1,0,0,18,31
121615,10,628,5,0,0,0,0,23,28
3891,4,885,1343,44,12,9,12,2324,3744
15401,9,341,11,0,0,0,0,29,40
109555,9,85,0,0,0,0,0,1,1
19725,9,85,9,0,0,0,0,12,21
11711,7,144,8,1,1,0,0,12,22
40409,7,144,2,0,0,0,0,3,5
134588,4,200,64,1,0,0,0,103,168
13693,11,214,6,0,0,0,0,4,10
77931,8,484,15,0,0,0,0,16,31
64336,9,145,17,3,2,0,0,31,53
105047,10,917,15,0,0,0,0,18,33
61868,10,917,4,0,0,0,0,8,12
87125,7,196,10,0,0,0,0,15,25
38307,6,789,21,0,0,0,0,27,48
101579,10,584,3,0,0,0,0,2,5
38186,6,375,10,0,0,0,0,17,27
88276,10,917,10,0,0,0,1,14,25
88063,9,556,4,0,0,0,0,8,12
153081,11,214,1,0,0,0,0,1,2
29622,8,214,858,25,9,0,9,1519,2420
150188,9,556,2,0,0,0,0,4,6
133554,9,302,2,0,0,0,0,6,8
19530,4,159,4,0,0,0,0,7,11
148176,10,322,1,0,0,0,0,1,2
124019,8,812,24,0,0,0,0,48,72
21679,5,218,75,0,0,0,0,137,212
111305,9,842,6,0,0,0,0,8,14
139916,4,885,6,0,0,0,0,1,7
131383,9,8,2,0,0,0,0,0,2
137014,9,640,176,0,0,0,4,273,453
1927,8,214,524,3,2,1,4,808,1342
87848,4,36,4,0,0,0,0,8,12
71357,7,118,4,0,0,0,0,3,7
56509,7,508,8,0,0,0,0,8,16
104561,7,660,1,0,0,0,0,2,3
147502,9,640,30,0,0,0,0,56,86
3751,4,458,80,3,3,0,0,162,248
105875,7,710,2,0,0,0,0,3,5
138515,9,885,4,0,0,0,0,10,14
115883,4,375,150,2,1,0,2,237,392
5677,9,86,22,0,0,0,0,23,45
29298,10,903,2,0,0,0,0,7,9
20467,4,200,1,0,0,0,0,6,7
14805,11,214,61,1,0,0,0,71,133
27034,11,800,35,1,0,0,0,42,78
123442,9,556,5,1,1,0,0,9,16
45390,4,174,28,0,0,0,0,37,65
70966,9,117,10,0,0,0,0,15,25
60935,7,216,41,1,0,2,0,52,96
125678,7,118,4,0,0,0,0,4,8
10234,9,341,8,0,0,0,0,39,47
98240,9,570,5,0,0,0,0,5,10
30611,9,484,1,0,0,0,0,22,23
8864,9,158,3,0,0,0,0,5,8
25876,8,214,92,1,0,0,0,176,269
48901,11,812,2,0,0,0,0,2,4
53135,11,214,5,0,0,0,0,4,9
111439,5,263,100,4,1,0,0,164,269
54239,9,77,77,3,1,0,0,113,194
41935,10,357,4,0,0,0,0,10,14
30100,10,22,12,0,0,0,0,17,29
61445,8,214,254,7,1,0,1,397,660
60400,5,124,45,1,1,0,0,68,115
7126,9,538,2,0,0,0,0,3,5
122221,10,798,2,0,0,0,0,5,7
155088,4,375,47,0,0,0,0,51,98
12116,4,375,38,0,0,0,0,53,91
29786,10,618,2,0,0,0,0,0,2
155234,10,322,2,0,0,0,0,3,5
43069,7,669,4,0,0,0,0,13,17
61074,7,864,1,0,0,0,0,2,3
102864,6,78,138,4,1,0,2,253,398
134893,9,472,9,0,0,0,0,19,28
103787,9,46,2,0,0,0,0,2,4
117168,9,472,17,1,1,0,0,46,65
69913,9,472,3,0,0,0,0,5,8
145097,7,472,2,0,0,0,0,4,6
84690,9,472,4,0,0,0,0,10,14
87833,9,658,4,0,0,0,0,3,7
154762,9,469,1,0,0,0,0,0,1
9138,7,748,14,0,0,0,0,14,28
2986,8,655,49,0,0,0,1,59,109
47283,10,917,7,0,0,0,0,9,16
167886,7,611,2,0,0,0,0,4,6
32801,9,380,4,2,1,0,0,14,21
121048,5,218,176,4,3,0,0,276,459
147561,4,658,21,0,0,0,0,32,53
23999,7,755,5,0,0,0,0,12,17
20844,10,653,2,0,0,0,0,3,5
3535,4,174,1,0,0,0,0,0,1
89197,7,367,382,8,4,2,0,665,1061
35663,9,8,17,0,0,0,0,23,40
118752,5,479,95,0,0,0,0,154,249
170594,4,752,87,3,1,0,0,149,240
39393,7,367,8,0,0,0,0,10,18
140716,5,821,64,1,1,0,1,80,147
16110,9,526,1,0,0,0,0,0,1
170564,11,214,2,0,0,0,0,1,3
22878,7,384,3,0,0,0,0,4,7
116119,7,384,13,1,1,0,0,18,33
97052,9,302,18,0,0,0,0,55,73
164353,9,630,2,0,0,0,0,4,6
65563,7,214,184,4,2,0,0,269,459
90785,10,355,1,0,0,0,0,1,2
76159,9,719,1,0,0,0,0,2,3
28000,8,214,54,0,0,0,0,75,129
101486,8,214,498,0,0,0,1,729,1228
11175,6,643,2,0,0,0,0,20,22
60933,8,489,3,0,0,0,0,4,7
121413,8,214,2,0,0,0,0,3,5
98011,8,214,264,2,1,0,0,395,662
151992,8,214,1265,39,13,3,9,2007,3336
153557,11,427,6,2,0,0,0,4,12
145830,8,214,81,0,0,0,0,108,189
29000,9,54,17,0,0,0,0,43,60
161341,9,306,6,0,0,0,0,10,16
82112,9,367,6,0,0,0,0,5,11
71587,9,367,1,0,0,0,0,0,1
50942,9,367,1,0,0,0,0,0,1
53866,5,200,3,0,0,0,0,2,5
21541,4,375,79,0,0,0,1,163,243
125500,10,806,16,0,0,0,1,28,45
24156,9,107,5,1,1,0,0,8,15
39814,5,293,14,0,0,0,0,20,34
128154,4,199,1,0,0,0,0,1,2
16333,9,374,2,1,0,0,0,2,5
161870,8,214,2103,65,15,7,13,4153,6356
144759,5,78,160,4,2,1,3,254,424
107677,7,56,8,2,1,0,0,9,20
108724,10,917,11,0,0,0,0,24,35
119293,7,578,10,0,0,0,0,30,40
119180,7,56,20,1,0,1,0,15,37
131233,6,159,51,0,0,0,0,71,122
114407,7,578,4,1,1,0,0,5,11
168942,11,214,10,0,0,0,0,22,32
134530,7,521,5,0,0,0,0,7,12
159082,10,628,1,0,0,0,0,3,4
51470,10,413,1,0,0,0,0,3,4
129788,7,306,1501,43,17,3,12,3083,4659
161873,4,36,7,0,0,0,0,6,13
10065,9,912,2,0,0,0,0,5,7
109196,9,131,18,0,0,0,0,24,42
127502,9,912,5,0,0,0,0,8,13
46687,9,302,4,0,0,0,0,5,9
143388,8,214,1,0,0,0,0,1,2
138947,9,874,4,0,0,0,0,6,10
58128,7,306,998,33,12,2,7,2924,3976
131226,9,65,4,0,0,0,0,7,11
113378,8,244,114,0,0,0,0,164,278
85098,8,214,152,3,1,0,2,311,469
109596,9,131,23,1,0,0,0,38,62
139321,8,489,1,0,0,0,0,0,1
54476,10,36,2,0,0,0,0,0,2
24814,4,200,6,0,0,0,0,8,14
32427,7,896,12,1,0,0,0,21,34
66089,7,896,47,3,2,0,0,72,124
81618,7,896,10,0,0,0,0,17,27
86021,11,214,1,0,0,0,0,0,1
59272,8,214,372,3,0,0,0,635,1010
43628,8,214,468,3,2,0,2,789,1264
32311,11,214,18,0,0,0,0,20,38
79249,7,611,4,0,0,0,0,6,10
86517,6,78,4,2,0,0,0,2,8
92722,7,648,59,3,1,1,0,68,132
118958,10,550,5,0,0,0,0,17,22
47467,6,453,3,0,0,0,0,7,10
126765,8,214,190,2,2,0,1,353,548
124274,9,462,3,0,0,0,0,6,9
146842,9,86,9,0,0,0,0,12,21
125986,9,4,8,0,0,0,0,10,18
19807,9,469,17,0,0,0,0,21,38
162399,10,66,2,0,0,0,0,2,4
11326,4,174,8,0,0,0,0,8,16
106101,4,877,2,0,0,0,0,4,6
126255,8,214,432,6,3,0,2,598,1041
6927,8,214,25,0,0,0,0,25,50
57299,7,56,2,0,0,0,0,4,6
23963,10,917,2,0,0,0,0,18,20
8656,10,917,22,0,0,0,0,46,68
4530,10,917,1,0,0,0,0,14,15
163779,10,917,3,0,0,0,0,14,17
137499,9,65,6,0,0,0,0,3,9
147054,8,489,115,0,0,0,1,186,302
22337,8,489,1,0,0,0,0,1,2
155034,8,214,181,4,2,0,2,352,541
98696,8,214,10,0,0,0,0,15,25
91794,8,214,6,0,0,0,0,7,13
129589,10,104,14,0,0,0,0,18,32
5655,8,214,183,5,1,1,0,387,577
106370,8,214,232,5,1,0,0,437,675
12148,9,452,1,0,0,0,0,2,3
51636,9,452,3,0,0,0,0,6,9
126766,10,917,2,0,0,0,0,3,5
13471,9,657,43,2,1,0,0,82,128
159658,10,628,9,0,0,0,0,16,25
6443,4,890,306,5,1,0,1,392,705
27593,5,800,1,0,0,0,0,3,4
155725,8,885,2,0,0,0,0,8,10
76341,7,508,39,0,0,0,1,43,83
117146,9,100,2,0,0,0,0,3,5
155710,7,508,27,0,0,0,0,21,48
75128,8,214,558,11,3,0,3,935,1510
81879,4,174,19,0,0,0,0,36,55
47717,6,453,71,5,2,0,2,146,226
102210,8,556,4,0,0,0,0,3,7
130686,5,124,12,0,0,0,0,19,31
29890,5,159,20,1,1,0,0,25,47
47588,9,538,18,0,0,0,1,103,122
150704,8,885,1,0,0,0,0,0,1
158047,9,910,5,0,0,0,0,4,9
143934,9,607,1,0,0,0,0,0,1
147553,9,838,2,0,0,0,0,3,5
124034,9,472,11,0,0,0,0,25,36
159699,9,367,5,0,0,0,0,5,10
58148,8,693,1,0,0,0,0,2,3
7937,7,575,12,0,0,0,0,29,41
49666,9,472,2,0,0,0,0,16,18
119080,9,418,10,0,0,0,0,15,25
31707,10,66,11,0,0,0,0,27,38
115370,9,472,2,0,0,0,0,6,8
168671,9,657,9,0,0,0,0,15,24
124782,7,657,15,4,1,0,1,31,52
28564,4,752,147,5,5,0,0,223,380
114713,10,81,5,0,0,0,0,6,11
105230,7,693,2,0,0,0,0,5,7
49500,9,243,8,0,0,0,0,9,17
40111,8,403,4,0,0,0,0,5,9
79815,9,630,900,23,13,6,4,1024,1970
17616,9,313,2,0,0,0,0,4,6
1550,9,489,35,1,1,0,0,35,72
155982,9,42,0,0,0,0,0,5,5
3960,9,42,2,0,0,0,0,5,7
21130,5,159,66,4,2,0,0,121,193
107730,11,214,1,0,0,0,0,1,2
8988,7,196,16,0,0,0,0,28,44
104180,10,81,0,0,0,0,0,5,5
148889,10,903,29,1,1,0,0,52,83
113805,9,693,6,0,0,0,0,10,16
127870,10,917,3,0,0,0,0,4,7
108911,8,623,89,0,0,0,0,137,226
80113,11,214,7,0,0,0,0,7,14
69397,6,783,18,0,0,0,0,21,39
65397,4,453,1,0,0,0,0,0,1
128402,9,556,2,0,0,0,0,2,4
154965,9,556,2,0,0,0,0,2,4
32676,9,456,4,0,0,0,0,5,9
82923,11,214,8,2,0,0,0,12,22
59597,9,912,4,0,0,0,0,6,10
83266,11,214,7,0,0,0,0,10,17
124687,8,214,501,9,3,1,5,901,1420
113430,8,214,290,4,2,0,3,570,869
124467,11,306,4,0,0,0,0,2,6
92884,10,525,14,0,0,0,0,17,31
127197,9,341,10,0,0,0,0,20,30
164063,4,174,20,0,0,0,0,40,60
104518,8,403,5,0,0,0,0,8,13
164009,9,374,10,0,0,0,0,15,25
87725,9,374,2,0,0,0,0,3,5
81809,5,124,16,0,0,0,0,30,46
162726,4,679,25,1,0,0,0,38,64
117729,9,374,2,0,0,0,0,3,5
59199,9,374,8,0,0,0,0,9,17
93515,4,752,194,2,1,0,1,324,522
128712,11,30,17,1,0,0,0,19,37
83203,10,111,19,4,0,0,0,46,69
2709,8,214,157,0,0,0,0,264,421
8550,7,626,5,0,0,0,0,10,15
39480,5,375,106,9,4,0,1,156,276
9594,10,555,232,7,2,0,0,346,587
40025,11,658,2,0,0,0,0,2,4
109030,5,159,75,3,1,0,0,134,213
126087,10,322,12,0,0,0,1,18,31
100839,10,413,4,0,0,0,0,6,10
17242,8,800,967,39,13,1,7,1724,2751
157691,10,256,23,1,1,0,0,38,63
150200,8,214,150,0,0,0,0,275,425
88573,5,371,2,0,0,0,0,3,5
61435,9,158,43,1,1,0,0,53,98
55660,9,873,0,0,0,0,0,9,9
72248,9,873,8,0,0,0,0,12,20
130046,9,535,7,0,0,0,0,10,17
36815,9,535,4,0,0,0,0,5,9
162161,9,658,11,0,0,0,0,18,29
130384,10,66,9,0,0,0,0,17,26
79057,4,174,1598,19,10,0,6,3035,4668
129955,9,658,2,0,0,0,0,2,4
72243,9,658,8,0,0,0,0,11,19
33731,4,890,242,6,1,0,0,343,592
93760,9,658,4,0,0,0,0,5,9
10070,9,658,12,1,1,0,0,23,37
29294,9,658,4,0,0,0,0,9,13
17588,9,658,3,1,0,0,0,5,9
76813,9,658,17,1,1,0,0,21,40
120183,4,375,8,0,0,0,0,15,23
6084,4,519,30,0,0,0,0,54,84
74100,10,355,1,0,0,0,0,2,3
11900,8,658,10,0,0,0,0,13,23
121961,6,785,21,1,0,0,0,55,77
93368,10,66,2,0,0,0,0,3,5
65436,8,885,20,0,0,0,0,18,38
43642,9,472,10,0,0,0,0,10,20
26074,10,868,2,0,0,0,0,4,6
122280,6,785,14,0,0,0,0,20,34
59539,10,256,11,1,0,0,0,35,47
99298,10,355,1,0,0,0,0,2,3
46897,10,355,1,0,0,0,0,10,11
72975,11,214,6,0,0,0,0,8,14
30851,10,355,1,0,0,0,0,2,3
163052,7,214,4,0,0,0,0,5,9
90831,7,214,24,0,0,0,0,52,76
168660,5,159,86,2,1,0,0,117,206
143705,7,864,3,0,0,0,0,10,13
110688,7,374,2,0,0,0,0,3,5
102109,7,864,0,0,0,0,0,5,5
31732,7,254,6,0,0,0,0,13,19
54102,5,821,21,0,0,0,0,34,55
109819,7,228,9,0,0,0,0,15,24
58365,7,228,7,0,0,0,0,8,15
144586,6,479,67,1,2,1,0,113,184
21497,7,228,2,0,0,0,0,8,10
122128,7,488,2,0,0,0,1,5,8
35481,7,228,30,0,0,0,1,69,100
88856,10,111,6,0,0,0,0,18,24
112263,10,111,4,0,0,0,0,9,13
72151,7,896,7,0,0,0,0,12,19
143561,7,864,5,0,0,0,0,7,12
98596,5,404,226,1,1,0,2,358,588
45048,6,800,6,0,0,0,0,7,13
96172,9,380,1,0,0,0,0,6,7
3567,9,380,4,0,0,0,0,7,11
126086,8,623,337,5,0,0,0,538,880
142317,9,380,4,0,0,0,0,8,12
72681,11,214,0,3,0,0,0,0,3
41886,7,641,4,0,0,0,0,5,9
866,7,551,3,0,0,0,0,3,6
136554,7,551,9,0,0,0,0,10,19
33592,4,36,57,3,0,0,0,108,168
144006,8,623,200,0,0,0,0,269,469
96558,4,675,1787,38,16,2,22,2890,4755
60076,6,263,12,0,0,0,0,17,29
153220,10,781,1,0,0,0,0,2,3
38457,5,200,8,0,0,0,0,12,20
111548,5,218,110,6,2,0,0,161,279
87724,10,898,2,0,0,0,0,2,4
136995,9,472,6,0,0,0,0,12,18
124624,7,822,1,0,0,0,0,1,2
88190,11,214,1,0,0,0,0,0,1
159750,9,314,24,1,0,0,0,58,83
23332,10,868,3,0,0,0,0,4,7
29388,9,65,7,0,0,0,0,10,17
38779,7,578,26,0,0,0,0,29,55
58599,4,675,1863,40,18,6,10,3375,5312
76391,5,200,10,0,0,0,0,12,22
25532,4,159,103,6,5,0,1,179,294
60731,7,864,19,5,0,0,0,50,74
54871,10,617,3,0,0,0,0,3,6
33600,9,302,4,0,0,0,0,5,9
29537,9,302,11,0,0,0,0,14,25
162391,9,302,4,0,0,0,0,5,9
113194,9,302,1,0,0,0,0,2,3
38397,6,427,6,1,0,0,0,9,16
164991,9,302,1,0,0,0,0,2,3
127315,11,658,1,0,0,0,0,0,1
18131,11,658,1,0,0,0,0,0,1
74826,5,141,52,0,0,0,0,96,148
129849,9,302,3,0,0,0,0,8,11
38083,9,838,6,0,0,0,0,7,13
53303,11,812,8,1,0,0,0,4,13
45594,4,885,68,0,0,0,0,116,184
163848,9,693,5,0,0,0,0,6,11
163277,7,226,7,0,0,0,0,11,18
43859,9,399,2,0,0,0,0,2,4
72430,8,800,4,0,0,0,0,0,4
50869,8,800,2,0,0,0,0,0,2
57169,5,181,3,0,0,0,0,2,5
78986,8,214,516,3,1,0,2,759,1281
61866,4,199,2,0,0,0,0,5,7
107083,9,427,1,0,0,0,0,0,1
118571,10,66,4,0,0,0,0,11,15
121221,10,66,0,0,0,0,0,6,6
58529,7,263,10,0,0,0,0,15,25
23278,4,752,162,1,0,0,0,251,414
122340,10,178,4,1,0,0,0,4,9
129136,6,885,1,0,0,0,0,0,1
93008,5,821,1,0,0,0,0,2,3
118338,5,141,17,0,0,0,0,30,47
54078,9,117,11,0,0,0,0,21,32
131845,4,174,25,0,0,0,1,47,73
60904,6,453,115,0,0,0,1,174,290
154467,9,570,2,0,0,0,0,6,8
127872,10,722,7,0,0,0,0,13,20
41211,9,462,5,0,0,0,0,3,8
15697,4,800,6,0,0,0,0,5,11
1093,5,78,1,0,0,0,0,2,3
144639,9,640,1,0,0,0,0,0,1
2726,5,78,1,0,0,0,0,2,3
41857,11,489,8,0,0,0,0,19,27
21684,9,399,16,0,0,0,0,27,43
125697,9,819,4,0,0,0,0,5,9
28074,9,378,4,0,0,0,0,5,9
114916,9,158,2,0,0,0,0,2,4
131339,6,124,14,0,0,0,0,16,30
49994,9,399,2,0,0,0,0,2,4
223,6,200,29,0,0,0,0,42,71
42502,7,611,3,0,0,0,0,4,7
113486,8,214,435,12,3,0,0,708,1158
43963,6,585,35,0,0,0,0,48,83
71956,8,623,69,0,0,0,0,114,183
107879,4,800,3,0,0,0,0,7,10
98644,7,492,1,0,0,0,0,1,2
65528,9,6,1,0,0,0,0,1,2
23235,9,469,20,0,0,0,0,27,47
160208,8,800,532,26,6,2,3,912,1481
6486,8,800,1614,78,33,10,9,2842,4586
37946,8,214,4,0,0,0,0,6,10
43332,8,214,142,0,0,0,0,235,377
33188,10,799,8,0,0,0,0,13,21
15571,7,489,32,0,0,0,1,37,70
43653,4,375,1,0,0,0,0,0,1
147449,7,521,3,0,0,0,0,8,11
41242,11,812,4,0,0,0,0,4,8
111480,7,864,26,0,0,0,0,40,66
140454,9,570,2,0,0,0,0,2,4
90644,9,570,2,0,0,0,0,2,4
29902,9,570,3,0,0,0,0,4,7
18111,9,740,1,0,0,0,0,1,2
134132,9,597,5,0,0,0,0,3,8
73990,10,917,2,0,0,0,0,6,8
28077,10,917,2,0,0,0,0,3,5
104585,10,917,2,0,0,0,0,3,5
153486,5,159,13,1,0,0,0,24,38
92388,5,159,30,1,1,0,1,35,68
25887,5,159,12,0,0,0,0,14,26
40209,11,214,4,0,0,0,0,5,9
40547,6,232,2,0,0,0,0,3,5
142226,9,828,2,0,0,0,0,7,9
13070,9,828,2,0,0,0,0,2,4
37854,8,214,236,1,0,0,1,375,613
75643,9,828,1,0,0,0,0,1,2
92866,9,828,1,0,0,0,0,1,2
19536,9,828,2,0,0,0,0,2,4
104784,9,828,2,0,0,0,0,2,4
118849,9,828,1,0,0,0,0,2,3
100710,10,868,10,0,0,0,0,11,21
164074,10,781,2,0,0,0,0,3,5
92433,10,618,2,0,0,0,0,3,5
107454,10,868,2,0,0,0,0,5,7
130385,10,618,3,0,0,0,0,4,7
62569,7,100,25,0,0,0,0,32,57
137609,10,781,2,0,0,0,0,3,5
48522,8,214,14,0,0,0,0,20,34
106344,9,560,4,0,0,0,0,6,10
126229,7,542,12,0,0,0,0,13,25
40400,7,542,2,0,0,0,0,2,4
71603,8,693,2,0,0,0,0,4,6
161476,9,65,6,0,0,0,0,14,20
72954,9,838,2,0,0,0,0,3,5
135299,4,458,204,7,2,1,2,356,572
128248,7,587,347,5,2,1,0,465,820
51250,4,658,7,0,0,0,0,10,17
50721,8,214,20,0,0,0,0,34,54
30153,8,214,4,0,0,0,0,6,10
163041,11,214,14,0,0,0,0,13,27
68290,9,471,7,0,0,0,0,15,22
72858,9,367,5,0,0,0,0,15,20
36325,9,545,18,0,0,0,0,47,65
105450,8,489,1,0,0,0,0,0,1
41192,9,65,4,0,0,0,0,5,9
108103,5,489,43,0,0,0,0,53,96
165903,9,796,2,0,0,0,0,2,4
17328,9,838,6,0,0,0,0,4,10
129295,4,200,36,0,0,0,0,71,107
124028,11,623,4,0,0,0,0,3,7
75063,7,306,111,1,0,1,3,286,402
134402,7,228,9,0,0,0,0,12,21
29802,7,228,4,0,0,0,0,4,8
107797,7,228,6,1,1,0,0,12,20
12461,7,228,8,0,0,0,0,9,17
123048,11,214,11,0,0,0,0,7,18
107889,7,228,4,0,0,0,0,9,13
29628,9,658,2,0,0,0,0,2,4
29780,6,643,3,0,0,0,0,13,16
136339,9,43,1,0,0,0,0,1,2
31391,11,214,2,0,0,0,0,2,4
4849,11,427,4,3,0,0,0,7,14
114736,8,812,44,1,1,0,0,62,108
79138,6,78,90,0,0,0,0,168,258
134636,6,159,31,0,0,0,0,61,92
165018,9,367,3,0,0,0,0,5,8
84792,6,141,21,0,0,0,0,30,51
53439,7,379,2,0,0,0,0,2,4
66741,10,322,2,0,0,0,0,3,5
153642,10,917,6,0,0,0,0,6,12
95639,6,505,4,0,0,0,0,9,13
93336,9,484,12,0,0,0,0,14,26
147928,9,607,3,0,0,0,0,1,4
21387,7,484,6,0,0,0,0,11,17
168049,9,456,8,0,0,0,0,16,24
97972,4,200,6,0,0,0,0,10,16
153629,11,885,8,0,0,0,0,7,15
107373,7,611,2,0,0,0,0,3,5
158920,10,917,3,0,0,0,0,4,7
107978,9,589,8,0,0,0,0,3,11
154620,6,585,35,1,1,0,0,67,104
153844,9,315,24,0,0,0,0,32,56
138773,4,36,34,0,0,0,0,81,115
3083,7,885,9,0,0,0,0,15,24
73534,7,885,5,0,0,0,0,11,16
118772,4,752,1,0,0,0,0,2,3
135674,7,892,34,3,0,1,0,49,87
158096,7,484,4,0,0,0,0,7,11
69225,7,302,9,0,0,0,0,17,26
52241,7,822,10,0,0,0,0,8,18
157195,8,214,254,1,0,0,0,366,621
87738,8,214,102,0,0,0,0,160,262
559,11,306,4,0,0,0,0,5,9
168877,8,214,124,0,0,0,0,202,326
104840,9,314,30,1,1,0,0,60,92
81460,7,471,12,1,0,0,0,37,50
142133,9,314,8,0,0,0,0,13,21
105964,9,314,3,0,0,0,0,5,8
131361,10,917,4,0,0,0,0,11,15
104708,7,496,0,0,0,0,0,12,12
126525,9,145,10,0,0,0,0,14,24
108150,8,214,9,0,0,0,0,8,17
33274,10,523,12,0,0,0,1,20,33
156332,8,214,9,0,0,0,0,22,31
133764,9,314,2,0,0,0,0,3,5
40502,9,314,6,0,0,0,0,7,13
130575,6,159,125,3,1,0,1,188,318
62919,10,797,413,3,0,1,2,657,1076
6362,9,314,113,3,1,0,0,179,296
55344,7,79,8,0,0,0,0,11,19
162766,9,314,4,0,0,0,0,7,11
124684,10,355,2,0,0,0,0,4,6
53441,7,100,0,0,0,0,0,4,4
116320,8,209,2,0,0,0,0,2,4
132503,9,719,4,1,0,0,0,8,13
65978,5,225,24,1,1,0,0,40,66
128892,7,100,0,0,0,0,0,5,5
72129,7,100,0,0,0,0,0,4,4
97976,9,313,5,0,0,0,1,16,22
162910,9,538,1805,1,6,2,8,2739,4561
104795,9,630,27,0,0,0,0,29,56
92950,6,141,28,1,1,0,0,65,95
165165,10,550,4,0,0,0,0,6,10
162664,7,74,2,0,0,0,0,3,5
134135,10,550,12,1,1,0,0,19,33
58325,7,492,1,0,0,0,0,1,2
8516,9,910,10,0,0,0,0,12,22
129815,7,196,15,0,0,0,1,32,48
90079,7,196,4,0,0,0,0,5,9
145807,8,174,59,3,0,0,0,95,157
124453,5,159,17,0,0,0,0,28,45
124665,9,158,5,1,1,0,0,30,37
67398,5,561,36,0,0,0,0,66,102
109953,10,355,34,1,1,0,0,44,80
45607,10,917,2,0,0,0,0,4,6
71842,8,800,248,5,2,1,5,525,786
99678,7,312,7,0,0,0,0,8,15
166830,7,56,21,1,0,1,0,35,58
103187,9,374,8,0,0,0,0,15,23
142026,7,896,3,0,0,0,0,5,8
49377,9,360,4,0,1,0,0,26,31
33056,9,353,12,0,0,0,0,21,33
135890,7,202,20,0,0,0,0,19,39
68055,9,353,9,0,0,0,0,8,17
90943,9,203,22,1,0,0,1,40,64
72142,9,203,1,0,0,0,0,9,10
9645,9,838,4,0,0,0,0,6,10
147128,9,838,2,0,0,0,0,3,5
77004,9,838,2,0,0,0,0,3,5
52764,9,838,6,0,0,0,0,5,11
28543,9,622,4,0,0,0,0,5,9
93282,11,812,1,0,0,0,0,1,2
138870,9,302,2,0,0,0,0,4,6
87027,9,741,35,0,1,0,0,68,104
76987,9,469,6,0,0,0,0,11,17
12341,11,623,2,0,0,0,0,2,4
128099,8,812,24,0,0,0,0,54,78
14041,9,589,16,0,0,0,0,15,31
18321,9,243,3,0,0,0,0,8,11
25041,10,618,2,0,0,0,0,2,4
126758,9,8,4,0,0,0,0,5,9
169485,9,202,13,0,0,0,0,25,38
46120,9,8,0,0,0,0,0,5,5
119531,4,200,1,0,0,0,0,1,2
152454,8,214,2,0,0,0,0,2,4
45581,8,214,17,0,0,0,0,17,34
128252,9,203,1,0,0,0,0,0,1
87453,9,341,7,0,0,0,0,8,15
11934,9,796,1,0,0,0,0,3,4
63261,9,158,2,0,0,0,0,9,11
143769,9,487,48,0,0,0,0,46,94
85339,5,200,27,1,1,0,0,36,65
87836,4,885,291,3,2,0,2,531,829
82666,8,800,2,0,0,0,0,2,4
56768,9,570,4,0,0,0,0,6,10
83782,9,570,10,0,0,0,0,12,22
61645,9,570,3,0,0,0,0,8,11
62341,7,460,3,0,0,0,0,1,4
114390,11,214,2,0,0,0,0,1,3
164706,7,460,2,0,0,0,0,0,2
139359,9,302,67,2,2,0,0,376,447
13902,7,312,5,0,0,0,0,7,12
94686,8,214,9,0,0,0,0,10,19
143786,8,214,67,0,0,0,0,81,148
98703,4,453,6,0,0,0,0,6,12
166244,4,638,2,0,0,0,0,6,8
62706,7,214,25,0,0,0,0,41,66
98267,9,762,2,0,0,0,0,4,6
167609,11,214,4,0,0,0,0,8,12
91483,11,214,2,0,0,0,0,2,4
123012,5,489,93,1,0,0,0,165,259
124961,9,158,10,0,0,0,0,11,21
143267,5,489,24,1,0,0,0,44,69
115942,9,314,4,0,0,0,0,4,8
83446,9,909,4,0,0,0,0,3,7
148717,4,519,1,0,0,0,0,1,2
147568,8,214,5,0,0,0,0,4,9
104558,9,838,1,0,0,0,0,0,1
87929,9,838,1,0,0,0,0,0,1
23368,9,95,2,0,0,0,0,3,5
154247,9,243,4,0,0,0,0,4,8
37254,8,800,2420,68,17,6,25,4718,7254
32735,7,484,6,0,1,0,0,9,16
123847,5,489,62,0,0,0,0,104,166
12752,9,315,6,0,0,0,0,10,16
115649,9,575,2,0,0,0,0,2,4
155481,9,828,4,0,0,0,0,3,7
24214,8,214,4,0,0,0,0,4,8
24879,9,243,4,0,0,0,0,3,7
85609,9,556,5,0,0,0,1,10,16
10912,11,812,5,0,0,0,0,4,9
111720,7,896,10,1,1,0,0,16,28
148245,7,232,6,0,0,0,0,5,11
141633,5,106,32,0,0,0,0,54,86
165895,5,106,28,0,0,0,0,42,70
133828,7,30,6,1,1,0,0,30,38
19591,7,611,6,0,0,0,0,6,12
164175,11,489,2,0,0,0,0,2,4
98399,6,505,5,0,0,0,0,11,16
156003,9,630,2,0,0,0,0,0,2
13260,8,214,27,0,0,0,0,37,64
52739,11,403,2,0,0,0,0,0,2
121826,8,214,182,0,0,0,0,249,431
60877,9,95,2,0,0,0,0,3,5
97177,9,65,6,0,0,0,0,6,12
28111,10,322,2,0,0,0,0,3,5
141549,9,838,1,0,0,0,0,5,6
129735,5,479,1,0,0,0,0,6,7
105951,5,453,5,0,0,0,0,11,16
3594,7,295,4,0,0,0,0,7,11
166440,9,575,16,0,0,0,0,22,38
58753,6,585,10,0,0,0,0,17,27
136801,9,374,11,0,0,0,0,16,27
134688,10,22,9,0,0,0,0,13,22
13286,4,752,1,0,0,0,0,0,1
140721,7,864,5,0,0,0,0,35,40
149335,7,864,48,2,0,0,0,72,122
150047,7,864,2,0,0,0,0,16,18
132928,9,828,11,0,0,0,0,31,42
138178,9,158,3,0,0,0,0,16,19
155638,9,367,2,0,0,0,0,3,5
149482,4,885,471,2,1,0,4,888,1366
104652,10,653,29,0,0,0,1,78,108
2540,7,77,12,0,0,0,0,29,41
63145,9,462,2,0,0,0,0,15,17
54101,9,85,19,0,0,0,0,20,39
135822,8,214,20,0,0,0,1,53,74
163563,8,489,4,0,0,0,0,6,10
26479,10,66,5,0,0,0,0,8,13
112256,9,380,3,0,0,0,0,5,8
50908,9,157,1,0,0,0,0,0,1
84381,7,228,3,0,0,0,0,5,8
159618,7,228,0,0,0,0,0,4,4
150610,7,864,67,4,0,0,0,111,182
143474,7,196,2,0,0,0,0,3,5
28846,9,885,4,0,0,0,0,4,8
133373,9,885,2,0,0,0,0,2,4
101094,7,226,4,0,0,0,0,7,11
49698,7,77,3,0,0,0,0,5,8
82817,10,355,2,0,0,0,0,3,5
32074,6,141,12,0,0,0,0,23,35
136989,8,214,85,0,0,0,0,127,212
75180,4,658,8,0,0,0,0,14,22
19020,5,200,10,1,0,0,0,11,22
44649,4,375,1,0,0,0,0,0,1
57194,4,800,2,0,0,0,0,4,6
41128,7,521,4,0,0,0,0,7,11
7393,6,556,2,0,0,0,0,2,4
165969,11,658,20,0,0,0,0,21,41
146793,6,306,3,0,0,0,0,1,4
123885,6,585,10,0,0,0,0,15,25
54786,8,489,1,0,0,0,0,0,1
61010,10,322,2,0,0,0,0,3,5
84880,9,640,2,0,0,0,0,3,5
2899,9,597,3,0,0,0,0,6,9
117520,9,597,2,0,0,0,0,3,5
74426,5,783,66,2,0,1,2,111,182
135375,5,893,35,0,0,0,0,69,104
155764,6,718,3,0,0,0,0,3,6
127475,11,812,10,2,0,0,0,8,20
92721,9,367,22,0,0,0,0,38,60
156359,5,78,131,0,0,0,2,233,366
32978,9,885,10,0,0,0,0,22,32
1827,11,214,4,0,0,0,0,5,9
58895,9,117,5,0,0,0,0,12,17
87054,9,117,5,0,0,0,0,8,13
20002,9,117,1,0,0,0,0,1,2
55791,6,124,19,0,0,0,0,33,52
97381,4,174,20,0,0,0,0,31,51
127074,9,489,2,0,0,0,0,1,3
27328,9,158,8,0,0,0,0,10,18
112847,9,158,0,0,0,0,0,4,4
116977,4,174,112,0,1,0,1,233,347
6157,5,479,18,0,0,0,0,25,43
85960,9,4,13,0,0,0,0,7,20
64713,6,59,10,0,0,0,0,14,24
135729,8,545,28,0,0,0,1,51,80
44119,7,77,13,0,0,0,0,22,35
108344,10,781,3,0,0,0,0,4,7
11794,4,200,153,10,2,1,2,294,462
130281,8,885,2,0,0,0,0,0,2
92890,7,508,4,0,0,0,0,5,9
146650,8,214,306,1,1,0,1,448,757
71692,7,118,6,0,0,0,0,13,19
33521,7,149,28,0,0,0,0,45,73
55262,4,885,6,0,0,0,0,6,12
66450,9,374,8,1,0,0,1,13,23
90795,4,453,6,0,0,0,0,3,9
104568,9,374,21,0,0,0,1,28,50
99639,8,214,1,0,0,0,0,0,1
41925,6,514,4,0,0,0,0,7,11
152059,9,838,8,0,0,0,0,4,12
133082,9,838,8,0,0,0,0,6,14
164183,7,312,1,0,0,0,0,1,2
132403,10,66,9,0,0,0,0,11,20
66012,4,200,2,0,0,0,0,4,6
42763,4,159,2,0,0,0,0,4,6
7602,9,145,2,0,0,0,0,4,6
3580,9,145,42,1,1,0,0,121,165
53568,9,117,24,0,1,0,1,36,62
55170,9,575,11,0,0,0,0,16,27
9678,9,577,2,0,0,0,0,4,6
84852,7,214,57,1,1,0,0,122,181
155740,7,214,34,0,0,0,1,67,102
75002,7,611,5,0,0,0,0,10,15
91587,9,556,2,0,0,0,0,0,2
63676,5,78,1,0,0,0,0,0,1
85460,11,355,13,0,0,0,0,11,24
85331,7,611,4,0,0,0,0,7,11
113817,7,563,8,0,0,0,0,11,19
81113,7,214,52,0,0,0,0,133,185
12190,4,174,4,0,0,0,0,6,10
80132,4,174,2,0,0,0,0,3,5
121871,5,141,25,0,0,0,0,46,71
8746,7,737,2,0,0,0,0,4,6
69300,11,124,7,0,0,0,0,8,15
86280,9,632,4,0,0,0,0,17,21
31088,6,209,1,0,0,0,0,1,2
6900,7,737,8,0,0,1,0,13,22
49376,9,184,2,0,0,0,0,2,4
854,9,184,10,0,0,0,0,11,21
86562,9,184,2,0,0,0,0,2,4
76771,9,632,1,0,0,0,0,2,3
134848,10,628,22,1,0,0,0,51,74
24348,9,632,2,0,0,0,0,6,8
145867,9,632,1,0,0,0,0,1,2
118368,6,585,1,0,0,0,0,0,1
144711,10,917,10,0,0,0,0,16,26
97829,6,209,4,0,0,0,0,0,4
115142,9,838,4,0,0,0,0,7,11
171126,9,535,14,0,0,0,0,14,28
131340,9,158,2,0,0,0,0,2,4
126139,11,306,75,3,0,0,0,91,169
67035,10,289,33,1,0,0,0,45,79
112600,9,838,8,0,0,0,0,11,19
321,9,838,1,0,0,0,0,7,8
153231,9,838,2,0,0,0,0,5,7
152178,9,873,16,0,0,0,0,15,31
77502,9,657,41,0,0,0,0,75,116
50660,9,819,2,0,0,0,0,6,8
52234,8,306,1,0,0,0,0,0,1
102078,4,174,11,0,0,0,0,18,29
156763,6,882,1,0,0,0,0,1,2
142723,9,145,0,0,0,0,0,16,16
27975,9,145,0,0,0,0,0,3,3
144605,9,145,8,0,0,0,0,24,32
25158,9,145,0,0,0,0,0,3,3
160417,9,492,6,0,0,0,0,3,9
24278,9,145,0,0,0,0,0,3,3
142094,9,145,4,0,0,0,0,11,15
160167,9,145,4,0,0,0,0,15,19
47004,9,800,5,0,0,0,0,7,12
19140,9,253,2,0,0,0,0,3,5
78441,9,800,5,0,0,0,0,10,15
148988,7,748,4,0,0,0,0,3,7
89938,11,214,6,0,0,0,0,10,16
64189,10,790,8,0,0,0,0,8,16
170031,7,306,1,0,0,0,0,0,1
119542,9,489,22,0,0,0,0,35,57
38361,5,200,18,0,0,0,0,20,38
6239,4,200,4,0,0,0,0,6,10
168008,4,200,6,0,0,0,0,7,13
41456,9,380,5,0,0,0,0,13,18
33967,7,896,3,0,0,0,0,9,12
108761,9,657,13,1,1,0,0,28,43
160573,9,657,13,0,0,0,0,35,48
145838,9,657,4,0,0,0,0,9,13
45611,10,111,5,0,0,0,0,7,12
92729,6,141,90,1,0,0,0,154,245
80817,6,141,32,1,1,0,0,75,109
20441,6,141,16,0,0,0,0,27,43
72362,6,141,12,0,0,0,0,41,53
58794,8,124,1,0,0,0,0,2,3
116800,11,244,14,0,0,0,0,17,31
95010,11,812,7,1,0,0,0,10,18
76309,4,375,1,0,0,0,0,4,5
908,6,200,1,0,0,0,0,0,1
19526,6,200,14,0,0,0,0,18,32
54044,8,622,4,0,0,0,0,3,7
137875,9,43,2,0,0,0,0,4,6
87017,9,838,2,0,0,0,0,4,6
130657,9,302,5,0,0,0,0,13,18
36744,9,131,4,0,0,0,0,10,14
109992,9,375,10,0,0,0,0,15,25
82365,9,95,10,0,0,0,0,12,22
68145,9,456,2,0,0,0,0,4,6
162722,7,521,1,0,0,0,0,2,3
60031,9,131,44,2,2,0,2,73,123
62301,9,131,2,0,0,0,0,4,6
98143,9,782,4,0,0,0,0,4,8
111147,9,131,4,0,0,0,0,15,19
11897,9,243,2,0,0,0,0,5,7
1556,9,243,4,0,0,0,0,7,11
97818,7,748,2,0,0,0,0,4,6
120626,9,556,4,0,0,0,1,10,15
78557,8,623,14,0,0,0,0,15,29
57110,9,202,2,0,0,0,0,6,8
60097,9,202,2,0,0,0,1,6,9
43617,9,374,4,0,1,0,0,7,12
113407,9,374,4,0,0,0,0,7,11
74561,7,118,4,0,0,0,0,6,10
63409,7,306,53,0,0,0,0,141,194
170762,9,589,13,0,0,0,0,23,36
57716,6,269,2,0,0,0,0,11,13
149460,6,514,6,0,0,0,0,8,14
37758,7,641,12,0,0,0,0,20,32
118871,10,111,9,2,0,0,0,14,25
170804,10,111,4,0,0,0,0,5,9
4696,9,570,3,0,0,0,0,3,6
98081,9,302,6,0,0,0,0,9,15
167377,9,302,13,0,0,0,0,18,31
34863,11,812,4,0,0,0,0,6,10
118937,10,322,2,0,0,0,0,3,5
28353,10,111,13,1,1,0,0,19,34
5844,7,462,11,1,1,0,1,28,42
75459,7,462,7,0,0,0,0,29,36
119465,10,550,14,2,0,0,0,16,32
135045,10,111,3,0,0,0,0,11,14
95698,10,111,1,0,0,0,0,2,3
158226,7,157,12,2,0,0,0,22,36
15750,9,427,95,0,0,0,1,231,327
132886,6,106,4,0,0,0,1,7,12
152001,10,111,7,0,0,0,0,16,23
65428,8,214,214,3,1,0,0,330,548
121899,7,521,1,0,0,0,0,0,1
54376,11,214,4,0,0,0,0,4,8
86449,6,601,48,2,1,0,1,67,119
9297,4,678,14,0,0,0,0,14,28
145207,8,403,1,0,0,0,0,0,1
151030,10,903,0,0,0,0,0,5,5
123854,10,903,0,0,0,0,0,4,4
496,9,399,2,0,0,0,0,3,5
35769,10,413,0,0,0,0,0,5,5
95637,10,413,0,0,0,0,0,4,4
15892,10,413,0,0,0,0,0,5,5
142826,10,807,5,0,0,0,0,10,15
44892,5,821,17,0,0,0,0,37,54
155209,6,785,2,0,0,0,0,2,4
56079,4,885,2,0,0,0,0,0,2
61056,8,214,172,2,1,0,1,288,464
69316,9,78,2,0,0,0,0,0,2
51262,10,322,2,0,0,0,0,2,4
33151,11,489,40,2,0,0,0,47,89
42924,8,489,2,0,0,0,0,0,2
48711,5,225,9,0,0,0,0,14,23
123203,8,214,2,0,0,0,0,2,4
32615,8,214,387,4,2,0,2,635,1030
131852,9,157,2,0,0,0,0,0,2
48449,10,798,0,0,1,0,0,0,1
152717,8,403,82,0,0,0,0,128,210
101126,8,403,49,1,1,0,0,73,124
152828,9,175,4,0,0,0,0,5,9
47564,5,479,152,2,0,0,0,259,413
53177,4,800,1,0,0,0,0,0,1
3303,6,453,331,7,4,0,2,606,950
39380,5,225,2,0,0,0,0,1,3
103102,9,842,70,1,0,9,0,78,158
21543,8,403,179,1,1,0,0,267,448
23891,9,469,5,0,0,0,0,10,15
158451,5,141,18,0,0,0,0,31,49
119918,7,741,8,0,0,0,0,14,22
75204,9,631,2,0,0,0,0,3,5
106705,7,741,1,0,0,0,0,1,2
79035,8,800,1,0,0,0,0,2,3
76050,5,124,32,1,1,0,0,65,99
23074,9,630,62,1,1,0,0,101,165
146308,5,141,8,0,0,0,0,14,22
51463,8,214,2,0,0,0,0,3,5
35368,11,489,1,0,0,0,0,1,2
134818,6,885,193,5,4,0,0,302,504
120307,10,104,8,0,0,0,0,12,20
93477,10,322,9,0,0,0,0,9,18
159997,7,56,8,1,0,1,0,16,26
140440,8,885,2,0,0,0,0,0,2
127272,10,628,2,0,0,0,0,3,5
104004,7,56,28,0,0,0,0,65,93
41949,11,489,4,0,0,0,0,2,6
32455,4,36,10,0,0,0,0,21,31
157232,9,367,80,2,1,0,0,134,217
86600,4,800,12,0,0,0,0,7,19
91225,4,877,4,0,0,0,0,11,15
142467,7,56,6,0,0,0,0,8,14
55638,9,145,3,0,0,0,0,6,9
78846,9,838,3,0,0,0,0,5,8
67389,11,214,12,0,0,0,0,17,29
37773,9,838,1,0,0,0,0,1,2
127014,9,838,1,0,0,0,0,1,2
58747,4,36,1,0,0,0,0,0,1
111204,10,357,11,0,0,0,0,18,29
9991,8,30,3,0,0,0,0,4,7
23204,9,910,3,0,0,0,0,7,10
81701,7,864,26,0,0,0,0,51,77
6245,9,910,9,0,0,0,0,10,19
39663,4,200,25,1,0,0,0,35,61
32870,9,693,1,0,0,0,0,0,1
156653,9,380,1,0,0,0,1,2,4
156998,4,159,1,0,0,0,0,1,2
102786,9,380,3,0,0,0,0,5,8
31523,7,306,243,3,1,0,2,444,693
119887,8,800,5,0,0,0,0,20,25
7940,9,842,6,1,1,0,0,9,17
120097,9,487,2,0,0,0,0,4,6
143100,9,380,17,0,0,0,0,27,44
84494,5,404,1,0,0,0,0,1,2
98667,4,890,131,6,3,0,0,252,392
167628,9,4,4,0,0,0,0,14,18
46839,10,322,2,0,0,0,0,6,8
73221,9,405,5,0,0,0,0,12,17
152252,11,489,4,0,0,0,0,6,10
17959,6,200,1,0,0,0,0,0,1
97802,4,678,1,0,0,0,0,1,2
169145,9,405,1,0,0,0,0,1,2
3343,9,405,15,0,0,0,0,25,40
16466,9,405,8,1,1,0,0,37,47
130296,9,405,7,0,0,0,0,28,35
103091,7,611,3,0,0,0,0,15,18
153050,7,611,7,0,0,0,0,17,24
143765,9,405,4,0,0,0,0,6,10
28513,11,489,5,0,0,0,0,5,10
97448,9,405,4,0,0,0,0,14,18
30847,7,196,8,0,0,0,0,17,25
39933,6,141,4,0,0,0,0,10,14
60668,6,200,18,0,0,0,0,22,40
47272,8,693,20,0,0,0,1,28,49
18731,9,489,8,0,0,0,0,10,18
92882,10,29,10,0,0,0,0,17,27
2988,4,678,1,0,0,0,0,1,2
36119,11,403,1,0,0,0,0,2,3
41471,7,77,31,0,0,0,0,69,100
165141,11,812,8,3,0,0,0,9,20
79567,8,885,41,0,0,0,0,142,183
124145,9,302,2,0,0,0,0,7,9
91639,10,29,2,0,0,0,0,3,5
64602,9,838,8,0,0,0,0,13,21
93228,8,885,30,0,0,0,0,101,131
32532,9,147,3,0,0,0,0,7,10
5486,9,873,2,0,0,0,0,4,6
91936,11,885,7,0,0,0,0,13,20
10412,5,479,351,7,4,0,3,522,887
70572,8,489,6,0,0,0,0,13,19
24194,4,220,2,0,0,0,0,0,2
99271,10,807,14,0,0,0,0,24,38
151434,10,807,4,0,0,0,0,5,9
147643,7,521,3,0,0,0,0,5,8
95162,4,885,152,0,0,0,0,235,387
63115,7,367,17,1,1,0,0,11,30
34153,7,551,5,0,0,2,0,3,10
25888,7,306,1,1,0,0,0,0,2
65648,7,118,2,0,0,0,0,1,3
75992,7,118,1,0,0,0,0,0,1
106162,9,535,2,0,0,0,0,3,5
24656,9,535,6,0,0,0,0,9,15
93405,10,549,18,0,0,0,0,41,59
87199,10,549,1,0,0,0,0,7,8
52502,10,549,6,0,0,0,0,15,21
88986,6,235,10,0,0,0,0,16,26
363,7,263,8,0,0,0,0,14,22
143082,5,140,6,0,0,0,0,5,11
32539,10,917,3,0,0,0,0,5,8
66023,6,290,25,2,0,2,0,58,87
50208,5,263,50,0,0,0,1,100,151
103595,10,63,7,0,0,0,0,11,18
150579,9,472,4,0,0,0,0,3,7
65746,11,306,5,0,0,0,0,9,14
55805,9,380,33,0,0,0,0,57,90
32408,9,380,2,0,0,0,0,4,6
118032,11,403,0,1,0,0,0,0,1
41826,7,374,6,0,0,0,0,11,17
118733,10,841,5,0,0,0,0,12,17
148482,8,885,1,0,0,0,0,2,3
83115,8,623,7,0,0,0,0,13,20
25973,4,174,11,0,0,0,0,3,14
111874,10,474,2,0,0,0,0,0,2
127327,10,917,14,1,1,0,0,27,43
167333,6,453,22,0,0,0,0,26,48
54686,4,658,397,4,2,1,1,793,1198
58388,8,214,317,6,3,0,2,549,877
121347,8,214,3,0,0,0,0,3,6
62084,9,640,10,0,0,0,0,8,18
35307,8,174,60,0,0,0,0,94,154
81958,10,357,16,1,0,0,0,19,36
44142,9,556,4,0,0,0,0,4,8
30481,10,66,1,0,0,0,0,2,3
67976,10,66,1,0,0,0,0,0,1
114111,4,453,27,0,0,0,0,40,67
165764,9,100,0,1,0,0,0,0,1
114422,9,145,0,0,0,0,0,4,4
4061,9,145,2,0,0,0,0,5,7
20563,9,145,2,0,0,0,0,3,5
15394,5,821,83,0,0,0,0,140,223
123420,4,752,556,6,2,0,1,946,1511
170127,9,302,1,0,0,0,0,2,3
6117,9,828,2,0,0,0,0,2,4
88359,4,159,4,0,0,0,0,6,10
89550,7,587,315,3,1,0,2,464,785
5168,5,821,17,0,1,0,0,26,44
150115,9,117,2,1,1,0,0,4,8
88598,8,214,1,0,0,0,0,0,1
91088,7,611,4,0,0,0,0,5,9
136070,5,200,16,0,0,0,1,27,44
111644,4,174,4,0,0,0,0,7,11
126013,5,200,26,1,1,0,0,55,83
112776,9,657,3,0,0,0,0,4,7
31008,8,214,209,11,6,1,1,372,600
123600,11,214,2,0,0,0,0,3,5
57442,11,306,15,4,0,0,0,17,36
43322,5,78,14,0,0,0,0,19,33
142193,7,126,4,0,0,0,0,8,12
47188,8,124,8,0,0,0,0,14,22
81446,9,570,2,0,0,0,0,3,5
116551,7,126,4,0,0,0,0,3,7
38314,11,214,5,0,0,0,0,4,9
59255,11,812,2,0,0,0,0,2,4
69332,11,403,32,0,0,0,0,39,71
2499,6,290,10,0,0,0,0,14,24
99104,9,452,2,0,0,0,0,4,6
15544,8,623,2,0,0,0,0,1,3
56467,10,628,13,0,0,0,0,43,56
81240,7,660,7,0,0,0,0,14,21
96440,9,577,4,0,0,0,0,8,12
169072,10,831,5,0,0,0,0,11,16
106437,9,657,6,1,0,0,0,16,23
165925,9,657,18,0,0,0,0,31,49
166286,9,380,4,0,0,0,0,4,8
36245,9,313,14,0,0,0,0,15,29
128126,9,313,4,0,0,0,0,5,9
2126,10,322,4,0,0,0,0,5,9
90403,9,147,2,0,0,0,0,2,4
7231,9,640,4,0,0,0,0,5,9
22185,9,46,76,4,0,1,0,150,231
153298,11,214,5,0,0,0,0,2,7
116493,7,864,4,0,0,0,0,7,11
91275,9,828,2,0,0,0,0,5,7
106290,8,214,36,0,0,0,0,112,148
163363,5,821,50,0,0,0,0,83,133
54406,9,175,7,0,0,1,0,12,20
121097,8,489,2,0,0,0,0,2,4
21195,10,917,3,2,2,0,0,4,11
98368,8,693,1,0,0,0,0,2,3
171048,7,755,4,0,0,0,0,6,10
115785,9,538,18,0,0,0,1,32,51
137859,4,220,3,0,0,0,0,0,3
148675,7,306,1,0,0,0,0,1,2
145050,9,885,4,0,0,0,0,8,12
91126,4,752,26,0,0,0,0,36,62
147939,6,375,1,0,0,0,0,1,2
170179,8,214,195,0,0,0,0,300,495
147654,8,214,313,3,1,0,0,497,814
139010,4,675,1,0,0,0,0,1,2
120666,9,622,2,0,0,0,0,2,4
125289,6,785,34,2,2,0,0,75,113
140040,6,290,1,0,0,0,0,1,2
81165,7,118,7,0,0,0,0,10,17
87593,7,118,9,0,0,0,0,17,26
103336,7,118,5,0,0,0,0,8,13
104726,6,570,0,0,0,0,0,5,5
110160,10,798,8,0,0,0,0,9,17
32477,8,88,3,0,0,0,0,4,7
43908,7,100,27,0,0,3,0,47,77
165606,9,800,4,0,0,0,0,3,7
37607,9,456,4,0,0,0,0,5,9
119756,6,453,10,0,0,0,0,21,31
71033,7,744,5,0,0,0,0,9,14
165956,6,601,16,1,0,0,0,30,47
23151,7,744,3,0,0,0,0,0,3
90503,7,306,253,4,2,0,2,447,708
52904,7,611,2,0,0,0,0,3,5
146211,6,514,9,0,0,0,0,19,28
86171,9,873,2,0,0,0,0,4,6
46089,9,429,19,0,0,0,1,34,54
104684,7,542,2,0,0,0,0,2,4
74329,7,542,2,0,0,0,0,2,4
139619,9,819,48,1,0,1,0,40,90
52182,9,575,11,1,1,0,0,21,34
151404,10,178,2,0,0,0,0,3,5
106233,7,306,4,0,0,0,0,3,7
42217,10,841,1,0,0,0,0,1,2
75293,8,214,98,0,0,0,0,156,254
124844,7,384,7,0,0,0,0,11,18
118904,4,174,1,0,0,0,0,4,5
165848,6,800,22,0,0,0,1,40,63
18748,10,66,8,0,0,0,0,8,16
5707,9,313,14,0,0,0,0,14,28
141928,11,214,4,0,0,0,0,5,9
91238,9,313,5,0,0,0,0,6,11
126773,7,641,14,0,0,0,0,19,33
91422,9,912,0,0,0,0,0,22,22
109042,8,545,4,0,0,0,0,0,4
114954,9,216,14,0,0,0,0,25,39
136875,5,78,1,0,0,0,0,0,1
98204,9,622,2,0,0,0,0,2,4
11949,11,658,27,1,0,0,0,34,62
14488,7,492,1,0,0,0,0,3,4
130086,6,453,16,3,1,0,0,19,39
124234,7,611,2,0,0,0,0,6,8
141133,11,306,29,1,0,0,0,38,68
53566,7,216,44,0,0,3,0,45,92
93788,9,800,2,0,0,0,0,3,5
90110,9,800,1,0,0,0,0,2,3
94765,9,800,1,0,0,0,0,1,2
16118,11,489,2,0,0,0,0,1,3
16300,9,86,19,8,4,0,0,61,92
79278,9,800,12,0,0,0,0,19,31
103602,7,306,104,0,0,0,1,157,262
50097,9,427,111,0,0,0,2,267,380
148836,8,124,2,0,0,0,0,2,4
55263,10,63,5,0,0,0,0,6,11
95368,8,214,1,0,0,0,0,0,1
157047,5,200,31,1,0,0,0,41,73
6641,6,514,14,0,0,0,0,31,45
98731,4,885,2,0,0,0,0,6,8
141495,8,174,58,5,5,0,0,89,157
126727,9,374,40,0,0,0,0,83,123
21840,8,489,1,0,0,0,0,0,1
39028,10,36,2,0,0,0,0,1,3
16673,6,922,1,0,0,0,0,3,4
101977,9,538,5,0,0,0,0,7,12
163584,5,78,3,0,0,0,0,9,12
97269,5,556,1,0,0,0,0,1,2
123579,9,131,16,0,0,0,0,22,38
32233,8,214,698,11,4,0,15,1227,1955
81027,5,821,5,0,0,0,0,8,13
9621,8,214,70,0,0,0,0,111,181
122754,10,322,2,0,0,0,0,3,5
107964,5,821,1,0,0,0,0,1,2
156609,7,254,47,2,1,0,0,75,125
124883,7,484,5,0,0,0,0,24,29
44939,5,479,104,0,0,0,0,193,297
55835,10,628,16,0,0,0,0,29,45
18536,10,66,12,0,0,0,0,24,36
101934,4,658,3,0,0,0,0,1,4
127360,9,622,0,0,0,0,0,9,9
169309,9,622,0,0,0,0,0,12,12
49478,6,489,644,18,12,1,4,1237,1916
36247,4,159,24,0,0,0,0,39,63
2803,10,743,1,0,0,0,0,0,1
130468,4,199,3,0,0,0,0,3,6
137575,9,313,0,0,0,0,0,5,5
161337,9,622,42,0,0,0,0,71,113
129516,9,266,1,0,0,0,0,1,2
20540,9,202,8,0,0,0,0,16,24
10684,9,341,6,0,0,0,1,8,15
62915,7,202,2,0,0,0,0,2,4
37554,9,630,3,0,0,0,0,2,5
47202,10,413,4,0,0,0,0,7,11
90497,10,413,12,0,0,0,0,9,21
41957,9,589,38,0,0,0,0,49,87
26923,7,611,2,0,0,0,0,2,4
112171,9,6,2,0,0,0,0,2,4
66061,9,838,2,0,0,0,0,7,9
150886,8,489,36,0,0,0,1,60,97
2893,9,570,4,0,0,0,0,14,18
33083,8,489,67,0,0,0,1,114,182
117432,9,203,2,0,0,0,0,7,9
63721,8,214,319,7,1,2,1,531,861
67047,9,313,0,0,0,0,0,22,22
15711,9,243,4,0,0,0,0,11,15
41336,9,313,7,0,0,0,0,9,16
97193,9,313,0,0,0,0,0,3,3
124362,9,607,157,0,0,30,0,252,439
72399,9,607,157,0,0,30,0,273,460
77079,9,607,83,0,0,30,0,134,247
59286,5,893,26,0,0,0,0,55,81
48009,4,159,14,0,0,0,0,18,32
156880,9,487,2,0,0,0,0,2,4
11524,10,653,26,2,1,0,1,54,84
167477,9,131,21,1,0,0,0,33,55
48874,11,214,3,0,0,0,0,3,6
62731,9,538,24,0,0,0,0,37,61
27600,11,214,21,1,0,0,0,14,36
14979,10,797,88,2,2,0,2,136,230
38774,9,353,0,0,0,0,0,1,1
142002,10,820,2,0,0,0,0,3,5
94413,9,457,2,0,0,0,0,4,6
116330,9,6,1,0,0,0,0,2,3
103076,9,6,5,0,0,0,2,13,20
94910,10,618,2,0,0,0,0,6,8
92861,9,873,1,0,0,0,0,6,7
168468,9,873,6,0,0,0,0,7,13
166255,9,873,1,0,0,0,0,0,1
169842,9,873,3,0,0,0,0,5,8
4891,9,4,22,0,0,0,0,30,52
103504,9,873,1,0,0,0,0,2,3
121277,9,796,1,0,0,0,0,2,3
119370,9,632,1,0,0,0,0,4,5
140576,9,632,1,0,0,0,0,0,1
115385,8,623,23,0,0,0,0,37,60
161409,10,831,16,0,0,0,0,30,46
51078,5,159,9,0,0,0,0,9,18
117669,7,611,2,0,0,0,0,2,4
133618,7,78,12,0,0,0,0,23,35
48178,7,312,2,0,0,0,0,4,6
26293,5,106,4,0,0,0,0,6,10
148277,6,221,11,0,0,0,0,16,27
43304,11,306,11,0,0,0,0,9,20
145823,7,611,2,0,0,0,0,3,5
48712,7,74,3,0,0,0,0,5,8
23398,10,66,6,0,0,0,0,17,23
169067,11,214,22,1,0,0,0,30,53
101786,9,819,3,0,0,0,0,10,13
18,8,306,2,0,0,0,0,2,4
2182,8,306,2,0,0,0,0,2,4
60582,4,200,24,0,0,0,0,25,49
93377,8,623,4,0,0,0,0,0,4
68797,8,623,4,0,0,0,0,0,4
30169,10,621,6,0,0,0,0,8,14
170881,4,659,3,0,0,0,0,9,12
61997,8,623,1,0,0,0,0,1,2
14636,10,66,1,0,0,0,0,1,2
136287,9,145,0,0,0,0,0,36,36
135049,9,145,16,0,0,0,0,35,51
137195,9,145,0,0,0,0,0,36,36
156089,9,145,0,1,1,0,0,11,13
6679,9,145,0,0,0,0,0,12,12
108558,9,145,6,0,0,0,0,24,30
70388,9,145,8,2,1,0,0,29,40
77661,6,514,8,0,0,0,0,55,63
62322,5,200,1,0,0,0,0,0,1
136026,4,675,4,0,0,0,0,8,12
78380,4,375,4,0,0,0,0,6,10
159457,11,800,0,1,0,0,0,0,1
76114,7,611,10,0,0,0,0,13,23
10200,7,312,2,0,0,0,0,3,5
105981,9,575,2,0,0,0,0,1,3
103703,9,457,6,0,0,0,0,4,10
111752,4,453,5,0,0,0,0,12,17
148965,10,208,2,0,0,0,0,6,8
153933,4,923,5,2,1,0,0,41,49
146778,5,200,309,2,0,1,1,469,782
85741,9,374,4,0,0,0,0,6,10
15417,9,100,2,0,0,0,0,3,5
154028,7,226,12,0,0,0,0,24,36
70459,6,232,18,2,2,0,0,42,64
87208,7,226,2,0,0,0,0,0,2
60376,7,484,2,0,0,0,0,2,4
111360,7,484,2,0,0,0,0,2,4
22471,7,74,2,0,0,0,0,2,4
131858,7,492,2,0,0,0,0,2,4
51493,8,623,1,0,0,0,0,0,1
24547,8,214,1,0,0,0,0,0,1
11965,8,214,1,0,0,0,0,0,1
42177,8,214,1,0,0,0,0,0,1
123524,8,214,1,0,0,0,0,0,1
127915,8,30,1,0,0,0,0,2,3
148634,8,124,1,0,0,0,0,1,2
91407,9,842,119,1,0,2,0,173,295
158195,8,545,6,0,0,0,0,4,10
167668,10,820,1,0,0,0,0,2,3
107363,10,820,1,0,0,0,0,1,2
7411,8,545,1,0,0,0,0,2,3
99041,8,489,1,0,0,0,0,0,1
34029,7,611,2,0,0,0,0,3,5
95898,4,691,1,0,0,0,0,1,2
115392,7,228,9,0,0,0,0,11,20
86483,9,46,20,1,1,0,0,34,56
20926,9,46,4,0,0,0,0,9,13
94333,9,100,3,0,0,0,0,4,7
158199,7,61,28,0,0,0,0,59,87
83215,8,124,4,0,0,0,0,6,10
70133,10,841,17,0,0,0,0,35,52
104846,10,841,40,0,0,0,0,43,83
130421,10,208,2,0,0,0,0,4,6
100913,10,322,2,0,0,0,0,2,4
121777,5,124,34,1,1,0,1,48,85
21290,9,570,2,0,0,0,0,3,5
81759,10,523,14,0,0,0,0,35,49
44591,9,912,1,0,0,0,0,1,2
6261,10,66,2,0,0,0,0,3,5
12310,10,413,0,0,0,0,0,5,5
19571,10,413,2,0,0,0,0,4,6
120485,10,781,8,0,0,0,0,11,19
13492,5,218,47,1,0,0,0,87,135
114889,10,799,2,1,0,0,0,4,7
55001,6,117,9,0,0,0,0,14,23
74205,9,469,1,0,0,0,0,2,3
12688,9,469,2,0,0,0,0,5,7
118630,6,570,320,23,9,1,3,597,953
108872,7,492,1,0,0,0,0,3,4
146247,9,302,24,0,0,0,0,36,60
48269,9,306,2,0,0,0,0,3,5
80407,8,658,12,0,0,0,0,0,12
32811,10,831,10,0,0,0,0,14,24
92398,10,628,5,0,0,0,0,8,13
146973,9,78,1,0,0,0,0,0,1
32057,9,457,0,0,0,0,0,1,1
112366,9,302,49,3,1,0,1,65,119
67098,9,457,0,0,0,0,0,2,2
11805,11,214,16,0,0,0,0,22,38
90445,9,65,4,0,0,0,0,6,10
100653,9,65,3,0,0,0,0,6,9
45080,9,405,4,0,0,0,0,2,6
16889,5,124,26,4,2,0,0,34,66
93934,9,85,2,0,0,0,0,3,5
108204,7,100,0,0,0,0,0,44,44
81609,4,137,3,0,0,0,0,2,5
150141,4,137,2,0,0,0,0,4,6
132214,5,124,2,0,0,0,0,0,2
13571,8,306,1,0,0,0,0,0,1
66230,7,755,2,0,0,0,0,3,5
35678,7,285,2,0,0,0,0,0,2
101281,7,484,18,1,0,0,0,28,47
140753,9,100,3,0,0,0,0,5,8
123779,11,214,211,0,0,0,0,256,467
131242,6,141,26,0,0,0,0,57,83
155054,11,214,33,0,0,0,0,45,78
158550,6,821,5,0,0,0,1,12,18
98376,4,885,4,0,0,0,0,7,11
54474,9,630,75,0,0,0,0,213,288
147677,10,60,1,0,0,0,0,1,2
22463,9,912,0,0,0,0,0,11,11
7461,9,912,0,0,0,0,0,10,10
129976,9,632,1,0,0,0,0,2,3
54354,9,632,5,1,1,0,0,20,27
205,6,165,2,0,0,0,0,4,6
133573,9,873,0,0,0,0,0,18,18
101276,9,632,1,0,0,0,0,2,3
785,9,873,0,0,0,0,0,9,9
103276,9,632,1,0,0,0,0,2,3
11655,4,453,1,0,0,0,0,2,3
82372,9,632,1,0,0,0,0,2,3
47908,9,632,1,0,0,0,0,2,3
100871,9,632,1,0,0,0,0,2,3
119340,9,632,3,0,0,0,0,6,9
63630,9,632,7,2,1,0,0,15,25
161828,9,632,2,0,0,0,0,5,7
94657,9,469,10,1,0,0,0,32,43
27063,8,717,1,0,0,0,0,0,1
111218,9,360,2,0,0,0,0,7,9
57932,9,570,10,0,0,0,0,14,24
97559,9,313,13,0,0,0,0,25,38
65931,10,917,1,0,0,0,0,12,13
100689,10,917,3,1,0,1,0,16,21
131604,9,243,8,0,0,0,1,16,25
11149,9,360,6,0,0,0,0,20,26
60066,9,360,28,1,1,0,1,52,83
53271,9,360,4,0,0,0,0,10,14
118360,9,360,2,0,0,0,0,4,6
78959,9,360,0,0,0,0,0,5,5
98930,10,903,1,0,0,0,0,4,5
58263,10,903,6,0,0,0,0,8,14
9544,10,903,1,0,0,0,0,4,5
137642,10,903,2,0,0,0,0,11,13
161792,8,403,942,55,12,1,9,1603,2622
36519,4,885,6,0,0,0,0,9,15
147119,4,638,0,1,0,0,0,0,1
120125,9,302,6,0,0,0,0,9,15
124101,9,302,3,0,0,0,0,3,6
158173,6,141,12,0,0,0,0,24,36
18340,6,124,10,0,0,0,0,17,27
99801,10,653,31,0,0,0,0,58,89
85771,4,923,36,2,1,0,0,113,152
96118,11,306,1,0,0,0,0,0,1
77711,9,622,6,0,0,0,0,6,12
136663,10,104,1,0,0,0,0,2,3
166776,10,692,0,0,0,0,0,35,35
164950,10,898,6,0,0,0,0,6,12
119494,9,630,3,0,0,0,0,1,4
91408,9,622,4,0,0,0,0,5,9
149249,5,124,29,0,0,0,0,54,83
120155,5,124,50,1,0,0,0,104,155
142642,9,693,5,0,0,0,0,6,11
102181,9,874,4,0,0,0,0,7,11
642,9,107,4,0,0,0,0,6,10
70409,9,405,8,0,0,0,0,19,27
124070,5,124,26,0,0,0,0,44,70
153387,9,405,2,0,0,0,0,3,5
120196,5,124,18,0,0,0,0,31,49
131716,9,819,5,0,0,0,0,14,19
100886,9,819,5,0,0,0,0,19,24
82060,7,521,2,0,0,0,0,2,4
25742,7,521,2,0,0,0,0,2,4
49935,10,355,10,0,0,0,0,16,26
148494,7,521,6,0,0,0,0,10,16
126833,6,78,48,1,0,0,1,80,130
126717,10,653,1,0,0,0,0,0,1
127614,9,65,2,0,0,0,0,3,5
79795,10,357,4,0,0,0,0,6,10
86678,7,207,1,0,0,0,0,3,4
34248,7,207,1,0,0,0,0,0,1
34397,9,107,3,0,0,0,0,6,9
1447,6,200,20,0,0,0,0,46,66
125044,7,126,12,2,0,0,0,23,37
71757,9,79,12,0,0,0,0,26,38
24282,9,341,0,0,0,0,0,5,5
104532,4,800,7,0,0,0,0,10,17
3721,11,623,4,0,0,0,0,2,6
115032,9,65,2,0,0,0,0,4,6
136986,9,65,0,0,0,0,0,5,5
112145,9,65,0,0,0,0,0,5,5
105451,9,65,1,0,0,0,0,7,8
162677,9,65,4,0,0,0,0,8,12
44583,9,575,2,0,0,0,0,3,5
74658,10,29,2,0,0,0,0,3,5
88546,10,111,22,1,0,0,0,50,73
105327,7,196,2,0,0,0,0,12,14
67346,4,780,1,0,0,0,0,0,1
20309,10,820,4,0,0,0,0,21,25
14232,10,716,12,0,0,0,0,20,32
66999,10,841,5,0,0,0,0,11,16
64819,10,914,14,0,0,0,0,22,36
140602,8,596,314,5,2,2,3,575,901
103443,4,658,2,0,0,0,0,2,4
17961,10,523,8,0,0,0,0,26,34
81479,10,523,3,0,0,0,0,26,29
146873,4,200,4,0,0,0,0,8,12
46857,11,214,2,0,0,0,0,3,5
132258,9,379,111,0,0,0,1,177,289
101840,7,196,40,0,0,1,0,138,179
50372,10,610,1,0,0,0,0,1,2
137891,8,214,1,0,0,0,0,1,2
65151,10,628,4,0,0,0,0,7,11
120164,4,200,115,2,1,1,0,241,360
43342,10,66,4,0,0,0,0,5,9
51847,10,799,2,0,0,0,0,3,5
80447,9,630,201,0,0,0,0,546,747
49177,10,66,32,2,0,1,0,40,75
83282,9,145,2,0,0,0,0,4,6
125156,9,302,3,0,0,0,0,16,19
98116,9,302,9,0,0,0,0,17,26
98079,7,755,6,0,0,0,1,17,24
133666,7,611,8,0,0,0,0,6,14
8381,8,214,4,0,0,0,0,0,4
57151,9,145,8,0,0,0,0,17,25
87354,8,214,2,0,0,0,0,2,4
19904,7,196,7,0,0,0,0,6,13
123163,8,214,339,4,0,0,1,590,934
106255,7,611,4,0,0,0,0,4,8
123010,9,374,15,0,0,0,1,29,45
156697,10,797,25,0,0,0,0,55,80
92524,8,596,312,8,4,0,3,658,985
152744,9,86,19,0,0,0,0,53,72
15118,9,631,1,0,0,0,0,1,2
122745,8,800,323,2,2,0,3,633,963
87228,5,821,14,0,0,0,0,25,39
118339,7,196,1,0,0,0,0,7,8
152788,7,587,1,0,0,0,0,5,6
155358,9,85,4,0,0,0,0,4,8
60564,7,611,2,0,0,0,0,3,5
14492,6,141,2,0,0,0,0,4,6
66271,5,375,5,0,0,0,0,5,10
107276,10,798,2,0,0,0,0,2,4
132371,10,798,2,0,0,0,0,2,4
113412,9,184,9,0,0,0,0,13,22
157191,6,30,2,0,0,0,0,1,3
141576,5,371,2,0,0,0,0,4,6
138170,4,365,7,0,0,0,0,7,14
42189,8,658,2,0,0,0,0,4,6
137579,10,781,6,0,0,0,0,6,12
15178,11,214,8,0,0,0,0,8,16
22370,6,78,38,0,0,0,0,65,103
154399,11,214,3,0,0,0,0,2,5
139636,7,578,2,0,0,0,0,3,5
138419,8,244,1,0,0,0,0,1,2
18374,5,124,4,0,0,0,0,9,13
132693,8,658,2,0,0,0,0,0,2
89321,4,678,3,0,0,0,0,2,5
84192,4,658,23,0,0,0,0,34,57
77681,7,669,6,0,0,0,0,13,19
139419,7,196,7,0,0,0,0,12,19
166568,7,196,3,0,0,0,0,13,16
4156,7,295,3,0,0,0,0,4,7
4723,8,545,2489,69,19,2,14,4167,6760
91009,9,693,2,0,0,0,0,2,4
146249,11,800,14,1,0,0,0,10,25
101771,9,314,8,0,0,0,0,16,24
157116,5,263,421,12,5,0,4,747,1189
167350,10,555,1,0,0,0,0,4,5
96152,6,420,46,1,1,0,0,85,133
21445,10,555,1,0,0,0,0,0,1
102014,10,628,6,0,0,0,0,7,13
50016,4,679,21,0,0,0,0,49,70
85483,9,151,0,0,0,0,0,22,22
145710,9,151,1,0,0,0,0,6,7
136968,6,200,10,0,0,0,0,15,25
161681,9,360,3,0,0,0,0,5,8
105518,9,360,2,0,0,0,0,5,7
155603,9,360,4,0,0,0,0,7,11
165005,9,360,4,0,0,0,0,7,11
143997,7,228,13,0,0,0,0,21,34
170749,9,909,4,0,0,0,0,7,11
129580,9,65,11,0,0,0,0,13,24
53191,10,618,10,0,0,0,0,26,36
6393,8,403,53,0,0,0,0,112,165
69060,8,403,180,3,1,0,0,349,533
79948,10,618,4,0,0,0,0,6,10
128936,10,618,9,0,0,0,0,20,29
154917,10,618,2,0,0,0,0,3,5
85165,9,367,2,0,0,0,0,2,4
16115,11,489,2,0,0,0,0,2,4
119807,9,484,0,0,0,0,0,15,15
71409,9,706,6,1,1,0,0,17,25
147693,9,706,16,1,0,0,0,39,56
80963,9,706,60,2,1,0,0,128,191
1540,9,706,102,0,0,0,1,154,257
36917,9,706,28,2,1,0,0,66,97
101580,9,706,0,0,0,0,0,11,11
34375,9,706,0,0,0,0,0,8,8
92337,9,706,3,0,0,0,0,23,26
131740,9,693,6,0,0,0,0,12,18
106608,10,178,6,0,0,0,0,9,15
58916,5,489,2,0,0,0,0,2,4
151332,7,175,1,0,0,0,0,2,3
23945,9,131,7,1,1,0,0,15,24
31924,9,131,28,3,0,0,0,41,72
21417,4,200,10,0,0,0,0,14,24
133671,9,131,3,0,0,0,0,5,8
163923,9,693,1,0,0,0,0,3,4
3829,9,243,2,0,0,0,0,3,5
153336,9,243,2,0,0,0,0,7,9
64441,10,63,1,0,0,0,0,1,2
153734,6,885,1,0,0,0,0,0,1
51105,8,124,13,0,0,0,0,16,29
63394,9,158,6,0,0,0,0,5,11
37326,9,158,2,0,0,0,0,2,4
72073,8,403,2369,116,48,10,10,4221,6774
66608,9,874,2,0,0,0,0,4,6
156970,4,159,1,0,0,0,0,1,2
40721,9,367,85,14,11,1,0,57,168
169120,8,545,172,5,3,0,0,287,467
48468,5,800,1,0,0,0,0,2,3
59169,5,306,22,0,0,0,0,54,76
97242,10,66,0,0,0,0,0,7,7
53933,10,628,4,0,0,0,0,10,14
73185,10,917,1,0,0,0,0,1,2
152139,8,214,25,0,0,0,0,39,64
109017,9,427,46,0,0,0,1,122,169
118929,4,658,15,0,0,0,0,30,45
119318,11,214,5,0,0,0,0,5,10
95767,8,214,26,0,0,0,0,77,103
25628,7,157,1,0,0,0,0,2,3
93466,9,658,10,0,0,0,0,17,27
62306,9,658,2,0,0,0,0,7,9
12166,9,658,7,0,0,0,0,12,19
69109,9,658,2,0,0,0,0,11,13
164986,9,658,2,0,0,0,0,3,5
7084,9,658,6,0,0,0,0,8,14
84278,9,658,2,0,0,0,0,4,6
121808,9,95,6,0,0,0,0,13,19
51923,9,314,40,3,1,0,1,83,128
66043,7,912,20,0,0,0,0,31,51
60644,8,800,1,0,0,0,0,1,2
133291,6,306,4,0,0,0,0,1,5
135070,5,479,10,0,0,0,0,13,23
30790,5,124,11,0,0,0,0,12,23
7646,4,675,15,0,0,0,0,30,45
135898,9,658,4,0,0,0,0,5,9
65719,8,214,2,0,0,0,0,1,3
167520,10,653,50,0,0,0,0,72,122
123899,9,640,1,0,0,0,0,1,2
117918,10,525,22,0,0,0,0,43,65
137651,8,214,19,0,0,0,0,33,52
84585,5,58,107,0,0,0,1,117,225
579,11,214,22,0,0,0,0,24,46
86946,4,159,103,1,1,0,0,159,264
132428,4,453,2,0,0,0,0,23,25
92706,7,157,1,0,0,0,0,0,1
151940,8,545,1869,67,18,8,17,3150,5129
42676,9,842,25,0,0,4,0,24,53
38563,6,306,4,1,0,0,0,3,8
135936,7,521,3,0,0,0,0,1,4
65398,5,800,19,0,0,0,0,50,69
129695,10,759,1,0,0,0,0,0,1
135973,10,256,9,0,0,0,0,15,24
126822,6,375,4,1,1,0,0,7,13
149960,8,403,1,0,0,0,0,1,2
108716,7,669,6,1,1,0,0,10,18
100430,7,118,2,0,0,0,0,1,3
25212,6,78,14,0,0,0,0,17,31
142964,10,36,5,0,0,0,0,1,6
34646,9,532,4,0,0,0,0,4,8
17363,9,302,5,0,0,0,0,5,10
115505,10,159,5,0,0,0,0,6,11
60200,9,469,3,0,0,0,0,0,3
58059,7,521,16,0,0,0,1,27,44
34280,7,56,2,0,0,0,0,2,4
47485,7,429,4,0,0,0,0,3,7
118196,9,151,14,0,0,0,0,17,31
112987,7,387,9,0,0,0,0,6,15
35185,5,78,25,0,0,0,0,60,85
49015,5,78,21,0,0,0,0,52,73
88260,5,78,242,1,1,0,5,381,630
40943,8,214,177,8,1,0,2,352,540
81329,10,66,1,0,0,0,0,0,1
144218,11,812,8,0,0,0,0,10,18
18728,11,214,1,0,0,0,0,0,1
73571,5,124,13,0,0,0,0,19,32
442,8,214,3,0,0,0,0,3,6
15367,4,159,2,0,0,0,0,7,9
43277,4,658,1,0,0,0,0,2,3
8255,6,232,4,0,0,0,0,5,9
71190,10,911,140,9,4,0,1,276,430
140864,10,63,27,0,0,0,0,30,57
69518,7,896,4,0,0,0,0,7,11
69693,7,78,5,0,0,0,0,14,19
107263,9,630,326,0,0,0,0,895,1221
146313,9,302,1,0,0,0,0,1,2
106129,9,302,1,0,0,0,0,1,2
152761,6,78,1,0,0,0,0,0,1
165524,5,58,46,0,0,0,1,69,116
1354,8,174,2,0,0,0,0,1,3
155654,10,618,2,0,0,0,0,4,6
65443,11,812,9,0,0,0,0,9,18
82963,8,489,2,0,0,0,0,1,3
36479,9,117,9,0,0,0,0,12,21
144156,11,489,3,0,0,0,0,1,4
10296,4,375,72,0,0,0,0,120,192
11735,9,302,7,0,0,0,0,13,20
116152,6,124,1,0,0,0,0,0,1
72625,9,158,30,1,1,0,0,63,95
6004,9,158,4,0,0,0,0,27,31
65620,9,158,10,0,0,0,0,36,46
163510,7,611,8,0,0,0,0,12,20
142143,9,302,7,0,0,0,1,20,28
103549,10,628,9,0,0,0,0,16,25
120148,6,263,3,0,0,0,0,4,7
76312,7,216,62,0,0,3,0,66,131
92518,6,306,272,1,0,0,2,457,732
65414,9,693,35,0,0,0,0,63,98
105060,9,302,3,1,1,0,0,5,10
60397,9,302,1,0,0,0,0,5,6
57459,9,560,1,0,0,0,0,2,3
80365,4,678,251,4,1,3,1,437,697
52803,6,58,12,0,0,0,0,6,18
67430,9,6,1,0,0,0,0,1,2
112839,5,225,49,1,1,0,0,90,141
73762,10,66,9,0,0,0,0,23,32
50762,6,124,16,1,0,0,0,33,50
39075,4,885,2,0,0,0,0,3,5
66096,6,783,138,0,0,0,2,245,385
104986,10,868,2,0,0,0,0,6,8
73920,10,66,6,0,0,0,0,14,20
136349,8,800,29,0,0,0,0,38,67
80549,10,66,4,0,0,0,0,14,18
163967,8,214,1,0,0,0,0,0,1
108614,7,693,3,0,0,0,0,5,8
31352,9,85,4,0,0,0,0,5,9
81829,5,200,49,1,0,0,0,84,134
140003,11,812,4,0,0,0,0,4,8
161782,10,63,5,0,0,0,0,8,13
120563,5,306,84,1,1,0,1,120,207
77477,9,630,389,0,0,0,1,1316,1706
107001,5,783,17,0,0,0,0,32,49
28968,7,312,1,0,0,0,0,1,2
38783,9,243,2,0,0,0,0,0,2
155731,6,263,3,0,0,0,0,2,5
12530,5,800,5,0,0,0,0,9,14
71246,4,752,200,3,1,0,1,378,583
169162,9,630,86,0,0,0,1,212,299
23251,9,630,298,0,0,0,1,912,1211
136906,11,214,4,0,0,0,0,4,8
32098,10,357,11,0,0,0,0,18,29
89236,9,203,1,0,0,0,0,4,5
116149,9,203,0,0,0,0,0,4,4
164992,9,203,2,0,0,0,1,6,9
41969,11,403,16,0,0,0,0,14,30
108028,9,145,2,0,0,0,0,23,25
33162,5,58,2,0,0,0,0,6,8
149045,9,145,26,2,0,0,0,86,114
68538,9,145,0,0,0,0,0,28,28
72160,9,145,0,0,0,0,0,4,4
97654,9,145,0,0,0,0,0,4,4
54453,9,145,41,1,0,0,1,72,115
108806,9,145,0,0,0,0,0,8,8
63332,9,145,6,0,0,0,0,35,41
29807,9,693,4,0,0,0,0,10,14
169239,10,111,4,0,0,0,0,0,4
103485,11,214,2,0,0,0,0,2,4
166855,9,65,24,0,0,0,0,35,59
66482,7,56,4,0,0,0,0,3,7
118576,11,306,19,0,0,0,0,18,37
135921,7,79,6,0,0,0,0,8,14
4537,9,30,9,0,0,0,0,13,22
76033,9,367,7,0,0,0,0,13,20
32602,5,200,4,0,0,0,0,7,11
44672,6,420,16,0,0,0,0,23,39
63957,11,214,7,0,0,0,0,5,12
70536,9,302,8,0,0,0,0,14,22
63462,9,315,18,0,0,0,1,39,58
149221,9,203,4,0,0,0,0,25,29
26328,9,909,11,0,0,0,0,12,23
22190,9,589,25,0,0,0,0,39,64
110436,9,315,4,0,0,0,0,6,10
35092,9,489,7,0,0,0,0,14,21
87278,9,560,2,0,0,0,0,6,8
165882,9,469,9,0,0,0,0,8,17
47928,4,124,2,0,0,0,0,2,4
5896,11,214,2,0,0,0,0,2,4
33110,4,885,510,12,8,1,3,986,1520
62373,9,427,24,0,0,0,0,75,99
55316,7,521,27,0,0,0,0,50,77
22069,4,453,2,0,0,0,0,3,5
143201,11,403,4,0,0,0,0,6,10
77882,4,453,19,0,0,0,0,34,53
34148,11,403,1,9,0,0,0,1,11
157920,9,86,4,0,0,0,0,3,7
4856,8,214,447,8,2,0,5,803,1265
112453,5,200,13,0,0,0,0,21,34
47890,9,719,12,1,0,0,0,17,30
25778,4,453,1,0,0,0,0,2,3
53225,8,214,2,0,0,0,0,4,6
90834,10,781,3,0,0,0,0,3,6
161609,11,623,4,0,0,0,0,3,7
169283,4,752,16,0,0,0,0,21,37
102305,4,375,16,0,0,0,0,32,48
92513,4,375,52,0,2,0,0,92,146
142579,11,489,4,0,0,0,0,5,9
167564,4,885,1,0,0,0,0,0,1
70729,6,843,9,1,1,0,0,23,34
144426,9,630,88,0,0,0,0,302,390
29794,9,100,37,2,1,0,0,45,85
164142,8,489,1,0,0,0,0,2,3
157832,7,864,9,0,0,0,0,15,24
115717,10,820,3,0,0,0,0,8,11
62164,8,124,52,2,2,0,0,80,136
155401,9,630,112,0,0,0,0,650,762
84830,9,630,397,0,0,0,1,1089,1487
132092,9,131,8,0,0,0,0,14,22
12467,9,131,6,0,0,0,0,14,20
6982,7,100,2,0,0,0,0,4,6
76627,5,58,16,0,0,0,0,24,40
145906,10,903,1,0,0,0,0,0,1
94936,10,903,12,0,0,0,0,20,32
37407,4,306,3,0,0,0,0,0,3
142940,4,200,6,0,0,0,0,3,9
154339,5,59,4,0,0,0,0,6,10
71125,9,46,2,0,0,0,0,6,8
22827,10,917,5,0,0,0,0,15,20
45724,9,46,33,1,0,0,0,54,88
96324,9,46,2,0,0,0,0,8,10
114498,9,46,2,0,0,0,0,4,6
165186,4,375,2,0,0,0,0,3,5
679,8,214,1,0,0,0,0,0,1
11148,9,487,4,0,0,0,0,28,32
113177,9,46,4,0,0,0,0,8,12
83003,9,380,10,0,0,0,0,18,28
138075,7,669,7,0,0,0,0,11,18
169915,7,669,3,0,0,0,0,7,10
115831,5,489,102,2,1,0,0,168,273
36279,4,581,155,1,0,0,2,307,465
170055,5,124,31,0,0,0,0,44,75
73210,5,124,18,0,0,0,0,11,29
29939,9,630,104,0,0,0,0,435,539
124542,9,640,629,11,3,0,3,994,1640
88356,9,302,1,0,0,0,0,2,3
155820,9,302,1,0,0,0,0,1,2
55601,4,752,250,6,5,0,2,445,708
82841,7,194,12,0,0,0,0,23,35
120045,9,560,10,0,0,0,0,23,33
14668,6,306,51,0,0,0,0,93,144
72501,9,175,1,0,0,0,0,4,5
7999,4,800,2,0,0,0,0,3,5
102673,11,214,4,0,0,0,0,3,7
103782,9,607,12,0,1,0,0,22,35
108360,8,623,2,0,0,0,0,2,4
102925,11,812,1,0,0,0,0,0,1
31363,9,158,0,0,0,0,0,8,8
62361,7,755,10,0,1,0,0,14,25
82235,9,630,104,0,0,0,1,261,366
57039,6,200,106,2,1,0,1,165,275
68617,5,479,2,0,0,0,0,2,4
66660,7,861,5,0,0,0,0,18,23
98386,10,63,5,0,0,0,0,8,13
26937,11,403,2,0,0,0,0,2,4
113713,8,812,3,0,0,0,0,2,5
19033,5,893,9,0,0,0,0,5,14
163573,4,675,84,3,0,0,1,173,261
40994,10,911,101,5,3,0,1,189,299
45294,10,628,1,0,0,0,0,1,2
122551,7,144,12,0,0,0,0,10,22
168104,10,841,1,0,0,0,0,1,2
50645,9,158,8,0,0,0,0,10,18
49934,9,575,1,0,0,0,0,0,1
142574,8,885,5,0,0,0,0,12,17
132325,4,885,130,5,3,0,0,212,350
11216,9,157,24,0,0,0,0,48,72
152651,4,159,5,0,0,0,0,10,15
40428,7,496,8,0,0,0,0,13,21
87818,8,214,2,0,0,0,0,1,3
97279,10,911,4,0,0,0,0,5,9
161367,7,367,86,6,4,0,1,161,258
157035,9,762,2,0,0,0,0,3,5
141091,11,489,10,3,0,0,0,18,31
15071,7,508,5,1,1,0,0,8,15
118058,9,909,4,0,0,0,0,10,14
76651,8,214,2,0,0,0,0,7,9
146845,7,74,2,0,0,0,0,1,3
106261,8,693,1,0,0,0,0,2,3
159648,9,630,102,0,0,0,1,366,469
1090,9,95,1,0,0,0,0,2,3
104612,9,43,7,0,0,0,0,11,18
151331,4,36,13,0,0,0,0,26,39
25425,10,81,2,0,0,0,0,1,3
83924,11,623,31,0,0,0,0,33,64
106168,10,628,0,0,0,0,0,4,4
13975,6,30,1,0,0,0,0,0,1
42253,9,42,2,0,0,0,0,4,6
65997,4,124,1,0,0,0,0,0,1
12096,4,581,77,0,0,0,0,129,206
156253,4,923,13,1,0,0,0,16,30
21418,9,589,14,0,1,0,0,22,37
36814,6,420,106,1,0,0,0,193,300
156201,7,589,3,0,0,0,0,4,7
162111,4,562,1,0,0,0,0,0,1
33508,5,232,2,0,0,0,0,3,5
22701,11,623,2,0,0,0,0,2,4
129435,10,618,1,0,0,0,0,0,1
105366,9,314,12,0,0,0,0,16,28
299,5,489,110,8,3,0,0,194,315
64342,7,367,2,0,0,0,0,4,6
125506,9,379,46,0,0,0,0,76,122
76933,5,479,26,0,0,0,0,42,68
60609,10,66,2,0,0,0,0,10,12
126462,6,135,13,0,0,0,0,16,29
130556,5,479,56,0,0,0,0,99,155
109421,9,405,15,0,1,0,0,31,47
56419,9,452,2,0,0,0,0,1,3
153984,10,256,14,0,0,0,0,26,40
155858,5,34,1,0,0,0,0,1,2
102504,9,819,4,0,0,0,0,5,9
104193,9,429,2,0,0,0,0,3,5
123325,9,6,1,0,0,0,0,0,1
145204,9,6,1,0,0,0,0,2,3
15319,9,6,1,0,0,0,0,1,2
52296,9,452,1,0,0,0,0,1,2
132765,9,341,2,0,0,0,0,3,5
93987,6,518,1,0,0,0,0,1,2
36459,9,706,0,0,0,0,0,12,12
108225,9,706,6,0,0,0,0,8,14
9843,7,80,7,0,0,0,0,9,16
97486,6,453,3,0,0,0,0,1,4
5141,10,334,2,0,0,0,0,3,5
114807,8,403,48,0,0,0,0,82,130
138711,9,622,1,0,0,0,0,0,1
47113,9,8,8,0,0,0,0,12,20
85895,5,479,241,1,0,0,1,352,595
154355,11,812,2,0,0,0,0,1,3
58450,4,659,4,0,0,0,0,4,8
101780,11,812,4,0,0,0,0,2,6
3340,11,812,2,0,0,0,0,1,3
53544,11,812,2,0,0,0,0,1,3
82732,5,479,1,0,0,0,0,13,14
47035,9,706,4,0,0,0,0,12,16
156384,7,693,15,0,0,0,0,22,37
56708,9,693,4,0,0,0,0,8,12
10449,9,693,8,0,0,0,0,13,21
122769,11,545,345,1,0,0,0,322,668
164277,9,912,14,0,0,0,0,36,50
6031,10,743,4,0,0,0,0,26,30
54484,4,658,20,0,0,0,1,27,48
135551,7,484,8,0,0,0,0,11,19
67547,9,367,11,0,0,0,0,20,31
134095,7,755,37,0,0,0,0,57,94
32349,6,200,86,1,0,0,0,142,229
145471,5,479,76,0,1,0,0,166,243
163606,8,885,8,0,0,0,0,11,19
59254,8,489,1,0,0,0,0,1,2
144438,5,296,2,0,0,0,0,3,5
60700,5,479,225,5,2,1,0,362,595
83207,9,741,30,0,0,0,0,39,69
12780,9,46,2,0,0,0,0,4,6
30604,9,46,2,0,0,0,0,6,8
69096,6,885,9,0,0,0,0,21,30
164947,7,306,130,0,0,0,0,620,750
74207,7,484,8,0,0,0,0,3,11
147649,9,909,4,0,0,0,0,13,17
78449,5,479,292,1,2,0,2,518,815
98732,5,479,69,2,0,0,1,157,229
94085,5,479,121,0,0,0,0,193,314
99362,5,489,26,1,0,0,0,44,71
167667,4,200,48,1,1,0,1,40,91
141096,9,452,10,0,0,0,0,15,25
35778,4,800,12,0,0,0,0,18,30
24545,8,545,6,0,0,0,0,5,11
98142,9,367,6,0,0,0,0,13,19
55255,10,66,2,0,0,0,0,3,5
96396,10,355,0,0,0,0,1,12,13
170347,11,214,45,1,0,0,0,42,88
65018,9,151,36,0,0,0,0,65,101
108705,10,256,3,2,1,0,0,16,22
14856,10,911,6,0,0,0,0,33,39
37288,7,118,12,0,0,0,0,19,31
26512,10,743,2,0,0,0,0,5,7
124921,10,413,12,0,0,0,0,19,31
100047,10,743,16,0,0,0,0,5,21
30917,10,743,4,0,0,0,0,4,8
120848,10,628,6,0,0,0,0,6,12
80017,9,462,4,0,0,0,0,8,12
135546,9,622,8,0,0,0,0,17,25
22044,10,413,1,0,0,0,0,2,3
54777,5,479,121,1,0,0,1,191,314
154287,9,796,2,0,0,0,0,3,5
147279,9,158,13,0,0,0,0,34,47
101787,9,158,4,0,0,0,0,16,20
5695,9,158,2,0,0,0,0,3,5
108962,8,30,3,0,0,0,0,1,4
134070,9,158,6,0,0,0,0,29,35
153481,9,302,45,0,0,0,0,127,172
17579,5,783,16,0,0,0,1,27,44
130985,11,214,9,0,0,0,0,15,24
118250,5,78,80,3,1,0,1,141,226
122108,5,58,8,0,0,0,0,13,21
97230,9,131,2,0,0,0,0,4,6
28786,9,131,2,0,0,0,0,9,11
156347,9,131,8,0,0,0,0,14,22
169324,9,131,7,0,0,0,0,12,19
24779,5,489,12,0,0,0,0,17,29
117910,9,131,2,0,0,0,0,4,6
138811,9,570,2,0,0,0,0,2,4
101652,11,214,7,0,0,0,0,6,13
144040,11,355,5,0,0,0,0,2,7
89930,10,831,7,0,0,0,0,7,14
74620,7,842,9,2,1,0,0,35,47
32078,6,269,130,2,0,0,0,218,350
81354,9,302,4,0,0,0,0,8,12
160668,7,38,706,10,2,0,3,1744,2465
77139,10,743,2,0,0,0,0,6,8
71130,10,743,2,0,0,0,0,2,4
129683,10,743,12,0,0,0,0,13,25
94324,9,405,4,0,0,0,0,5,9
30064,10,903,1,0,0,0,0,0,1
33558,10,903,1,0,0,0,0,0,1
166878,10,903,2,0,0,0,0,0,2
134879,5,489,2,0,0,0,0,3,5
98730,4,159,1,0,0,0,0,0,1
164400,8,693,1,0,0,0,0,0,1
59067,11,489,6,0,0,0,0,9,15
156512,11,489,2,0,0,0,0,2,4
104597,10,914,11,0,0,0,0,29,40
28795,9,374,1,0,0,0,0,1,2
141779,4,752,1,0,0,0,0,0,1
39669,8,403,202,5,4,0,0,344,555
97500,7,885,0,0,0,0,0,3,3
90776,4,658,22,0,0,0,0,46,68
17842,10,36,2,0,0,0,0,3,5
88930,9,630,13,0,0,0,0,31,44
49475,9,302,28,0,0,0,0,89,117
131349,8,800,1,0,0,0,0,0,1
2341,6,783,8,0,0,0,0,12,20
149525,9,202,6,0,0,0,0,14,20
120285,9,202,8,0,0,0,0,13,21
162993,9,202,14,0,0,0,0,23,37
84046,5,235,3,0,0,0,0,9,12
25925,5,404,2,0,0,0,0,0,2
35124,7,494,4,0,0,0,0,3,7
114218,11,306,19,0,0,0,0,24,43
32637,9,570,17,0,0,0,0,31,48
160983,10,392,15,0,0,0,0,12,27
145879,9,145,28,1,0,0,0,68,97
126081,9,145,4,0,0,0,0,27,31
86658,4,800,46,0,0,0,0,83,129
12803,11,812,2,0,0,0,0,2,4
161863,9,640,1,0,0,0,0,0,1
117077,7,896,3,0,0,0,0,4,7
64032,8,812,51,0,0,0,0,66,117
106239,9,575,3,0,0,0,0,7,10
79801,9,313,18,0,0,0,0,45,63
44461,7,748,3,0,0,0,0,8,11
32019,8,623,2,0,0,0,0,2,4
66470,5,408,2,0,0,0,0,4,6
65706,8,885,1,0,0,0,0,0,1
47810,9,175,13,0,0,0,0,10,23
97319,9,117,2,0,0,0,0,2,4
103613,7,263,6,0,0,0,1,22,29
46283,9,89,6,0,0,0,0,13,19
133308,7,800,6,0,0,0,0,16,22
158966,10,685,4,0,0,0,0,3,7
27963,9,367,8,0,0,0,0,10,18
142012,11,124,4,0,0,0,0,4,8
82719,9,800,2,0,0,0,0,6,8
49128,10,911,15,0,0,0,0,24,39
37760,5,489,10,0,0,0,0,12,22
72386,6,514,0,0,0,0,0,17,17
102288,10,917,3,0,0,0,0,2,5
144364,8,48,1662,60,10,5,13,2625,4375
108708,9,575,1,0,0,0,0,0,1
50316,9,452,3,0,0,0,0,6,9
75864,6,366,2,0,0,0,0,2,4
48138,5,78,2,0,0,0,0,0,2
31790,9,30,5,0,0,0,0,7,12
151393,6,78,4,0,0,0,0,4,8
10907,5,821,9,0,0,0,0,11,20
82564,9,471,22,1,1,0,0,20,44
71453,9,375,4,0,0,0,0,7,11
120992,9,375,2,0,0,0,0,3,5
8143,9,380,3,0,0,0,0,4,7
39689,9,556,4,0,0,0,0,4,8
146497,4,365,3,0,0,0,0,3,6
29097,6,141,6,0,0,0,0,17,23
49629,11,375,4,0,0,0,0,6,10
34537,8,214,1,0,0,0,0,0,1
124982,8,623,22,0,0,0,0,35,57
15592,8,885,3,0,0,0,0,4,7
68292,8,545,8,0,0,0,0,16,24
169169,7,38,973,24,7,4,6,2003,3017
58691,9,819,6,0,0,0,0,9,15
148907,8,885,106,1,1,0,0,198,306
140765,11,214,7,0,0,0,0,4,11
135110,8,489,1,0,0,0,0,0,1
77141,4,752,62,1,0,0,3,81,147
151831,11,489,2,0,0,0,0,1,3
3591,4,675,2,0,0,0,0,3,5
144800,10,798,10,0,0,0,0,8,18
131466,7,312,2,0,0,0,0,3,5
28885,9,65,2,0,0,0,0,5,7
148539,9,65,2,0,0,0,0,7,9
145492,9,65,0,0,0,0,0,5,5
138016,9,535,1,0,0,0,0,0,1
110099,7,228,3,0,0,0,0,8,11
55746,10,111,12,0,0,0,0,11,23
102177,9,483,2,0,0,0,0,1,3
140156,7,508,2,0,0,0,0,2,4
130275,8,214,2,0,0,0,0,5,7
106854,9,640,133,1,1,0,1,187,323
121692,10,111,2,0,0,0,0,6,8
42883,9,314,2,0,0,0,0,2,4
98547,6,263,1,0,0,0,0,9,10
122861,10,111,2,0,0,0,0,4,6
476,10,549,4,0,0,0,0,7,11
115100,10,868,5,0,0,0,0,15,20
56553,10,868,0,0,0,0,0,3,3
156236,10,413,2,0,0,0,0,3,5
7218,10,413,0,0,0,0,0,7,7
15450,6,200,48,2,1,0,0,110,161
81407,9,158,2,0,0,0,0,12,14
81636,4,36,15,0,0,0,0,26,41
59001,9,145,1,0,0,0,0,6,7
37257,9,145,0,0,0,0,0,12,12
9152,9,873,0,0,0,0,0,11,11
59778,9,873,1,0,0,0,0,12,13
144916,9,873,1,0,0,0,0,7,8
156961,9,873,0,0,0,0,0,5,5
19913,9,873,0,0,0,0,0,5,5
157469,9,873,1,0,0,0,0,7,8
86896,9,145,4,0,0,0,0,12,16
142161,9,145,0,0,0,0,0,4,4
102960,9,145,0,0,0,0,0,4,4
36637,9,873,0,0,0,0,0,5,5
124908,9,873,1,0,0,0,0,2,3
133891,8,800,2,0,0,0,0,0,2
30556,9,589,10,0,0,0,0,15,25
113951,9,589,16,1,1,0,0,30,48
101894,9,429,4,0,0,0,0,8,12
166121,9,429,0,0,0,0,0,3,3
99339,9,429,2,0,0,0,0,3,5
140018,9,429,2,0,0,0,0,3,5
10543,9,657,7,0,0,0,0,14,21
51899,5,78,1,0,0,0,0,0,1
140645,9,100,3,0,0,0,0,4,7
110691,9,302,2,0,0,0,0,6,8
100466,8,306,4,0,0,0,0,0,4
68162,10,413,7,0,0,0,0,7,14
129080,10,617,24,0,0,0,0,43,67
148143,7,374,3,0,0,0,0,4,7
115263,9,640,393,9,0,0,2,617,1021
153887,9,607,5,0,0,0,0,10,15
22330,9,560,2,0,0,0,0,2,4
49310,6,141,6,0,0,0,0,10,16
57806,9,452,2,0,0,0,0,2,4
19284,10,820,3,0,0,0,0,7,10
41964,9,575,5,0,0,0,0,6,11
50781,9,353,4,0,0,0,0,3,7
94363,9,202,2,0,0,0,0,2,4
159779,10,743,0,0,0,0,0,3,3
98879,10,903,3,0,0,0,1,7,11
109988,8,214,1,0,0,0,0,1,2
82331,11,214,2,0,0,0,0,2,4
72871,9,630,1,0,0,0,0,0,1
111332,9,885,8,1,1,0,0,10,20
39485,9,885,2,0,0,0,0,2,4
150726,7,429,7,0,0,0,0,17,24
100677,8,545,6,0,0,0,0,9,15
104813,8,545,2,0,0,0,0,0,2
155038,10,66,8,0,0,0,0,6,14
127682,10,66,4,0,0,0,0,7,11
32761,10,628,4,0,0,0,0,7,11
108890,9,6,14,0,0,0,0,24,38
130014,4,36,48,1,0,0,0,66,115
15534,8,124,1,0,0,0,0,0,1
58095,7,508,6,0,0,0,0,14,20
4199,4,809,2,0,0,0,0,4,6
169463,11,812,2,0,0,0,0,2,4
86077,9,145,1,0,0,0,0,0,1
18998,9,54,3,0,0,0,0,8,11
117024,7,611,4,0,0,0,0,8,12
155036,7,118,2,0,0,0,0,5,7
52576,7,118,6,0,0,0,0,11,17
55804,6,518,21,0,0,0,0,31,52
148650,8,48,82,3,0,0,0,119,204
89724,6,269,1,0,0,0,0,0,1
164576,9,43,8,0,0,0,0,12,20
150553,6,269,1,0,0,0,0,0,1
89293,4,453,2,0,0,0,0,5,7
147889,6,269,3,0,0,0,0,0,3
17979,10,911,2,0,0,0,0,3,5
6263,9,456,7,0,0,0,0,10,17
41273,7,149,1,0,0,0,0,2,3
157182,11,244,2,0,0,0,0,3,5
118079,6,78,2,0,0,0,0,0,2
112246,6,78,2,0,0,0,0,0,2
147734,8,214,2,0,0,0,0,0,2
127120,6,78,10,0,0,0,0,8,18
167355,4,752,144,2,1,0,1,225,373
68473,11,214,6,0,0,0,0,2,8
65459,5,200,5,0,0,0,0,8,13
147607,6,124,13,0,0,0,0,16,29
53306,5,332,2,0,0,0,0,3,5
46666,4,159,2,0,0,0,0,9,11
77492,9,538,6,0,0,0,0,16,22
171163,5,885,1,0,0,0,0,0,1
44224,11,623,2,0,0,0,0,3,5
65288,7,144,2,0,0,0,0,4,6
144836,9,657,5,0,0,0,0,9,14
95267,11,812,5,0,0,0,0,8,13
86756,9,657,13,0,0,0,1,31,45
126187,9,796,1,0,0,0,0,3,4
775,10,159,1,0,0,0,0,0,1
8617,9,796,1,0,0,0,0,0,1
158583,9,796,2,0,0,0,0,2,4
125755,8,124,46,5,4,0,0,58,113
156792,5,489,17,1,1,0,0,29,48
108284,9,427,1,0,0,0,0,0,1
165752,6,783,16,0,0,0,0,24,40
94140,6,783,46,0,0,0,0,86,132
118413,7,521,7,0,0,0,0,10,17
18378,7,295,4,0,0,0,0,8,12
112705,7,295,10,0,0,0,0,16,26
156538,9,315,5,0,0,0,1,20,26
130762,8,658,36,0,0,0,0,53,89
102934,7,74,2,0,0,0,0,5,7
85871,4,800,1,0,0,0,0,0,1
164269,7,508,1,0,0,0,0,2,3
100243,5,489,28,1,0,0,1,58,88
147638,9,630,18,0,0,0,0,28,46
40850,8,489,1,0,0,0,0,0,1
139616,6,643,1,0,0,0,0,0,1
52834,10,29,1,0,0,0,0,2,3
151804,4,581,331,0,0,0,0,542,873
71755,6,58,9,0,0,0,0,4,13
37925,6,290,2,0,0,0,0,4,6
71378,9,145,6,0,0,0,0,22,28
85067,6,570,20,1,0,0,0,38,59
97847,9,909,2,0,0,0,0,2,4
12098,9,842,8,0,0,0,0,12,20
94165,7,56,4,1,1,0,0,6,12
109210,7,741,2,0,0,0,0,4,6
140618,9,175,9,0,0,0,0,12,21
131332,9,456,2,0,0,0,0,4,6
156748,9,95,1,0,0,0,0,2,3
146538,7,660,6,0,0,0,0,20,26
89785,6,518,8,0,0,0,0,13,21
171093,9,145,0,0,0,0,0,7,7
7116,9,741,1,0,0,0,0,2,3
68163,8,30,2,0,0,0,0,3,5
11986,4,800,1,0,0,0,0,11,12
143262,9,575,1,0,0,0,0,0,1
19282,9,575,1,0,0,0,0,0,1
94000,7,384,5,0,0,0,0,9,14
63071,10,831,53,1,1,0,0,72,127
11052,9,203,2,0,0,0,0,6,8
125427,9,203,1,0,0,0,0,0,1
113196,9,145,1,0,0,0,0,7,8
23981,10,917,9,0,1,0,0,16,26
30093,9,95,5,0,0,0,0,7,12
153533,11,214,5,0,0,0,0,5,10
77979,10,474,2,0,0,0,0,3,5
154556,4,200,4,0,0,0,0,8,12
62403,10,799,3,0,0,0,0,8,11
141880,9,456,4,0,0,0,0,8,12
115988,8,812,596,15,5,0,11,2472,3099
92792,8,812,1,0,0,0,0,0,1
40019,10,868,10,0,0,0,0,17,27
133489,9,741,2,0,0,0,0,1,3
82565,10,60,2,0,0,0,0,5,7
165815,7,38,16,0,0,0,0,14,30
161086,9,538,3,0,0,0,0,9,12
160042,6,263,13,0,0,0,0,20,33
143542,10,355,2,0,0,0,0,3,5
79294,11,885,25,0,0,0,0,41,66
84529,10,790,6,0,0,0,0,14,20
74260,10,790,2,0,0,0,0,3,5
34028,9,429,78,15,8,3,0,99,203
148719,8,545,1,0,0,0,0,0,1
42601,7,578,7,0,0,0,0,8,15
105575,4,752,251,1,1,0,1,413,667
1923,10,413,2,0,0,0,0,4,6
74998,10,653,2,0,0,0,0,0,2
153625,6,141,22,0,0,0,0,39,61
62170,9,796,2,0,0,0,0,0,2
96511,4,375,10,0,0,0,0,4,14
13616,4,678,65,1,0,0,1,124,191
146466,9,367,16,0,0,0,0,0,16
146581,11,214,12,0,0,0,0,12,24
3865,9,314,7,0,0,0,0,8,15
88587,9,314,4,0,0,0,0,6,10
124706,9,243,4,0,0,0,0,4,8
92042,7,228,23,0,0,0,0,52,75
119894,7,755,4,0,0,0,0,8,12
71866,9,452,1,0,0,0,0,3,4
31983,4,658,3,0,0,0,0,6,9
93820,9,842,59,2,0,7,0,89,157
35376,9,314,1,0,0,0,0,2,3
10221,9,828,1,0,0,0,0,1,2
26403,9,489,24,0,0,0,0,37,61
49767,8,403,2,0,0,0,0,0,2
48239,10,289,5,0,0,0,0,13,18
5572,7,226,6,0,0,0,0,14,20
94511,8,30,2,0,0,0,0,3,5
105271,8,623,26,0,0,0,0,50,76
114092,8,623,17,0,0,0,0,32,49
144844,9,145,4,0,0,0,0,32,36
141640,7,484,2,0,0,0,0,4,6
63084,10,81,0,0,0,0,0,4,4
129870,11,812,2,0,0,0,0,2,4
161052,9,145,2,0,0,0,0,6,8
49189,9,145,2,0,0,0,0,4,6
43670,5,355,257,5,1,2,2,437,704
167147,9,706,0,0,0,0,0,15,15
59998,8,545,2,0,0,0,0,1,3
77092,9,706,2,0,0,0,0,4,6
115111,9,706,2,0,0,0,0,4,6
87972,4,800,1,0,0,0,0,1,2
102154,9,6,2,0,0,0,0,12,14
165344,9,535,12,0,0,0,0,19,31
117418,9,203,60,1,2,0,0,153,216
13995,6,141,6,0,0,0,0,10,16
94969,9,203,86,5,0,1,0,168,260
82468,9,203,8,0,0,0,0,46,54
106518,9,203,6,0,0,0,0,18,24
160512,9,203,8,0,1,0,0,60,69
31649,9,203,0,0,0,0,0,12,12
22472,4,427,28,0,0,0,0,69,97
90758,5,699,19,0,0,0,0,25,44
164844,9,740,1,0,0,0,0,1,2
21454,7,496,13,0,0,0,0,14,27
42862,9,630,2,0,0,0,0,3,5
95762,10,66,4,0,0,0,0,5,9
83654,9,483,5,0,0,0,0,7,12
116080,8,885,139,8,2,0,0,275,424
155922,8,214,1,0,0,0,0,0,1
66191,5,371,14,1,0,0,0,24,39
99620,9,184,4,0,0,0,0,8,12
126601,9,367,10,0,0,0,0,15,25
7897,9,838,16,0,0,0,0,32,48
39378,5,505,2,0,0,0,0,4,6
165575,10,355,10,0,0,0,1,16,27
150678,8,403,68,2,0,0,0,114,184
121429,10,322,2,0,0,0,0,3,5
168281,10,111,2,0,0,0,0,2,4
14271,11,489,3,0,0,0,0,0,3
120414,7,384,2,0,0,0,0,3,5
64337,7,310,8,0,0,0,0,17,25
18336,10,413,2,0,0,0,0,3,5
16638,11,306,13,0,0,0,0,9,22
54951,10,289,6,1,0,0,0,9,16
71636,10,289,4,0,0,0,0,8,12
98626,7,645,2,0,0,0,0,2,4
163859,8,545,18,0,0,0,0,14,32
128825,9,456,4,0,0,0,0,4,8
150435,9,456,4,0,0,0,0,4,8
135318,11,427,21,0,0,0,0,21,42
102031,10,66,12,0,0,0,0,18,30
27778,10,355,0,0,0,0,0,6,6
3510,10,628,8,0,0,0,0,20,28
67294,10,208,24,0,0,0,1,58,83
79335,10,66,6,0,0,0,0,14,20
9618,7,611,2,0,0,0,0,4,6
53848,4,780,1,0,0,0,0,0,1
59594,7,800,90,5,1,0,0,172,268
39132,10,618,0,0,0,0,0,7,7
157943,10,289,2,0,0,0,0,5,7
101951,9,341,16,0,0,0,0,26,42
129568,9,341,2,0,0,0,0,4,6
85512,7,228,33,1,1,0,0,29,64
102520,7,800,56,0,0,0,0,147,203
40193,11,489,2,0,0,0,0,0,2
49977,9,469,5,0,0,0,0,12,17
154844,9,469,2,0,0,0,0,5,7
13433,8,489,5,0,0,0,0,0,5
21636,7,626,2,0,0,0,0,4,6
66027,7,521,5,0,0,0,0,9,14
39114,9,560,3,0,0,0,0,1,4
7820,6,78,1,0,0,0,0,0,1
51556,7,74,2,0,0,0,1,4,7
1013,4,658,14,0,0,0,0,17,31
117254,4,678,6,0,0,0,0,8,14
138172,9,374,4,2,0,0,0,9,15
31569,9,462,7,0,0,0,0,11,18
114906,11,214,12,1,0,0,0,12,25
16138,8,885,1,0,0,0,0,0,1
13466,4,908,2,0,0,0,0,3,5
61970,9,266,1,0,0,0,0,0,1
29365,10,618,10,0,0,0,0,20,30
98324,7,306,0,0,0,0,0,3,3
151893,9,489,84,0,0,1,0,113,198
124191,9,489,107,0,0,0,2,355,464
102761,9,622,4,0,0,0,0,7,11
162935,9,489,124,0,0,0,2,531,657
23872,9,796,12,0,0,0,0,11,23
9964,7,196,4,0,0,0,0,7,11
130469,11,214,4,0,0,0,0,4,8
51219,5,693,4,0,0,0,0,7,11
165211,4,780,1,0,0,0,0,0,1
29598,7,563,8,0,0,0,0,12,20
562,11,403,1,0,0,0,0,1,2
94714,9,158,5,0,0,0,0,13,18
160211,4,200,2,0,0,0,0,2,4
15738,6,124,1,0,0,0,0,2,3
54958,9,912,4,0,0,0,0,9,13
128648,9,145,1,0,0,0,0,1,2
151543,10,40,1,0,0,0,0,0,1
90176,9,158,0,0,0,0,0,4,4
140401,10,111,4,0,0,0,0,4,8
133588,7,611,4,0,0,0,0,5,9
101753,10,799,12,0,0,0,0,17,29
11968,5,124,28,0,0,0,0,45,73
126393,6,232,3,0,0,0,0,1,4
90572,8,885,189,3,2,0,3,371,568
11556,8,244,1,0,0,0,0,0,1
76946,8,214,2,0,0,0,0,3,5
128172,4,809,8,0,0,0,0,14,22
75833,11,214,10,0,0,0,0,12,22
87985,7,489,305,10,4,2,4,808,1133
55238,6,124,1,0,0,0,0,0,1
44248,11,214,97,1,0,0,0,102,200
125504,8,30,4,0,0,0,0,3,7
98714,8,885,152,3,1,0,0,235,391
137976,5,332,3,0,0,0,0,14,17
3174,9,246,3,0,0,0,0,3,6
24948,5,124,10,1,0,0,0,15,26
166875,11,214,42,0,0,0,0,66,108
153312,5,489,3,0,0,0,0,4,7
14837,7,216,68,1,0,0,0,85,154
157899,10,653,2,0,0,0,0,2,4
115678,9,302,15,0,0,0,0,38,53
2279,4,200,1,0,0,0,0,1,2
162841,9,315,2,0,0,0,0,3,5
5729,9,216,26,2,0,1,0,38,67
51293,9,796,2,0,0,0,0,4,6
33974,9,630,2,0,0,0,0,3,5
55413,4,200,7,0,0,0,0,1,8
74008,9,452,1,0,0,0,0,2,3
153124,7,508,2,0,0,0,0,14,16
165994,9,492,1,0,0,0,0,3,4
62528,7,367,6,0,0,0,0,12,18
34258,7,367,4,0,0,0,0,11,15
167318,7,755,5,0,0,0,0,12,17
101041,4,453,99,0,0,4,0,157,260
122235,5,181,71,4,1,1,0,109,186
163709,11,489,2,0,0,0,0,0,2
127556,11,489,1,0,0,0,0,0,1
124901,7,157,82,2,2,0,0,159,245
60123,7,611,4,0,0,0,0,4,8
66548,7,611,9,0,0,0,0,10,19
88811,7,611,2,0,0,0,0,4,6
62966,4,890,6,0,0,0,0,16,22
110481,8,214,1,0,0,0,0,1,2
128847,8,693,2,0,0,0,0,0,2
143660,10,816,1,0,0,0,0,0,1
109538,11,214,6,0,0,0,0,15,21
69541,8,214,2,0,0,0,0,2,4
150738,8,214,1,0,0,0,0,0,1
31199,4,200,169,1,0,9,0,207,386
80825,8,545,2,0,0,0,0,2,4
86764,7,489,960,27,7,6,4,2152,3156
22981,7,892,1,0,0,0,0,1,2
9651,11,489,4,1,0,0,0,5,10
93172,11,427,4,0,0,0,0,3,7
48181,10,217,1,0,0,0,0,2,3
142115,8,214,2,0,0,0,0,2,4
149338,7,56,13,1,1,0,0,21,36
152864,8,489,3,0,0,0,0,2,5
68988,8,214,1,0,0,0,0,0,1
101218,4,923,1,0,0,0,0,1,2
129597,7,489,108,4,3,0,0,175,290
77999,6,789,50,1,1,0,0,83,135
166993,9,301,13,0,0,0,0,21,34
75294,7,207,2,0,0,0,0,6,8
24701,9,483,11,1,0,0,0,24,36
130650,7,587,378,7,2,1,1,558,947
122198,10,334,2,0,0,0,0,0,2
63612,10,334,3,0,0,0,0,0,3
10158,10,63,3,0,0,0,0,6,9
71318,10,63,5,0,0,0,0,5,10
17911,7,384,3,0,0,0,0,8,11
161973,9,630,1,0,0,0,0,1,2
86349,9,657,7,0,0,0,0,12,19
119655,7,578,9,0,0,0,0,43,52
94101,7,578,6,0,0,0,0,9,15
140766,7,77,6,0,0,0,0,12,18
150759,10,322,6,0,0,0,0,6,12
169252,5,518,4,0,0,0,0,9,13
55554,11,489,10,2,0,0,0,11,23
72336,4,800,1,0,0,0,0,1,2
81672,4,453,12,0,0,0,0,34,46
1491,10,549,0,0,0,0,0,3,3
34120,9,910,2,0,0,0,0,0,2
39014,10,66,0,0,0,0,0,3,3
83499,9,301,4,0,0,0,0,7,11
107678,9,85,8,0,0,0,0,11,19
163776,9,367,4,0,0,0,0,9,13
87997,7,232,6,0,0,0,0,15,21
647,10,911,14,1,0,0,0,28,43
48768,10,917,2,0,0,0,0,2,4
26692,9,380,6,0,0,0,0,18,24
130488,5,238,2,0,0,0,0,7,9
26827,10,799,0,0,0,0,0,6,6
117551,6,269,289,8,3,0,0,517,817
56958,9,405,4,0,0,0,0,3,7
123593,9,909,3,0,0,0,0,4,7
73065,6,232,2,0,0,0,0,3,5
35960,6,453,4,0,0,0,0,11,15
43736,8,562,7,0,0,0,0,22,29
17067,10,807,7,1,0,0,0,36,44
68721,9,158,4,0,0,0,0,9,13
109722,4,200,3,0,0,0,0,4,7
126127,8,124,2,0,0,0,0,0,2
78313,9,203,0,0,0,0,0,6,6
143675,9,203,0,0,0,0,0,4,4
50867,11,214,2,0,0,0,0,0,2
143341,10,66,4,0,0,0,0,5,9
85444,7,367,2,0,0,0,0,4,6
122069,10,60,4,0,0,0,0,6,10
163844,10,66,4,0,0,0,0,13,17
109560,9,570,9,0,0,0,0,19,28
55156,10,81,2,0,0,0,0,3,5
109219,10,716,10,0,0,0,0,14,24
84573,9,575,15,0,0,0,0,34,49
163117,9,184,8,1,0,0,0,27,36
150275,9,184,8,0,0,0,0,14,22
151507,9,184,8,0,0,0,0,10,18
146317,7,508,4,0,0,0,0,5,9
43100,11,214,9,0,0,0,0,13,22
63518,4,800,4,0,0,0,0,3,7
166747,5,200,1,0,0,0,0,1,2
153883,11,489,6,2,0,0,0,10,18
9425,4,800,7,0,0,0,0,9,16
104921,8,885,128,0,0,0,3,174,305
46813,8,244,2,0,0,0,0,3,5
124383,9,640,11,1,0,0,0,18,30
51855,9,457,3,0,0,0,0,8,11
160159,6,235,108,0,0,0,1,196,305
43173,7,896,10,0,0,0,0,34,44
114639,10,66,1,0,0,0,0,2,3
110069,10,66,1,0,0,0,0,1,2
52311,4,800,2,0,0,0,0,1,3
126194,7,489,796,33,15,8,5,1624,2481
107439,10,911,40,1,0,1,1,107,150
134686,10,81,1,1,0,0,0,2,4
42297,10,911,7,1,1,0,0,42,51
104745,6,447,624,11,3,0,3,1004,1645
97601,9,483,2,0,0,0,0,9,11
166760,9,640,84,15,2,0,1,141,243
27270,7,611,4,0,0,0,0,9,13
70121,11,545,15,1,0,0,0,16,32
51201,11,800,60,3,0,0,0,63,126
168141,10,81,4,0,0,0,0,7,11
63291,9,145,4,0,0,0,0,5,9
82295,9,202,4,0,0,0,0,5,9
19161,7,202,10,0,0,0,0,13,23
32967,9,43,2,0,0,0,0,3,5
15218,10,820,2,0,0,0,0,8,10
130918,10,355,13,0,0,0,0,34,47
156462,9,873,2,0,0,0,0,4,6
80102,9,873,2,0,0,0,0,4,6
130982,9,6,6,0,0,0,0,18,24
74615,8,403,2,0,0,0,0,2,4
108013,8,306,2,0,0,0,0,3,5
103785,11,306,2,0,0,0,0,1,3
34060,8,306,2,0,0,0,0,2,4
91942,9,100,2,0,0,0,0,4,6
7616,8,693,5,0,0,0,0,22,27
139811,9,456,2,0,0,0,0,3,5
67678,9,456,2,0,0,0,0,3,5
169651,9,456,2,0,0,0,0,3,5
143515,9,842,2,0,0,0,0,2,4
34468,9,577,2,0,0,0,0,4,6
82849,9,577,3,0,0,0,0,5,8
21931,9,577,2,0,0,0,0,5,7
7477,9,575,9,0,0,0,0,17,26
15545,9,657,6,0,0,0,0,11,17
54475,7,587,59,0,0,1,0,43,103
145168,9,630,2,0,0,0,0,2,4
8040,5,200,55,1,0,0,0,61,117
89972,7,611,1,0,0,0,0,1,2
20666,9,131,3,0,0,0,0,4,7
42740,11,489,2,0,0,0,0,1,3
20387,11,800,2,0,0,0,0,1,3
153174,8,812,1,0,0,0,0,0,1
146925,9,885,2,0,0,0,0,3,5
150492,6,306,2843,68,27,2,16,4903,7859
145509,7,587,20,1,0,0,0,31,52
71670,10,63,2,0,0,0,0,6,8
52776,5,78,4,0,0,0,0,5,9
83440,4,159,46,1,1,0,1,79,128
136422,6,269,9,0,0,0,0,4,13
3743,11,214,2,0,0,0,0,2,4
67874,5,200,14,0,0,0,0,23,37
35932,9,65,2,0,0,0,0,4,6
123502,9,65,1,0,0,0,0,2,3
27139,11,545,6,0,0,0,0,3,9
45669,6,306,2166,40,12,2,9,3689,5918
122352,5,306,2,0,0,0,0,4,6
137459,9,630,1,0,0,0,0,0,1
73783,9,65,1,0,0,0,0,2,3
70109,9,65,3,0,0,0,0,6,9
126585,9,462,20,0,0,0,0,52,72
39961,9,353,2,0,0,0,0,2,4
15560,7,56,14,1,1,0,0,23,39
68985,7,737,4,1,1,0,0,4,10
48016,4,375,12,0,0,0,0,24,36
54167,10,628,7,0,0,0,0,10,17
48552,4,885,11,0,0,0,0,24,35
120328,7,641,16,0,0,0,0,34,50
159741,7,669,10,1,1,0,0,16,28
43703,7,669,4,0,0,0,0,5,9
115137,8,214,2,0,0,0,0,4,6
96246,9,819,51,0,0,0,0,110,161
53261,8,800,776,27,10,0,4,1500,2317
51182,9,314,6,0,0,0,0,7,13
128185,9,483,13,1,0,0,1,40,55
55615,9,750,6,0,0,0,0,7,13
94007,11,214,4,0,0,0,0,4,8
71396,4,885,1,0,0,0,0,1,2
3227,11,623,5,0,0,0,0,2,7
23918,11,214,4,0,0,0,0,2,6
598,8,857,1,0,0,0,0,1,2
162584,4,159,11,0,0,0,0,13,24
123767,11,214,7,0,0,0,0,7,14
118851,8,306,2,0,0,0,0,0,2
66990,9,302,7,1,1,0,0,11,20
97770,8,306,3,0,0,0,0,0,3
124995,4,174,30,0,0,0,0,61,91
164725,9,632,3,0,0,0,0,5,8
139360,9,89,8,0,0,0,0,8,16
149203,9,246,41,0,0,0,0,70,111
14738,9,89,2,0,0,0,0,2,4
27126,9,89,6,0,0,0,0,9,15
120310,9,89,5,0,0,0,0,4,9
129876,9,89,2,0,0,0,0,2,4
44494,9,89,4,0,0,0,0,11,15
67541,8,214,1,0,0,0,0,0,1
155491,9,89,4,0,0,0,0,4,8
79215,6,729,3,0,0,0,0,4,7
101721,11,214,4,1,0,0,0,6,11
4333,8,800,681,5,4,0,3,1267,1960
128336,8,214,2,0,0,0,0,1,3
5182,9,302,6,0,0,0,0,7,13
30417,4,675,3,0,0,0,0,2,5
84173,8,214,1,0,0,0,0,2,3
29896,9,741,2,0,0,0,0,2,4
85979,4,658,3,0,0,0,0,4,7
161753,9,4,4,0,0,0,0,7,11
99742,9,302,4,0,0,0,0,7,11
169122,4,800,34,0,0,0,0,53,87
85937,9,405,1,0,1,0,0,1,3
10423,8,658,2,0,0,0,0,1,3
89601,8,306,2,0,0,0,0,2,4
90248,9,570,5,0,0,0,0,9,14
133018,10,555,3,0,0,0,0,19,22
67280,9,246,1,0,0,0,0,0,1
497,9,202,3,0,0,0,0,2,5
105380,8,812,5,0,0,0,0,10,15
48480,9,632,1,0,0,0,0,2,3
61593,7,367,2,0,0,0,0,5,7
105046,7,384,3,0,0,0,0,6,9
124136,7,384,6,0,0,0,0,16,22
80761,7,226,3,0,0,0,0,2,5
65163,7,226,2,0,0,0,0,3,5
136864,7,226,4,0,0,0,0,6,10
90658,7,384,39,1,0,0,0,90,130
165441,7,384,2,0,0,0,0,2,4
3318,8,545,2457,65,30,2,13,4388,6955
46126,8,214,107,0,0,0,1,179,287
41618,6,489,1285,31,9,2,8,2093,3428
7836,8,800,317,5,2,1,4,514,843
165228,10,413,1,0,0,0,0,2,3
153030,10,413,1,0,0,0,0,2,3
130528,10,413,1,0,0,0,0,2,3
114967,8,885,184,3,2,0,2,294,485
15296,8,800,1,0,0,0,0,1,2
118890,11,489,2,0,0,0,0,2,4
100393,6,200,4,0,0,0,0,10,14
10409,7,552,66,0,0,0,1,97,164
72651,7,552,128,1,0,0,0,213,342
100979,10,898,2,1,2,0,0,3,8
140507,5,58,14,1,1,0,0,27,43
168028,10,628,1,0,0,0,0,2,3
170144,7,489,16,0,0,0,0,35,51
96405,8,693,1,0,0,0,0,0,1
95204,10,628,5,0,0,0,0,11,16
105671,8,489,3,0,0,0,0,1,4
17361,10,653,184,2,0,0,0,398,584
19980,8,30,1,0,0,0,0,1,2
141442,7,641,68,0,0,0,0,129,197
31780,7,641,16,0,0,0,0,32,48
109044,7,521,29,1,1,0,0,51,82
114771,5,218,11,0,0,2,0,16,29
23028,4,885,1,0,0,0,0,1,2
151418,9,405,6,0,0,0,0,9,15
163137,7,587,283,8,6,1,1,437,736
89768,9,640,2,0,0,0,0,5,7
147891,8,214,2,0,0,0,0,2,4
160520,8,812,4,0,0,0,0,0,4
34601,10,831,4,1,0,0,0,15,20
25196,8,214,1,0,0,0,0,0,1
116698,7,660,9,0,0,0,0,22,31
14376,7,387,4,0,0,0,0,7,11
3354,10,200,3,0,0,0,0,7,10
88021,7,254,22,2,0,0,0,30,54
32440,7,842,2,0,0,0,0,2,4
153111,11,812,2,0,0,0,0,0,2
159327,7,551,1,0,0,0,0,2,3
61898,10,413,20,0,0,0,0,21,41
32794,10,355,0,0,0,0,0,8,8
163585,9,640,6,0,0,0,0,11,17
131981,6,885,9,0,0,0,0,24,33
30049,11,214,11,0,0,0,0,10,21
120804,9,630,2,0,0,0,0,2,4
47132,9,630,1,0,0,0,0,2,3
28897,10,322,3,0,0,0,0,4,7
115825,7,306,3,0,0,0,0,2,5
70262,9,800,13,0,0,0,0,32,45
4182,9,487,9,0,0,0,0,18,27
147380,9,487,2,0,0,0,0,3,5
114492,9,630,2,0,0,0,0,0,2
148695,11,489,2,0,0,0,0,2,4
108135,9,202,6,0,0,0,0,11,17
135410,4,375,1,0,0,0,0,0,1
156026,7,611,2,0,0,0,0,2,4
150413,7,118,2,0,0,0,0,7,9
13933,8,545,692,27,12,0,4,1347,2082
89150,6,159,17,0,0,0,0,34,51
56544,8,489,7,0,0,0,0,6,13
140475,10,917,10,0,0,0,0,10,20
2264,5,893,2,0,0,0,0,4,6
47643,7,471,1,0,0,0,0,1,2
106026,9,100,4,0,0,0,0,6,10
48554,8,812,147,1,1,0,0,456,605
77056,9,399,14,0,0,0,0,9,23
13152,9,658,2,0,0,0,0,3,5
5070,9,658,5,0,0,0,0,12,17
55873,9,341,23,0,0,1,0,26,50
65138,9,175,5,0,0,0,0,7,12
24441,9,306,3,0,0,0,0,3,6
68811,6,200,2,0,0,0,0,3,5
162190,9,456,1,0,0,0,0,1,2
54944,6,489,358,2,1,0,1,612,974
159931,11,812,1,0,0,0,0,3,4
86544,11,812,0,0,0,0,0,2,2
152932,6,821,8,0,0,0,0,31,39
90314,7,489,117,3,3,0,1,273,397
95442,9,632,14,0,0,0,0,27,41
141913,9,203,2,0,0,0,0,3,5
117476,7,391,12,0,0,0,0,25,37
29184,11,214,2,0,0,0,0,2,4
6868,8,545,593,45,24,0,6,1411,2079
83322,9,589,32,0,0,0,0,42,74
96579,7,492,3,0,0,0,0,10,13
139571,11,812,2,0,0,0,0,2,4
128457,7,246,2,0,0,0,0,7,9
77395,8,801,2,0,0,0,0,2,4
156544,10,653,5,0,0,0,0,12,17
68869,7,535,5,0,0,0,0,12,17
107099,9,65,4,0,0,0,0,6,10
7693,9,538,10,0,0,0,0,21,31
115171,10,653,2,0,0,0,0,1,3
154968,9,622,2,0,0,0,0,4,6
28072,4,124,2,0,0,0,0,1,3
52844,9,175,12,0,0,0,0,11,23
169563,6,306,1,0,0,0,0,1,2
30427,8,693,14,0,0,0,3,28,45
31274,6,885,76,1,1,0,0,132,210
111020,10,66,24,0,0,0,0,36,60
91983,8,885,1,0,0,0,0,4,5
146785,4,200,2,0,0,0,0,2,4
83584,9,658,2,0,0,0,0,7,9
170463,9,658,4,0,0,0,0,7,11
134643,9,658,8,0,0,0,0,8,16
72127,9,353,1,0,0,0,0,2,3
65721,6,141,8,0,0,0,0,14,22
139882,9,302,5,0,0,0,0,3,8
35369,9,472,1,0,0,0,0,1,2
148032,6,200,23,0,0,0,0,36,59
16265,7,521,7,0,0,0,0,11,18
107030,7,157,2,0,0,0,0,4,6
19152,9,469,4,0,0,0,0,7,11
31330,4,36,4,0,0,0,0,8,12
167623,9,313,25,0,0,0,0,39,64
115210,8,885,115,2,0,0,0,193,310
112864,4,923,1,0,0,0,0,0,1
4869,4,159,5,0,0,0,0,5,10
94180,9,202,2,0,0,0,0,2,4
60698,9,202,2,0,0,0,0,2,4
54789,6,124,103,0,0,0,0,155,258
88347,9,607,6,0,0,0,0,9,15
45899,9,341,6,0,0,0,0,13,19
115273,9,640,1,0,0,0,0,2,3
107101,5,667,17,0,0,0,1,25,43
9748,5,78,2,0,0,0,0,3,5
91982,7,669,8,0,0,0,0,19,27
166660,7,669,0,0,0,0,0,4,4
393,7,587,17,0,0,0,0,31,48
88200,6,585,1,0,0,0,0,1,2
140438,4,885,2,0,0,0,0,8,10
120406,9,556,1,0,0,0,0,4,5
5563,9,909,3,0,1,0,0,6,10
129570,10,790,19,3,0,1,0,31,54
14772,8,214,153,0,0,0,1,271,425
145481,8,214,3,0,0,0,0,19,22
135520,10,799,1,0,0,0,0,1,2
9847,10,799,1,0,0,0,0,3,4
138299,11,214,4,0,0,0,0,4,8
88340,9,353,1,0,0,0,0,0,1
94319,9,353,1,0,0,0,0,0,1
138543,11,214,2,0,0,0,0,3,5
28941,9,302,7,0,0,0,0,12,19
86130,8,403,233,9,1,0,1,423,667
144477,4,200,1,0,0,0,0,1,2
27433,10,798,4,0,0,0,0,3,7
147995,7,669,5,0,0,0,0,15,20
53346,9,489,2930,92,35,7,17,4633,7714
21855,5,505,4,0,0,0,0,8,12
126885,10,911,30,1,1,0,0,94,126
81084,6,514,8,0,0,0,0,14,22
167183,5,505,2,0,0,0,0,3,5
145040,7,149,2,0,0,0,0,4,6
130747,8,214,1,0,0,0,0,0,1
55946,9,570,4,0,0,0,0,7,11
72972,9,203,2,0,0,0,0,4,6
92681,7,384,2,0,0,0,0,4,6
61248,9,367,2,0,0,0,0,4,6
60511,7,384,1,0,0,0,0,3,4
114206,11,623,2,1,0,0,0,2,5
136683,10,322,3,5,1,0,0,6,15
94259,6,306,1,0,0,0,0,3,4
169598,9,325,2,0,0,0,0,3,5
75493,9,216,3,0,0,0,0,3,6
3402,7,489,1,0,0,0,0,0,1
167515,7,207,7,0,0,0,0,13,20
90600,7,587,59,3,2,0,0,76,140
143428,7,829,4,0,0,0,0,5,9
4540,8,489,1,0,0,0,0,0,1
55231,9,632,4,0,0,0,0,9,13
32242,9,243,0,1,1,0,0,0,2
33680,9,630,5,0,0,0,0,8,13
45266,10,831,7,0,0,0,0,9,16
117174,10,322,1,0,0,0,0,0,1
84214,7,79,4,0,0,0,0,7,11
55005,7,157,19,0,0,2,0,29,50
153155,8,885,154,3,2,0,2,301,462
41506,4,36,1,0,0,0,0,1,2
39953,6,159,1,0,0,0,0,0,1
153499,9,302,5,0,0,0,0,6,11
153675,8,214,1,0,0,0,0,0,1
152669,8,214,1,0,0,0,0,0,1
74189,8,214,1,0,0,0,0,0,1
109616,8,214,10,0,0,0,0,15,25
149731,7,521,1,0,0,0,0,1,2
104605,8,545,555,34,14,1,2,1111,1717
121458,6,124,66,0,0,0,0,137,203
18450,8,545,2,0,0,0,0,0,2
93108,8,693,9,0,0,0,0,13,22
56547,9,462,2,0,0,0,0,3,5
134731,5,800,17,0,0,0,0,19,36
19539,8,623,2,0,0,0,0,0,2
133862,5,76,17,0,0,0,0,27,44
28743,8,403,1,0,0,0,0,1,2
40456,6,643,1,0,0,0,0,0,1
87334,9,457,4,0,0,0,0,4,8
61604,8,812,1,0,0,0,0,0,1
114043,4,200,23,0,0,0,0,51,74
148921,4,174,1,0,0,0,0,1,2
26895,7,861,9,0,0,0,0,24,33
89874,8,214,288,3,1,0,0,438,730
127211,5,106,1,0,0,0,0,0,1
114662,7,563,4,0,0,0,0,6,10
26860,9,374,2,0,0,0,0,3,5
13508,9,374,4,0,0,0,0,3,7
19586,4,800,190,7,3,0,0,357,557
82986,9,800,6,0,0,0,0,164,170
48575,9,630,52,3,2,0,0,103,160
82964,10,798,6,0,0,0,0,5,11
169475,7,202,4,0,0,0,0,10,14
30549,7,611,4,0,0,0,0,6,10
27804,10,256,101,3,1,1,0,135,241
26995,8,403,2,0,0,0,0,3,5
102120,9,494,5,0,0,0,0,5,10
82113,9,175,20,0,6,0,0,25,51
7322,10,60,4,0,0,0,0,8,12
164881,9,30,3,0,0,0,0,4,7
115075,9,405,4,0,0,0,0,6,10
62935,8,214,2,0,0,0,0,3,5
108627,9,100,40,4,2,1,0,64,111
26097,9,202,4,0,0,0,0,5,9
78999,9,202,4,0,0,0,0,6,10
134952,4,780,1,0,0,0,0,2,3
147337,7,587,21,2,2,0,0,38,63
102013,9,202,2,0,0,0,0,2,4
49268,9,405,2,0,0,0,0,3,5
13114,8,489,2,0,0,0,0,10,12
54111,7,892,4,0,0,0,0,3,7
168391,5,76,66,4,0,0,0,82,152
151503,7,587,51,3,1,0,0,71,126
165128,11,489,7,0,0,0,0,5,12
53776,7,587,103,4,1,1,0,116,225
68935,9,693,27,0,0,0,0,31,58
81390,7,492,1,0,0,0,0,1,2
109498,10,917,1,0,0,0,0,1,2
82946,9,405,1,0,0,0,0,1,2
33910,7,521,4,0,0,0,0,6,10
60825,7,367,9,0,0,0,0,12,21
90696,8,214,398,10,4,0,1,709,1122
114333,8,214,596,13,3,1,1,934,1548
131830,9,838,2,0,0,0,0,3,5
168702,9,838,2,0,0,0,0,3,5
17625,9,65,1,1,1,0,0,2,5
11460,9,131,2,0,0,0,0,3,5
46447,8,545,41,0,0,0,0,70,111
84698,7,611,8,0,0,0,0,13,21
26473,7,861,7,0,0,0,0,11,18
47180,5,293,95,1,1,0,0,170,267
133372,7,157,6,0,0,0,0,16,22
108391,11,214,2,0,0,0,0,0,2
41799,10,322,4,0,0,0,0,7,11
124301,9,457,2,0,0,0,0,2,4
127937,7,254,4,0,0,0,0,6,10
147697,10,917,2,0,0,0,0,2,4
11144,10,917,2,0,0,0,0,2,4
166531,10,917,2,0,0,0,0,2,4
106221,9,489,8,0,0,0,0,9,17
107425,9,570,29,0,0,0,0,53,82
107891,5,238,5,0,0,0,0,10,15
151153,9,65,4,0,0,0,0,5,9
69856,9,65,5,0,0,0,0,6,11
105117,9,65,1,0,0,0,0,3,4
153322,9,145,0,0,0,0,0,3,3
80229,7,744,1,0,0,0,0,0,1
48182,7,744,1,0,0,0,0,3,4
150754,9,489,2,0,0,0,0,0,2
7296,9,838,2,0,0,0,0,1,3
95832,4,199,2,0,0,0,0,4,6
45087,9,538,8,1,1,0,0,11,21
153519,8,693,21,0,0,0,1,37,59
6669,10,781,2,0,0,0,0,4,6
122519,9,630,2,0,0,0,0,1,3
40257,7,163,1,0,0,0,0,4,5
39143,7,196,14,1,1,0,0,14,30
35710,10,413,2,0,0,0,0,2,4
50719,7,521,1,0,0,0,0,2,3
108880,4,581,3,0,0,0,0,4,7
40052,8,214,403,3,2,0,0,648,1056
818,10,29,2,0,0,0,0,2,4
16235,9,374,17,0,0,9,0,28,54
153296,7,56,1,0,0,0,0,1,2
27695,6,489,270,15,4,1,0,479,769
162853,9,145,0,0,0,0,0,7,7
68919,9,374,8,0,0,6,0,13,27
51190,8,489,1,0,0,0,0,1,2
134739,7,306,9,0,0,0,0,11,20
86270,9,306,1,0,0,0,0,0,1
125462,7,211,17,1,1,0,0,33,52
27359,7,211,2,0,0,0,0,1,3
57855,7,492,20,0,0,0,0,28,48
167663,8,214,42,0,0,0,0,75,117
139971,4,365,6,0,0,0,0,14,20
41661,9,216,18,1,1,0,0,32,52
81723,9,216,7,1,1,0,0,11,20
101401,9,216,6,1,1,0,0,10,18
45636,7,755,1,0,0,0,0,2,3
1633,4,885,522,7,2,0,1,1017,1549
147197,8,403,2,0,0,0,0,5,7
140495,11,403,1,0,0,0,0,0,1
63536,7,563,40,8,1,0,0,156,205
82344,7,563,13,3,2,0,0,65,83
130228,10,60,2,0,0,0,0,3,5
147637,6,78,2,0,0,0,0,3,5
158718,9,819,1,0,0,0,0,1,2
63137,4,200,10,0,0,0,0,9,19
92807,9,145,8,0,0,0,0,18,26
1591,6,200,22,0,0,0,0,16,38
159523,9,489,11,0,0,0,0,22,33
93071,8,489,1,0,0,0,0,2,3
154424,6,489,7,4,0,0,0,10,21
136869,10,798,4,0,0,0,0,7,11
134437,7,211,0,0,0,1,0,0,1
161386,7,211,0,0,0,1,0,0,1
27498,7,805,6,0,0,0,0,9,15
50627,4,453,110,2,0,1,1,209,323
97410,4,658,26,0,0,0,0,50,76
65833,7,228,8,0,0,1,0,11,20
16077,11,214,9,0,0,0,0,8,17
115911,9,306,1,0,0,0,0,2,3
169038,7,77,143,7,2,3,2,298,455
134172,9,216,16,0,0,0,0,31,47
141332,10,66,3,0,0,0,0,5,8
68262,9,819,6,0,0,2,0,5,13
12475,9,819,7,0,0,2,0,12,21
117352,10,322,2,0,0,0,0,1,3
77924,7,24,1,0,0,0,0,0,1
106336,10,63,2,0,0,0,0,0,2
32646,6,556,1,0,0,0,0,0,1
75199,4,519,4,0,0,0,0,2,6
55715,8,800,2661,71,27,6,26,4809,7600
24264,7,263,4,0,0,0,0,6,10
116753,11,545,4,0,0,0,0,5,9
26447,7,805,2,0,0,0,0,5,7
50933,10,63,65,0,0,0,0,97,162
75462,9,4,4,1,0,0,0,5,10
451,11,214,8,0,0,0,0,10,18
55859,5,667,21,0,0,0,0,36,57
18338,9,158,2,0,0,0,0,3,5
117337,7,367,46,1,1,0,2,77,127
100286,10,217,5,0,0,0,0,7,12
126894,4,908,2,0,0,0,0,7,9
54022,7,157,15,0,0,0,0,9,24
103976,9,800,28,1,1,0,0,63,93
68455,11,403,4,0,0,0,0,6,10
153759,8,214,105,0,0,0,0,179,284
29570,5,200,11,0,0,0,0,15,26
27678,9,131,5,0,0,0,0,11,16
51660,4,752,2,0,0,0,0,3,5
165612,11,489,1,0,0,0,0,0,1
166901,5,66,4,0,0,0,0,2,6
4234,7,556,1,0,0,0,0,1,2
48576,9,556,4,0,0,0,0,5,9
135420,9,243,5,0,0,0,0,10,15
73671,5,76,26,0,0,0,0,33,59
26596,9,157,7,0,0,0,0,2,9
98895,9,630,10,0,0,0,0,4,14
48736,9,489,52,0,0,0,0,49,101
136860,7,822,6,0,0,0,0,9,15
6743,7,864,3,0,0,0,0,6,9
130673,9,630,7,0,0,0,0,20,27
87879,7,864,3,0,0,0,0,7,10
40402,7,521,1,0,0,0,0,0,1
75801,9,184,2,0,0,0,0,5,7
116438,9,630,783,31,13,2,5,1153,1987
153311,7,78,1,0,0,0,0,0,1
134093,7,496,10,0,0,0,0,14,24
42066,9,301,4,0,0,0,0,7,11
25112,7,842,1,0,0,0,0,0,1
10772,9,842,1,0,0,0,0,0,1
65527,9,819,5,0,0,0,0,10,15
61354,9,489,1,0,0,0,0,0,1
45375,10,798,2,0,0,0,0,4,6
143816,7,77,386,14,8,2,1,654,1065
114892,8,214,259,0,0,0,1,414,674
81821,9,842,18,0,0,0,0,14,32
106372,9,452,2,0,0,0,0,2,4
40396,9,374,7,0,0,6,0,9,22
121123,9,374,3,0,0,6,0,3,12
46295,9,374,1,0,0,6,0,0,7
100380,11,489,4,0,0,0,0,4,8
12198,9,873,0,0,0,0,0,4,4
63074,9,282,2,0,0,0,0,4,6
113997,8,885,70,0,0,0,1,107,178
24315,4,375,2,0,0,0,0,4,6
14250,5,821,5,0,0,0,1,11,17
145571,11,214,2,0,0,0,0,3,5
83008,11,214,6,1,0,0,0,2,9
132750,10,911,18,1,1,0,0,52,72
134756,11,403,0,1,0,0,0,0,1
93335,10,66,15,0,0,0,0,33,48
93685,10,66,1,0,0,0,0,1,2
15993,8,214,261,0,0,0,1,436,698
60630,9,838,0,0,0,0,0,4,4
89581,11,214,6,0,0,0,0,9,15
26668,9,535,2,0,0,0,0,6,8
37054,6,124,49,2,1,0,1,65,118
71461,8,214,101,0,0,0,1,189,291
68002,8,214,118,0,0,0,1,211,330
76784,7,755,18,0,0,0,0,38,56
87536,8,214,75,0,0,0,0,132,207
107867,9,405,2,0,0,0,0,3,5
111446,8,124,1,0,0,0,0,0,1
52713,9,658,4,0,0,0,0,12,16
125271,11,214,2,0,0,0,0,2,4
21396,8,214,115,0,0,0,1,190,306
15886,10,917,3,0,0,0,0,9,12
124259,10,917,2,0,0,0,0,4,6
113260,10,917,1,0,0,0,0,3,4
25487,6,290,1,0,0,0,0,2,3
73728,7,263,4,0,0,0,0,8,12
158992,11,693,1,0,0,0,0,1,2
168755,7,374,5,0,0,7,0,8,20
64687,7,374,12,0,0,7,0,21,40
93834,7,374,13,0,0,7,0,22,42
97585,9,367,5,0,0,0,0,11,16
158530,7,755,5,0,0,0,0,15,20
42706,4,519,3974,99,36,18,21,8529,12677
10247,8,885,173,3,0,0,2,261,439
97625,5,76,30,2,1,0,0,52,85
104540,9,575,1,0,0,0,0,0,1
165876,10,322,2,0,0,0,0,4,6
12252,7,552,27,0,0,0,0,61,88
76282,8,693,24,0,0,0,0,37,61
129317,4,388,6,0,0,0,0,10,16
141664,10,903,3,0,0,0,0,6,9
41937,7,157,3,0,0,0,0,10,13
109179,8,655,268,13,1,0,3,449,734
77137,10,289,1,0,0,0,0,3,4
90535,9,630,7,0,0,0,0,11,18
7325,11,214,2,0,0,0,0,2,4
165454,8,800,191,15,3,1,1,400,611
48943,5,821,9,0,0,0,0,15,24
71303,11,885,2,0,0,0,0,0,2
28303,9,457,2,0,0,0,0,3,5
69946,9,4,5,0,0,0,0,5,10
123687,7,77,167,6,2,0,0,239,414
139119,5,479,5735,134,51,25,48,11646,17639
63055,7,77,15,0,0,0,0,22,37
109167,8,214,119,0,0,0,0,250,369
63373,9,374,33,0,0,10,0,60,103
66777,9,306,1,0,0,0,0,0,1
114000,5,783,7,0,0,0,0,8,15
84337,7,611,1,0,0,0,0,1,2
109012,8,693,12,0,0,0,1,25,38
619,5,200,9,0,0,0,0,14,23
11554,11,214,1,0,0,0,0,0,1
158115,9,684,2,0,0,0,0,6,8
132283,9,684,1,0,0,0,0,2,3
121504,9,630,450,11,3,4,5,719,1192
96069,6,885,43,0,0,0,1,80,124
98846,9,469,13,0,0,0,0,19,32
41669,8,214,15,0,0,0,0,23,38
30138,9,489,8,0,0,0,0,10,18
20497,8,693,1,0,0,0,0,1,2
157838,8,800,61,1,1,0,1,98,162
141825,8,489,2,0,0,0,0,2,4
121547,8,800,1,0,0,0,0,0,1
164226,5,479,3,0,0,0,0,3,6
16711,9,489,104,2,0,0,0,34,140
157105,8,800,1,0,0,0,0,0,1
116019,10,81,2,0,0,0,0,3,5
119289,10,81,1,0,0,0,0,2,3
59963,5,78,1,0,0,0,0,0,1
116294,6,200,20,1,0,0,0,51,72
124714,8,800,121,6,1,0,1,180,309
145402,6,174,0,0,0,0,0,1,1
163492,5,699,2,0,0,0,0,3,5
99199,9,487,4,0,0,0,0,7,11
108974,9,640,26,0,0,0,0,35,61
147331,9,246,3,0,0,0,0,3,6
123960,4,375,1,0,0,0,0,2,3
100666,7,488,8,0,0,0,0,14,22
76640,5,159,137,4,3,0,1,273,418
112456,10,60,4,0,0,0,0,6,10
63380,5,118,7,0,0,0,0,11,18
82754,9,630,37,0,0,0,0,88,125
81720,9,380,54,4,3,1,0,72,134
94093,9,85,2,0,0,0,0,4,6
545,7,508,2,0,0,0,0,13,15
130022,8,800,203,7,1,1,1,308,521
10830,8,214,89,2,0,0,0,142,233
991,8,800,58,1,0,0,0,141,200
55345,5,76,25,0,0,0,0,42,67
151796,8,800,1,0,0,0,0,0,1
88140,9,597,4,0,0,0,0,7,11
10185,5,518,5,0,0,0,0,9,14
102885,5,561,1,0,0,0,0,0,1
43171,7,521,8,0,0,0,0,17,25
26282,9,65,1,0,0,0,0,2,3
83932,9,65,1,0,0,0,0,1,2
39925,11,214,1,0,0,0,0,0,1
54769,9,399,1,0,0,0,0,2,3
20332,9,912,4,0,0,0,0,10,14
38888,9,741,6,0,0,0,0,15,21
111876,8,800,387,15,4,0,1,600,1007
44437,8,545,1,0,0,0,0,0,1
157558,9,302,2,0,0,0,0,4,6
740,7,306,834,19,8,4,6,2990,3861
127368,10,60,24,0,0,0,0,56,80
25716,9,375,4,0,0,0,0,1,5
36335,10,618,4,0,0,0,0,13,17
85231,9,873,2,0,0,0,0,7,9
131006,9,873,2,0,0,0,0,5,7
47747,10,618,2,0,0,0,0,4,6
15932,9,873,2,0,0,0,0,4,6
73448,4,159,19,1,1,0,0,32,53
49699,9,873,24,0,0,0,1,27,52
7537,5,78,1,0,0,0,0,1,2
140915,8,655,741,28,7,0,6,1262,2044
62345,9,483,0,0,0,0,0,19,19
14077,9,741,2,0,0,0,0,4,6
166001,5,489,1,0,0,0,0,4,5
51509,7,563,17,0,0,0,0,19,36
136373,9,483,2,0,0,0,0,3,5
128007,9,483,2,0,0,0,0,3,5
126496,7,648,159,2,0,1,0,290,452
90118,4,885,80,0,0,0,1,154,235
44077,5,76,16,2,0,0,0,44,62
104277,11,214,2,1,0,0,0,0,3
14284,7,744,25,0,0,0,0,47,72
160460,9,374,10,0,0,10,0,16,36
82875,9,374,13,0,0,10,0,20,43
135229,5,479,19,0,0,0,0,26,45
18258,10,322,2,0,0,0,0,0,2
111200,10,322,3,0,0,0,0,3,6
7727,9,545,5,0,0,0,0,0,5
18162,10,60,2,0,0,0,0,3,5
82976,10,111,2,0,0,0,0,6,8
53031,9,78,6,0,0,0,0,12,18
51087,6,200,19,2,1,0,0,28,50
109244,9,78,12,0,0,0,0,28,40
105031,6,51,260,15,6,2,0,509,792
31900,10,355,5,0,0,0,0,5,10
90221,9,86,1,0,0,0,0,1,2
126831,4,306,2297,91,24,25,8,4192,6637
134774,5,225,16,0,0,0,0,24,40
67785,7,79,29,1,0,0,0,51,81
76488,9,873,4,0,0,0,0,6,10
15472,11,124,1,0,0,0,0,0,1
66111,8,124,1,0,0,0,0,3,4
9220,8,214,49,0,0,0,1,76,126
76623,8,214,49,0,0,0,0,86,135
84609,9,842,22,0,0,0,0,38,60
67270,8,800,2,0,0,0,0,3,5
159115,9,158,4,1,1,0,0,11,17
4109,9,367,2,0,0,0,0,5,7
80562,8,885,1,0,0,0,0,0,1
76630,9,874,6,0,0,0,0,8,14
58331,4,200,6,0,0,0,0,22,28
73349,7,508,11,0,0,0,0,27,38
12712,8,800,74,2,0,0,0,146,222
61779,4,453,1,0,0,0,0,2,3
389,7,693,11,0,0,0,0,16,27
43125,7,460,18,0,0,0,0,34,52
7194,7,460,2,0,0,0,0,5,7
6630,11,214,7,0,0,0,0,9,16
134665,8,489,3,0,0,0,0,5,8
137505,8,214,49,1,1,0,0,71,122
114438,9,640,49,0,0,0,0,81,130
57309,9,630,77,0,1,0,0,126,204
167399,11,214,6,0,0,0,0,7,13
52404,9,873,21,1,2,0,0,41,65
155888,5,489,65,3,2,0,0,107,177
26030,10,555,13,0,0,0,0,26,39
84662,10,355,6,0,0,0,0,16,22
118119,11,623,4,0,0,0,0,4,8
52656,5,181,146,5,2,0,3,260,416
76701,10,87,20,0,0,0,0,30,50
23835,9,175,1,0,0,0,0,1,2
29694,9,100,13,2,0,0,0,8,23
99845,9,483,4,0,0,0,0,6,10
66238,8,489,1,0,0,0,0,0,1
6265,7,384,2,0,0,0,0,4,6
131628,5,800,15,0,0,0,0,16,31
39987,10,903,2,0,0,0,0,3,5
114774,10,903,7,0,0,0,0,6,13
156964,8,489,4,0,0,0,0,3,7
7162,11,214,6,0,0,0,0,7,13
105503,10,903,4,0,0,0,0,4,8
69491,8,658,2,0,0,0,0,4,6
8107,11,658,2,0,0,0,0,3,5
127247,9,89,2,0,0,0,0,4,6
159971,7,587,36,2,0,0,0,58,96
70101,9,457,4,0,0,0,0,9,13
96024,9,457,6,0,0,0,0,8,14
67051,9,630,8,0,0,0,0,38,46
122992,9,457,2,0,0,0,0,3,5
2162,8,306,1,0,0,0,0,5,6
73063,5,479,1,0,0,0,0,0,1
26530,9,202,4,0,0,0,0,6,10
67182,4,375,5,0,0,0,0,18,23
139395,8,214,1,0,0,0,0,0,1
131324,6,789,8,0,0,0,0,11,19
73053,5,479,145,1,0,0,0,254,400
11989,4,375,2,0,0,0,0,3,5
16730,9,452,6,1,1,0,0,14,22
3879,10,628,1,0,0,0,0,1,2
49450,8,489,2,0,0,0,0,0,2
70758,9,909,2,0,0,0,0,3,5
114609,8,214,163,0,0,0,0,303,466
9385,11,214,6,0,0,0,0,5,11
4348,9,489,21,1,1,0,0,42,65
26761,8,124,0,0,0,0,0,1,1
28562,9,302,4,0,0,0,0,6,10
149603,9,302,2,0,0,0,0,7,9
105074,5,76,92,2,1,0,0,123,218
47654,5,76,35,0,0,0,0,57,92
88748,4,890,17,0,0,0,0,36,53
105153,5,159,27,1,1,0,0,42,71
85137,9,556,1,0,0,0,0,0,1
20241,4,200,7,0,0,0,0,10,17
39418,4,200,2,0,0,0,0,4,6
167178,8,489,1,0,0,0,0,0,1
161456,8,489,1,0,0,0,0,0,1
18156,11,214,8,0,0,0,0,10,18
75229,5,306,1,0,0,0,0,1,2
7670,10,208,4,0,0,0,0,11,15
67126,7,100,7,0,0,0,0,13,20
161034,7,118,1,0,0,0,0,4,5
136539,9,489,20,0,0,0,0,41,61
70913,10,66,2,0,0,0,0,6,8
15871,10,111,0,0,0,0,0,4,4
7235,10,66,2,0,0,0,0,4,6
133217,7,306,4,0,0,0,0,4,8
55260,9,341,4,0,0,0,0,5,9
12067,9,341,2,0,0,0,0,2,4
118443,5,375,2,0,0,0,0,3,5
155464,11,545,18,0,0,0,0,21,39
104037,7,263,1,0,0,0,0,1,2
66026,9,873,3,0,0,0,0,4,7
85663,9,873,1,0,0,0,0,0,1
160630,9,873,1,0,0,0,0,0,1
145202,9,873,3,0,0,0,0,4,7
161387,9,800,24,2,2,0,0,43,71
45944,5,667,1,0,0,0,0,0,1
27375,5,667,20,0,0,0,0,37,57
106210,5,479,134,5,2,0,1,239,381
127072,9,65,4,0,0,0,0,12,16
11040,9,796,5,0,0,0,0,8,13
84221,9,145,2,0,0,0,0,4,6
44415,9,706,2,0,0,0,0,4,6
170471,9,828,2,0,0,0,0,4,6
86814,11,623,2,0,0,0,0,2,4
47544,4,752,1,0,0,0,0,0,1
34738,10,555,2,0,0,0,0,4,6
158467,7,492,2,0,0,0,0,14,16
104829,7,492,6,1,0,1,0,12,20
143021,9,640,62,0,0,0,0,111,173
97551,7,492,1,0,0,0,0,1,2
2701,5,78,1,0,0,0,0,2,3
142018,9,472,2,0,0,0,0,3,5
30143,9,640,13,0,0,0,0,11,24
116341,5,76,39,0,0,0,0,53,92
84412,6,124,38,1,1,0,0,72,112
96834,9,282,1,0,0,0,0,1,2
2739,6,124,16,0,0,0,0,22,38
92595,10,911,1,0,0,0,0,1,2
32623,9,457,10,0,0,0,0,15,25
87543,9,796,1,0,0,0,0,2,3
123501,8,800,18,0,0,0,0,34,52
114023,8,30,1,0,0,0,0,0,1
89734,9,77,14,0,0,0,0,22,36
119063,7,748,6,0,0,0,0,4,10
154078,7,367,8,0,0,0,0,11,19
44512,9,873,4,0,0,0,0,7,11
68643,7,367,8,0,0,0,0,8,16
60990,7,658,12,0,0,0,0,14,26
96401,8,484,141,4,0,0,2,245,392
44285,9,658,2,0,0,0,0,3,5
97053,9,535,4,0,0,0,0,4,8
136197,9,538,7,0,0,0,0,8,15
46055,5,124,1,0,0,0,0,2,3
86431,4,453,1,0,0,0,0,0,1
86472,6,200,48,2,2,0,0,92,144
22147,10,523,2,0,0,0,0,11,13
56849,10,523,2,0,0,0,0,18,20
35160,10,178,9,0,0,0,0,12,21
77161,9,6,6,0,0,0,0,10,16
150865,9,6,2,0,0,0,0,2,4
35463,6,800,124,11,2,0,0,238,375
63335,9,819,16,0,0,0,0,29,45
39790,7,755,6,0,0,0,0,11,17
132291,6,269,2,0,0,0,0,1,3
14525,9,6,2,0,0,0,0,4,6
133115,5,76,6,0,0,0,0,11,17
33038,9,842,2,0,0,0,0,5,7
143896,10,29,2,0,0,0,0,4,6
97198,8,800,14,0,0,0,0,37,51
150345,4,885,6,0,0,0,0,15,21
81660,4,885,3,0,0,0,0,7,10
104060,7,508,16,0,0,0,0,37,53
158172,7,508,3,0,0,0,0,8,11
42121,10,820,0,0,0,0,0,8,8
129643,10,820,0,0,0,0,0,7,7
131393,6,235,4,0,0,0,0,8,12
18756,7,909,34,2,0,0,0,62,98
76593,4,174,6,0,0,0,0,5,11
49957,8,214,1,0,0,0,0,0,1
155078,8,214,113,3,1,0,0,205,322
48752,6,124,54,3,2,0,0,107,166
5444,7,228,16,0,0,0,0,25,41
58254,4,200,6,0,0,0,0,0,6
75318,5,655,54,0,0,0,0,71,125
55572,5,225,7,0,0,0,0,10,17
144539,10,917,0,0,0,0,0,8,8
35119,5,200,10,0,0,0,0,15,25
163527,5,489,22,2,2,0,1,51,78
64138,6,489,460,16,5,0,3,826,1310
47348,11,214,2,0,0,0,0,2,4
121125,7,492,5,0,0,0,0,6,11
2206,5,200,26,0,0,0,0,29,55
164186,9,800,40,2,0,0,1,44,87
64308,9,842,5,0,0,0,0,13,18
166424,4,800,3,0,0,0,0,6,9
87623,8,214,5,0,0,0,0,6,11
142494,11,214,6,3,0,0,0,8,17
50777,11,214,2,1,0,0,0,5,8
167584,6,518,10,0,0,0,1,34,45
1265,10,60,0,0,0,0,0,6,6
10893,10,60,0,0,0,0,0,4,4
169092,7,306,2,0,0,0,0,6,8
54964,9,885,6,0,0,0,0,5,11
22966,11,214,6,0,0,0,0,9,15
170537,10,111,4,0,0,0,0,10,14
126435,10,831,7,0,0,0,0,14,21
117267,8,545,177,11,5,1,1,752,947
78844,7,157,1,0,0,0,0,4,5
24781,8,214,2,0,0,0,0,3,5
34371,7,748,3,0,0,0,0,3,6
149665,7,80,41,0,0,0,0,65,106
120584,10,392,8,0,0,0,0,12,20
166738,10,357,4,0,0,0,0,6,10
99682,9,184,22,0,0,0,0,33,55
81255,9,630,68,1,1,0,0,109,179
150515,10,722,12,0,0,0,1,17,30
91359,10,917,12,0,0,0,0,36,48
77287,7,521,16,1,0,0,0,28,45
45811,9,838,14,0,0,0,0,5,19
151843,9,202,2,0,0,0,0,3,5
80231,9,8,6,0,0,0,0,12,18
150898,9,202,2,0,0,0,0,3,5
76557,9,202,2,0,0,0,0,3,5
10228,7,202,2,0,0,0,0,3,5
53888,9,157,10,0,0,0,0,12,22
4784,9,885,2,0,0,0,0,4,6
101253,7,660,5,0,0,0,0,11,16
152140,9,800,12,0,0,0,0,14,26
18678,5,893,2,0,0,0,0,2,4
34957,5,518,14,0,0,0,0,18,32
37118,9,630,24,0,0,0,0,31,55
41542,9,203,4,0,0,0,0,7,11
84935,10,29,2,0,0,0,0,7,9
58160,9,912,2,0,0,0,0,3,5
64765,9,632,8,0,0,0,0,14,22
39966,4,159,2,0,0,0,0,2,4
152935,6,141,8,0,0,0,0,9,17
49229,5,78,4,0,0,0,0,6,10
108926,11,489,2,0,0,0,0,2,4
49239,5,655,36,0,0,0,0,53,89
97014,9,117,4,0,0,0,0,11,15
86807,8,214,2,0,0,0,0,0,2
49672,10,392,2,0,0,0,0,3,5
152024,11,812,4,0,0,0,0,4,8
6350,10,357,4,0,0,0,0,12,16
43719,7,80,6,0,0,0,0,5,11
114711,5,140,8,0,0,0,0,15,23
112988,6,922,0,1,0,0,0,0,1
39130,9,456,8,0,0,0,0,13,21
161967,9,492,4,0,0,0,0,7,11
138563,7,496,15,0,0,0,1,38,54
77710,9,489,5,0,0,0,0,11,16
29099,9,184,2,0,0,0,0,3,5
21289,9,538,2,0,0,0,0,4,6
62492,7,842,38,2,1,0,0,56,97
109085,6,306,2,0,0,0,0,3,5
16724,4,800,3,0,0,0,0,2,5
61206,6,518,5,0,0,1,0,10,16
22968,9,489,10,0,0,0,0,27,37
165495,8,916,2,0,0,0,0,4,6
151611,9,489,47,2,0,0,2,78,129
63069,9,472,3,0,0,0,0,4,7
130617,9,489,1,0,0,0,0,1,2
102244,11,623,5,0,0,0,0,9,14
18504,9,8,2,0,0,0,0,3,5
99658,9,8,8,0,0,0,0,24,32
155726,9,8,4,0,0,0,0,15,19
138693,9,157,0,0,0,0,0,6,6
61200,10,289,1,0,0,0,0,2,3
144280,9,483,14,0,0,0,0,23,37
117206,9,483,8,0,0,0,0,9,17
10341,9,483,2,0,0,0,0,9,11
168981,7,56,2,0,0,0,0,1,3
63155,5,489,15,0,0,0,1,33,49
123689,4,375,2,0,0,0,0,4,6
34814,9,800,2,0,0,0,0,4,6
122261,9,302,1,0,0,0,0,4,5
119408,7,228,17,0,0,1,0,22,40
63564,9,630,49,0,0,0,1,138,188
32920,7,669,4,1,1,0,0,7,13
161428,10,820,1,0,0,0,0,0,1
154255,7,100,1,0,0,0,0,0,1
58053,7,909,6,0,0,0,0,10,16
129687,6,200,8,0,0,0,0,16,24
87485,9,8,8,0,0,0,0,16,24
136418,9,8,4,0,0,0,0,14,18
105357,9,8,0,0,0,0,0,12,12
66155,9,8,10,0,0,0,0,18,28
114443,9,589,2,0,0,0,0,4,6
162971,8,623,1,0,0,0,0,0,1
127400,6,269,1,0,0,0,0,0,1
73000,8,30,3,0,0,0,0,0,3
131105,5,655,6,0,0,0,0,9,15
86893,5,518,4,0,0,0,0,8,12
100823,7,822,12,0,0,0,0,9,21
43523,10,555,2,0,0,0,0,4,6
66382,10,555,9,0,0,0,0,15,24
164686,10,555,5,0,0,0,0,13,18
34525,6,306,1,0,0,0,0,3,4
170838,9,842,1,0,0,1,0,0,2
132856,9,86,8,1,1,0,0,11,21
70284,11,214,4,0,0,0,0,4,8
78290,6,209,7,0,0,0,0,10,17
36160,5,893,6,0,0,0,0,12,18
114927,7,118,2,0,0,0,0,3,5
166637,11,800,1,0,0,0,0,1,2
168244,7,78,30,0,0,0,0,46,76
56482,10,66,10,0,0,0,0,19,29
103124,11,885,0,1,0,0,0,0,1
114943,6,174,2,0,0,0,0,4,6
3218,7,693,4,0,0,0,0,5,9
124988,5,479,34,1,0,0,0,52,87
136016,5,76,180,4,2,1,1,269,457
57607,11,489,10,0,0,0,0,11,21
15239,9,909,1,0,0,0,0,1,2
160316,5,181,2,0,0,0,0,0,2
8374,9,657,4,0,0,0,0,4,8
1781,10,29,2,0,0,0,0,9,11
28370,10,29,12,0,0,0,0,21,33
96805,9,657,13,1,1,0,1,23,39
108128,10,798,2,0,0,0,0,3,5
11162,7,885,4,0,0,0,0,7,11
165735,9,575,4,0,0,0,0,7,11
55475,7,79,8,0,0,0,0,12,20
95917,7,312,2,0,0,0,0,4,6
35662,8,214,6,0,0,0,0,13,19
125243,11,214,2,0,0,0,0,2,4
153660,11,489,2,0,0,0,0,2,4
36161,5,124,42,2,0,0,0,79,123
40854,5,489,12,0,0,0,0,29,41
136718,4,453,217,5,3,0,2,369,596
147476,7,228,1,0,0,0,0,6,7
60025,4,159,2,0,0,0,0,4,6
91078,6,200,28,0,0,0,0,50,78
17026,8,800,1,0,0,0,0,0,1
52977,8,124,0,0,0,0,0,3,3
93051,7,56,26,2,0,0,1,61,90
6096,7,741,2,0,0,0,0,12,14
92334,9,469,279,0,0,0,1,129,409
34653,10,781,2,0,0,0,0,2,4
125276,10,781,1,0,0,0,0,2,3
170338,9,378,2,0,0,0,0,3,5
42657,6,693,26,0,0,0,0,42,68
143132,7,563,18,1,1,0,0,54,74
122335,9,427,3,0,0,0,0,4,7
5828,9,800,24,1,0,0,0,74,99
48131,9,65,1,0,0,0,0,1,2
139452,7,175,4,0,0,0,0,10,14
93136,10,357,6,0,0,0,0,7,13
102777,7,570,1,0,0,0,0,2,3
29979,9,145,2,0,0,0,0,3,5
14650,11,800,13,0,0,0,0,14,27
142314,8,489,1,0,0,0,0,0,1
161186,9,873,2,0,0,0,0,4,6
59887,8,214,76,3,1,0,0,153,233
47628,10,781,2,0,0,0,0,2,4
105724,9,375,2,0,0,0,0,3,5
17558,9,147,2,0,0,0,0,4,6
144782,9,147,2,0,0,0,0,10,12
41236,9,147,10,0,0,0,0,17,27
154108,9,630,3,0,0,0,0,6,9
85057,7,80,8,0,0,0,0,13,21
91688,9,353,2,0,0,0,0,4,6
142869,7,100,40,0,0,1,0,69,110
31542,7,521,6,0,0,0,0,10,16
169284,7,484,0,0,0,0,0,6,6
136948,7,521,2,0,0,0,0,3,5
99325,5,570,5,0,0,0,0,8,13
2969,9,374,4,0,0,0,0,11,15
18869,5,479,64,1,1,0,0,114,180
96117,11,214,1,0,0,0,0,0,1
9255,8,545,2,0,0,0,0,2,4
5543,4,923,10,0,0,0,0,11,21
128322,9,147,4,0,0,0,0,9,13
133142,9,489,6,0,0,0,0,9,15
504,11,812,2,0,0,0,0,3,5
21230,10,63,2,0,0,0,0,4,6
129696,5,225,32,0,0,0,0,49,81
146227,9,46,2,0,0,0,0,4,6
44628,9,631,2,0,0,0,0,8,10
161822,9,65,1,0,0,0,0,1,2
22659,9,631,1,0,0,0,0,3,4
37323,9,631,7,0,0,0,1,13,21
119120,6,221,3,0,0,0,0,4,7
512,10,628,2,0,0,0,0,3,5
157081,10,355,2,0,0,0,0,3,5
165747,5,479,19,0,0,0,0,30,49
15066,8,214,86,2,1,0,0,152,241
50066,9,100,1,0,0,0,0,2,3
18886,6,489,1,0,0,0,0,2,3
13811,7,302,2,0,0,0,0,3,5
166390,7,484,5,2,0,0,0,14,21
135583,7,56,1,0,0,0,0,1,2
124659,9,630,30,0,0,0,0,82,112
66719,4,890,84,2,0,0,0,176,262
77462,9,800,11,0,0,0,0,13,24
168243,9,800,27,0,0,0,1,45,73
6514,8,124,3,0,0,0,0,3,6
61743,7,118,4,0,0,0,0,9,13
157089,9,456,2,0,0,0,0,4,6
149263,9,640,33,0,0,0,0,44,77
104737,9,556,4,0,0,0,0,11,15
95621,10,29,6,0,0,0,0,12,18
11209,4,591,2,0,0,0,0,4,6
125721,7,61,0,0,0,0,0,4,4
96436,7,61,4,0,0,0,0,8,12
103618,7,61,17,0,0,0,0,21,38
79040,4,658,70,2,0,0,0,124,196
167190,7,149,2,0,0,0,0,4,6
82261,10,392,13,0,0,0,0,8,21
84520,9,367,5,0,0,0,0,13,18
122725,7,575,4,0,0,0,0,7,11
154729,9,842,1,0,0,0,0,0,1
169060,7,521,1,0,0,0,0,0,1
83148,8,800,108,1,0,0,1,200,310
160998,9,43,3,0,0,0,0,6,9
9503,9,43,7,0,0,0,0,9,16
48942,9,838,4,0,0,0,0,19,23
12402,9,838,8,0,0,0,0,15,23
71177,9,838,0,0,0,0,0,5,5
94520,9,418,10,0,0,0,0,18,28
156958,9,418,2,0,0,0,0,4,6
159576,9,622,2,0,0,0,0,6,8
160771,10,60,6,0,0,0,0,12,18
132907,9,380,2,0,0,0,0,6,8
155405,11,214,2,1,0,0,0,6,9
125855,10,628,4,0,0,0,0,8,12
76254,10,628,2,0,0,0,0,3,5
26421,9,456,4,0,0,0,0,11,15
29975,10,618,4,0,0,0,0,5,9
169554,5,479,320,10,6,0,3,608,947
91434,9,457,4,0,0,0,0,4,8
3234,8,214,1,0,0,0,0,1,2
111632,4,36,76,2,1,0,0,166,245
84767,9,457,2,0,0,0,0,5,7
13049,9,457,2,0,0,0,0,6,8
49780,10,628,3,0,0,0,0,2,5
76029,9,658,2,0,0,0,0,0,2
104404,9,630,5,0,0,0,0,11,16
123617,10,628,2,0,0,0,0,3,5
110628,5,238,2,0,0,0,0,3,5
57547,7,211,10,0,0,0,0,23,33
69153,7,373,8,0,0,0,0,11,19
55131,10,781,2,0,0,0,0,3,5
139241,10,355,6,0,0,0,0,10,16
133383,10,322,3,0,0,0,0,3,6
95842,10,752,2,0,0,0,0,2,4
102165,5,124,38,0,0,0,0,67,105
60888,5,124,26,0,0,0,0,36,62
161997,7,149,4,0,0,0,0,8,12
35998,7,306,1,0,0,0,0,10,11
38926,9,489,4,0,0,0,0,10,14
107854,8,800,2,0,0,0,0,3,5
171138,9,630,42,0,0,0,0,71,113
817,9,630,13,0,0,0,0,28,41
146131,9,630,15,0,0,0,0,30,45
113439,9,42,2,0,0,0,0,4,6
170663,4,658,43,1,0,0,0,69,113
152284,7,489,41,0,0,0,0,68,109
12137,7,489,8,0,0,0,0,16,24
142889,5,78,39,1,1,0,0,66,107
52044,10,831,2,0,0,0,0,4,6
132612,10,628,2,1,1,0,0,7,11
128722,9,632,2,0,0,0,0,6,8
163010,10,917,2,0,0,0,0,0,2
107303,8,214,132,0,0,0,1,226,359
83501,9,306,1,0,0,0,0,0,1
128251,5,263,1,0,0,0,0,0,1
38020,6,269,1,0,0,0,0,2,3
34256,6,78,1,0,0,0,0,3,4
146723,6,489,1,0,0,0,0,2,3
98780,6,585,4,0,0,0,0,6,10
118504,10,781,2,0,0,0,0,3,5
16102,7,149,6,1,1,0,0,12,20
90594,7,196,3,0,0,0,0,8,11
133178,9,131,4,0,0,0,0,7,11
97670,6,489,6,0,0,0,0,6,12
115227,11,545,2,0,0,0,0,2,4
92954,10,66,3,0,0,0,0,10,13
69635,10,66,5,0,0,0,0,11,16
134479,10,743,2,0,0,0,0,3,5
70012,8,214,1,0,0,0,0,2,3
36801,9,819,13,0,0,0,0,28,41
23387,9,819,23,0,0,0,0,48,71
151534,10,63,12,0,0,0,0,23,35
22681,8,214,1,0,0,0,0,1,2
2315,11,214,0,1,0,0,0,0,1
52644,10,917,1,0,0,0,0,1,2
81271,10,917,1,0,0,0,0,3,4
33155,10,322,1,0,0,0,0,2,3
3572,4,638,1,0,0,0,0,0,1
117104,8,214,246,12,3,0,3,464,728
22636,4,174,1,0,0,0,0,3,4
123640,11,214,0,2,0,0,0,0,2
8795,7,489,2,0,0,0,0,3,5
147510,7,842,8,0,0,0,0,7,15
136144,8,214,294,5,1,0,0,486,786
66836,8,623,9,0,0,0,0,17,26
19477,9,175,5,0,0,0,0,6,11
10452,4,36,19,0,0,0,0,29,48
35813,9,630,3,0,0,0,0,3,6
12226,10,413,3,0,0,0,0,10,13
84821,9,374,4,0,0,0,0,7,11
102607,5,78,0,2,0,0,0,0,2
79882,8,214,124,6,3,0,1,238,372
151989,7,864,5,1,1,0,0,12,19
166096,8,556,2,0,0,0,0,4,6
18054,7,306,1,0,0,0,0,3,4
55097,10,413,1,0,0,0,0,1,2
12696,4,800,2,0,0,0,0,0,2
70743,8,214,148,4,1,0,0,275,428
18359,10,322,1,0,0,0,0,1,2
125424,10,322,1,0,0,0,0,1,2
161646,7,367,1,0,0,0,0,0,1
160234,5,78,1,0,0,0,0,1,2
4559,9,492,7,0,0,0,0,15,22
162066,5,78,1,0,0,0,0,2,3
121997,9,819,1,0,0,0,0,11,12
7312,11,214,2,0,0,0,0,3,5
54982,4,885,46,0,0,0,0,81,127
88956,4,36,366,12,6,0,1,1140,1525
139327,7,56,3,0,0,0,0,4,7
120209,7,521,9,0,0,0,0,25,34
120642,7,79,4,0,0,0,0,15,19
159025,10,256,8,0,0,0,0,13,21
9531,5,78,14,0,0,0,0,18,32
64140,7,175,4,1,1,0,0,18,24
12828,8,658,2,0,0,0,0,2,4
120065,8,800,27,0,0,0,1,58,86
157044,7,118,6,0,0,0,0,18,24
8461,10,104,1,0,0,0,0,10,11
146088,10,104,1,0,0,0,0,2,3
2890,4,453,1,0,0,0,0,2,3
160556,8,214,92,2,2,0,0,145,241
162450,9,575,2,0,0,0,0,7,9
152672,6,235,72,3,1,1,2,151,230
33169,10,903,10,0,0,0,0,12,22
85232,7,489,5,0,0,0,0,6,11
95836,7,157,6,0,0,0,0,7,13
117926,9,216,135,8,3,0,2,266,414
96289,11,812,2,0,0,0,0,0,2
159064,8,214,102,0,0,0,0,178,280
28445,9,216,10,0,0,0,0,21,31
160429,9,216,43,0,0,0,0,60,103
127111,7,118,2,0,0,0,0,4,6
89903,6,427,1,0,0,0,0,3,4
20494,4,453,1,0,0,0,0,0,1
101598,8,562,103,2,0,0,0,157,262
106012,4,885,36,0,0,0,0,67,103
149961,9,89,20,0,0,0,0,37,57
45900,7,100,4,0,0,0,0,7,11
36613,7,384,2,0,0,0,0,4,6
17872,7,484,2,0,0,0,0,3,5
133119,7,384,4,0,0,0,0,4,8
167500,7,384,2,0,0,0,0,3,5
29222,8,214,2,0,0,0,0,10,12
85992,9,842,2,0,0,0,0,0,2
106364,10,798,2,0,0,0,0,4,6
82815,4,200,56,2,1,0,0,90,149
87055,6,235,56,0,0,0,0,97,153
148851,7,56,30,1,1,0,0,34,66
131506,4,885,44,0,0,0,0,90,134
108434,4,658,16,0,0,0,0,20,36
70481,4,885,140,6,3,0,0,259,408
23603,9,86,94,1,0,1,0,134,230
108072,10,66,6,0,0,0,0,12,18
81589,5,76,10,0,0,0,0,10,20
32617,9,489,8,0,0,1,0,9,18
16219,8,556,1,0,0,0,0,0,1
106006,10,322,2,0,0,0,0,4,6
16871,5,159,18,0,0,0,0,35,53
88307,9,89,3,0,0,0,0,4,7
135742,7,175,2,0,0,0,0,3,5
14013,4,200,10,0,0,0,0,18,28
36849,8,403,283,10,1,2,1,458,755
77351,10,917,2,0,0,0,0,7,9
86065,7,384,4,0,0,0,0,7,11
9680,9,630,74,0,0,0,1,229,304
130757,5,489,7,0,0,0,0,3,10
144541,4,159,19,0,0,0,1,30,50
12568,8,403,390,22,8,2,2,769,1193
44634,10,413,2,0,0,0,0,4,6
110177,7,157,6,0,0,0,0,17,23
168005,7,157,4,0,0,0,0,9,13
119613,5,885,52,1,0,0,0,84,137
104199,7,669,2,0,0,0,0,3,5
121999,7,175,1,0,0,0,0,0,1
32067,4,36,78,3,2,0,1,147,231
168842,9,630,382,13,3,1,6,1484,1889
90206,9,6,2,0,0,0,0,4,6
31758,9,65,1,0,0,0,0,0,1
99398,10,898,5,0,0,0,0,9,14
45983,7,641,6,0,0,0,0,6,12
93074,6,269,201,6,2,1,0,357,567
82616,10,413,0,0,0,0,0,4,4
8697,10,413,0,0,0,0,0,4,4
103726,10,413,0,0,0,0,0,4,4
86954,7,864,2,0,0,0,0,4,6
100279,7,144,15,0,0,0,0,16,31
161126,7,56,2,0,0,0,0,6,8
60133,7,56,8,0,0,0,0,17,25
72506,9,484,1,0,0,0,0,0,1
26094,9,6,1,0,0,0,0,0,1
92278,9,483,18,0,0,0,1,40,59
161296,8,214,8,0,0,0,0,17,25
134586,7,489,27,1,1,0,0,51,80
108495,10,66,2,0,0,0,0,4,6
73407,9,575,2,0,0,0,0,0,2
36210,7,578,24,2,1,0,0,52,79
71137,7,578,0,0,0,0,0,4,4
130847,6,296,2,0,0,0,0,2,4
168961,5,355,14,0,0,0,0,13,27
106923,8,403,22,0,0,0,0,25,47
138657,8,800,226,5,1,1,0,487,720
113657,7,149,2,0,0,0,0,4,6
99664,7,157,0,0,0,0,0,3,3
137854,7,295,2,0,0,0,0,3,5
26594,11,214,2,0,0,0,0,2,4
18454,7,254,8,0,0,0,0,15,23
121264,9,630,2,0,0,0,0,0,2
130216,9,560,1,0,0,0,0,0,1
2553,9,560,1,0,0,0,0,0,1
251,9,560,1,0,0,0,0,0,1
75751,6,800,2,1,0,0,0,4,7
78366,7,79,2,0,0,0,0,6,8
137044,7,79,2,0,0,0,0,6,8
147608,4,453,2,0,0,0,0,3,5
116865,7,144,8,0,0,0,0,18,26
57630,10,355,2,0,0,0,0,8,10
23601,4,375,2,0,0,0,0,3,5
47612,9,630,30,0,0,0,0,46,76
6668,9,6,2,0,0,0,0,6,8
98358,9,6,2,0,0,0,0,4,6
45590,9,838,2,0,0,0,0,4,6
58259,9,367,2,0,0,0,0,3,5
26461,10,831,2,0,0,0,0,2,4
75996,10,820,0,0,0,0,0,4,4
1002,10,555,2,0,0,0,0,14,16
99860,11,214,2,0,0,0,0,2,4
21328,9,374,5,0,0,0,0,6,11
151885,9,374,1,1,0,0,0,0,2
129518,9,819,15,0,0,0,0,28,43
111877,5,78,2,0,0,0,0,4,6
151742,7,367,2,0,0,0,0,4,6
116921,9,796,1,0,0,0,0,1,2
77188,7,563,1,0,0,0,0,1,2
106385,9,145,1,0,0,0,0,1,2
55552,9,145,1,0,0,0,0,1,2
38120,8,545,4,0,0,0,0,1,5
12861,7,118,2,0,0,0,0,1,3
42529,9,380,43,4,3,3,0,78,131
99305,9,380,2,1,1,0,0,0,4
37046,9,570,1,0,0,0,0,3,4
44600,6,78,1,0,0,0,0,0,1
108330,9,640,1,0,0,0,0,0,1
100282,7,741,1,0,0,0,0,0,1
117456,9,184,2,0,0,0,0,3,5
10911,8,489,1,0,0,0,0,0,1
94838,9,607,153,5,4,0,2,331,495
103199,4,159,1,0,0,0,0,0,1
95235,9,570,1,0,0,0,0,0,1
106692,4,36,102,3,1,0,0,231,337
46438,7,175,2,1,1,0,0,3,7
46623,7,175,2,0,0,0,0,6,8
169328,9,84,6,0,0,0,0,4,10
121174,7,805,19,0,0,0,0,30,49
73021,10,653,29,0,0,0,0,65,94
103061,5,78,2,0,0,0,0,2,4
4863,4,159,5,0,0,0,0,9,14
6116,6,800,1,0,0,0,0,4,5
136080,11,30,1,0,0,0,0,0,1
146886,10,217,3,0,0,0,0,3,6
83618,8,623,1,0,0,0,0,2,3
99842,10,334,3,0,0,0,0,3,6
55072,8,214,2,0,0,0,0,5,7
133814,11,214,0,1,0,0,0,0,1
40287,9,796,1,0,0,0,0,1,2
136342,8,484,2,0,0,0,0,1,3
20538,5,347,20,0,0,0,0,26,46
170352,5,118,2,0,0,0,0,2,4
124803,9,100,60,4,1,0,0,118,183
31129,9,462,3,0,0,0,0,9,12
164042,7,157,2,0,0,0,0,6,8
27521,8,90,75,0,0,2,0,115,192
71025,9,630,16,0,0,0,0,52,68
48508,10,36,1,0,0,0,0,0,1
72857,4,658,3,0,0,0,0,5,8
75195,7,660,6,0,0,0,0,0,6
114966,5,76,14,0,0,0,0,24,38
85806,10,628,9,1,1,0,0,19,30
26507,9,6,3,0,0,0,0,8,11
25083,9,6,7,0,0,0,0,17,24
153582,8,489,1,0,0,0,0,0,1
135853,10,628,1,0,0,0,0,3,4
90614,8,214,3,0,0,0,0,5,8
40876,10,628,1,0,0,0,0,3,4
8513,9,367,20,0,0,0,0,37,57
94582,9,301,4,0,0,0,0,10,14
145108,7,489,30,0,0,0,0,44,74
14543,9,489,14,0,0,0,0,25,39
83522,5,159,13,0,0,0,0,18,31
126780,8,214,1,0,0,0,0,2,3
6822,9,184,4,0,0,0,0,4,8
4969,7,56,12,0,0,0,0,24,36
56109,9,489,121,6,2,1,0,172,302
13310,9,6,2,0,0,0,0,3,5
28596,5,225,1,0,0,0,0,1,2
97416,9,405,1,0,0,0,0,1,2
39667,8,90,44,0,0,5,0,79,128
110951,10,841,4,0,0,0,0,4,8
9226,9,657,32,2,0,0,0,81,115
129673,4,658,746,9,1,0,9,1788,2553
163051,4,800,67,0,0,0,0,128,195
167111,6,404,51,0,0,0,0,81,132
108824,8,545,4407,162,46,14,26,7940,12595
22348,11,489,2,0,0,0,0,4,6
88925,8,489,2,0,0,0,0,4,6
81312,10,917,10,0,0,0,0,39,49
78225,9,158,0,0,0,0,0,4,4
168623,10,798,1,0,0,0,0,0,1
129213,7,737,3,0,0,0,0,19,22
83744,9,640,63,1,0,0,0,101,165
93311,8,623,12,0,0,0,0,21,33
120105,9,306,1,0,0,0,0,0,1
110781,8,174,35,0,0,0,0,59,94
145258,4,435,1731,48,15,1,9,3252,5056
42664,9,374,8,0,0,0,0,19,27
88002,8,677,243,10,2,1,1,508,765
99238,9,86,6,0,0,0,0,12,18
24229,6,514,32,1,0,0,0,83,116
49889,9,658,4,0,0,0,0,9,13
134114,9,630,73,2,2,0,1,136,214
152097,7,175,5,0,0,0,0,24,29
4270,10,617,1,0,0,0,0,1,2
42229,10,355,2,0,0,0,0,0,2
56766,7,589,1,0,0,0,0,1,2
108575,9,462,24,1,1,0,0,47,73
26467,9,796,10,0,0,0,1,17,28
64669,9,796,4,0,0,0,1,10,15
142678,9,796,2,0,0,0,0,21,23
25557,9,796,2,0,0,0,0,9,11
29486,9,796,0,0,0,0,0,4,4
128312,9,796,0,0,0,0,0,4,4
133254,9,796,1,0,0,0,0,4,5
122616,9,796,0,0,0,0,0,8,8
111000,9,796,0,0,0,0,0,4,4
90344,9,657,45,0,0,0,0,77,122
11607,10,628,35,0,0,0,0,47,82
62836,9,909,1,0,0,0,0,0,1
37949,9,909,1,0,0,0,0,0,1
102757,9,909,1,0,0,0,0,0,1
88646,6,585,8,0,0,0,0,21,29
14958,10,628,4,0,0,0,0,10,14
143945,4,800,4,0,0,0,0,8,12
3606,10,628,6,0,0,0,0,8,14
69665,10,628,4,0,0,0,0,10,14
28516,7,660,3,0,0,0,0,9,12
69382,8,693,278,7,2,0,3,556,846
142122,9,819,14,0,0,0,0,24,38
91638,9,819,3,0,0,0,0,5,8
20474,7,310,2,0,0,0,0,0,2
75824,8,800,89,2,1,0,1,204,297
90982,5,4,2,0,0,0,0,9,11
82227,9,630,249,9,3,0,0,501,762
144299,7,889,0,0,0,0,0,1,1
57695,6,885,11,0,0,0,0,14,25
146109,8,214,7,0,0,0,0,5,12
99076,8,800,5,0,0,0,0,10,15
66015,4,36,44,2,0,0,0,69,115
29526,7,374,3,0,0,0,0,3,6
165216,4,36,96,4,0,0,2,183,285
162006,9,741,4,0,0,0,0,7,11
80843,10,66,0,0,0,0,0,4,4
40415,7,163,2,0,0,0,0,2,4
46487,10,36,1,0,0,0,0,0,1
9288,10,357,2,0,0,0,0,3,5
112850,9,367,15,0,0,0,0,27,42
29660,9,158,6,0,0,0,0,9,15
23508,5,118,1,0,0,0,0,0,1
69256,4,36,32,0,0,0,0,41,73
160715,9,657,6,0,0,0,0,4,10
90735,7,100,2,0,0,0,0,3,5
30957,7,484,12,1,0,1,0,26,40
118135,6,843,4,0,0,0,0,1,5
55877,9,909,2,0,0,0,0,20,22
3295,9,909,0,0,0,0,0,4,4
163413,9,630,28,0,0,0,0,41,69
84480,7,496,7,0,0,0,0,11,18
31527,7,56,14,2,3,0,0,27,46
151494,8,885,16,0,0,0,0,18,34
84801,4,200,0,0,0,0,0,5,5
99459,10,322,1,0,0,0,0,1,2
34316,7,824,12,0,0,0,0,26,38
92573,4,435,153,8,3,0,3,319,486
60941,4,36,149,7,1,0,1,299,457
50401,9,489,1,0,0,0,0,0,1
24222,9,100,173,8,3,0,2,258,444
103872,8,693,7,0,0,0,0,9,16
3012,10,653,8,0,0,0,0,16,24
116168,5,479,43,1,0,0,0,91,135
66705,7,228,6,0,0,0,0,9,15
25163,9,819,32,3,0,2,0,51,88
157719,7,263,1,0,0,0,0,1,2
92938,9,429,0,0,0,4,0,0,4
161950,9,429,0,0,0,4,0,0,4
36304,7,489,1,0,0,0,0,0,1
42521,7,641,10,0,0,0,0,16,26
127988,8,214,1,0,0,0,0,0,1
50217,4,891,5670,50,29,0,19,9674,15442
11067,7,295,18,1,1,0,0,35,55
69636,9,632,10,0,0,0,0,9,19
23903,8,545,1,0,0,0,0,0,1
65543,8,124,2,0,0,0,0,6,8
156165,6,306,153,5,0,0,1,264,423
85565,4,36,31,0,0,0,0,74,105
131650,7,885,4,0,0,0,0,12,16
910,8,30,1,0,0,0,0,0,1
146786,7,864,2,0,0,0,0,6,8
70233,8,214,0,0,0,0,0,4,4
2125,8,693,1,0,0,0,0,5,6
85593,7,100,5,0,0,0,0,17,22
141537,6,585,36,0,0,0,0,90,126
158484,9,302,4,0,0,0,0,9,13
112377,4,199,3,0,0,0,0,6,9
63096,7,295,4,0,0,0,0,5,9
103156,9,65,1,0,0,0,0,0,1
162267,4,159,310,0,0,0,4,687,1001
125620,11,214,2,0,0,0,0,4,6
22320,8,214,4,0,0,0,0,6,10
126507,10,868,2,0,0,0,0,0,2
76252,6,124,2,0,0,0,0,2,4
117511,6,124,12,0,0,0,0,17,29
11509,9,380,6,0,0,0,0,8,14
62094,10,743,8,0,0,0,0,8,16
92082,5,306,34,0,0,0,0,52,86
114100,9,380,3,0,0,0,0,6,9
107178,4,891,21328,685,247,50,98,38831,61239
72466,9,380,2,0,0,0,0,4,6
96404,6,4,10,0,0,0,0,11,21
27719,6,4,2,0,0,0,0,4,6
147088,9,8,2,0,0,0,0,5,7
119489,8,214,21,1,0,0,0,36,58
129992,8,214,1288,33,14,1,5,2535,3876
61198,9,71,3,0,0,0,0,5,8
55731,10,242,5,0,0,0,0,7,12
14629,7,563,7,1,0,0,0,10,18
65886,7,56,2,0,0,0,0,3,5
143728,8,489,3,0,0,0,0,0,3
93933,4,658,459,7,4,0,3,765,1238
101004,7,100,327,32,10,4,5,662,1040
43589,7,100,84,8,7,0,1,170,270
141198,4,891,4596,131,35,14,28,8776,13580
64433,4,891,9656,278,97,28,29,16875,26963
158761,6,306,3,0,0,0,0,29,32
45721,4,435,658,7,4,0,6,1305,1980
57571,7,56,1,0,0,0,0,0,1
92728,7,658,1,0,0,0,0,5,6
18282,9,315,6,0,0,0,0,7,13
83511,6,885,55,3,2,0,0,134,194
113563,6,729,8,0,0,0,0,5,13
157130,6,306,188,1,0,0,1,330,520
107532,6,922,2,0,0,0,0,3,5
72969,7,611,1,0,0,0,0,2,3
123735,8,214,694,15,9,0,6,1445,2169
15725,6,200,7,0,0,0,0,14,21
108178,10,217,4,0,0,0,0,6,10
112996,8,214,33,0,0,0,0,80,113
132229,7,429,258,1,0,6,0,441,706
163185,4,453,4,0,0,0,0,2,6
132747,8,800,5,0,0,0,0,9,14
47764,10,357,1,0,0,0,0,2,3
91507,7,896,2,0,0,0,0,3,5
88754,8,693,12,0,0,0,0,19,31
15671,8,693,9,0,0,0,0,12,21
162436,8,489,32,0,0,0,3,66,101
101100,10,322,2,0,0,0,0,4,6
70762,8,306,6,0,0,0,0,10,16
142666,6,306,186,2,0,0,0,320,508
130262,5,479,8,0,0,0,0,18,26
138080,4,891,1770,43,11,5,10,2951,4790
62942,8,800,27,0,0,0,1,66,94
132540,9,147,2,0,0,0,0,4,6
88181,9,367,6,1,0,0,0,27,34
78772,4,752,5,0,0,0,0,9,14
151979,7,74,4,0,0,0,0,14,18
105706,7,61,6,0,0,0,0,11,17
22867,8,489,175,0,0,0,1,266,442
54520,8,489,185,0,0,0,2,334,521
15818,7,489,40,2,0,0,1,63,106
140446,10,178,5,0,0,0,0,9,14
66603,4,375,4,0,0,0,0,9,13
96877,4,658,1808,19,6,3,15,3562,5413
157631,4,800,159,0,0,0,2,122,283
139315,8,214,29,0,0,0,0,76,105
126560,9,353,6,0,0,0,0,7,13
145426,9,457,4,0,0,0,0,8,12
27000,4,159,7,0,0,0,0,20,27
145840,8,214,13,0,0,0,0,19,32
157710,11,214,2,0,0,0,0,2,4
113923,10,628,1,0,0,0,0,6,7
132623,9,380,2,0,0,0,0,3,5
136532,9,6,0,0,0,0,0,6,6
72220,11,214,8,0,0,0,0,9,17
157538,8,214,207,2,2,0,1,355,567
38390,8,623,1,0,0,0,0,0,1
113280,9,6,2,0,0,0,0,4,6
49227,9,6,2,0,0,0,0,6,8
45295,9,874,2,0,0,0,0,3,5
19684,9,874,4,0,0,0,0,6,10
40832,9,462,15,1,0,0,0,41,57
160729,9,874,4,0,0,0,0,6,10
84083,8,214,1,0,0,0,0,0,1
39567,8,214,17,3,0,0,0,24,44
117487,6,514,24,1,0,1,0,43,69
31465,7,157,3,0,0,0,0,19,22
119657,8,717,913,25,7,3,6,1692,2646
132479,6,404,65,0,0,0,1,95,161
37748,4,675,4,0,0,0,0,4,8
159162,9,575,2,0,0,0,0,4,6
164816,6,200,2,0,0,0,0,3,5
106856,9,8,7,0,0,0,0,12,19
5306,9,8,13,0,0,0,0,35,48
2334,7,56,8,0,0,0,0,8,16
151502,8,800,35,1,1,0,0,57,94
169313,9,313,1,0,0,0,0,2,3
90005,9,313,1,0,0,0,0,3,4
31262,9,313,5,1,0,0,0,8,14
102568,9,313,1,0,0,0,0,3,4
37213,4,435,281,7,2,1,2,593,886
79493,8,800,23,0,0,0,0,44,67
162925,10,66,0,0,0,0,0,4,4
146713,10,66,2,0,0,0,0,6,8
132551,10,66,0,0,0,0,0,4,4
166923,10,66,20,2,0,0,1,47,70
9193,10,66,0,0,0,0,0,4,4
66835,10,66,0,0,0,0,0,4,4
92359,9,301,6,0,0,0,0,10,16
11638,7,744,5,0,0,0,0,9,14
140489,9,314,8,0,0,0,0,21,29
46405,4,800,1,0,0,0,0,0,1
9213,7,175,3,0,0,0,0,20,23
140236,4,200,75,1,0,0,1,135,212
118010,11,812,4,0,0,0,0,2,6
48238,7,157,27,1,1,0,0,45,74
79829,6,132,116,7,2,1,2,180,308
125365,9,315,2,0,0,0,0,4,6
143237,7,611,2,0,0,0,0,3,5
103707,6,135,240,22,4,4,3,457,730
108342,7,611,2,0,0,0,0,3,5
1422,7,611,2,0,0,0,0,4,6
59742,7,56,2,0,0,0,0,0,2
159314,6,269,2,0,0,0,0,3,5
57526,10,903,4,0,0,0,0,5,9
112023,7,484,10,0,0,0,0,21,31
37807,11,812,2,0,0,0,0,3,5
82966,9,693,2,0,0,0,0,6,8
166476,7,864,2,0,0,0,0,7,9
79410,6,514,25,1,0,0,0,55,81
127868,7,56,13,2,2,0,1,24,42
30487,9,325,2,0,0,0,0,0,2
68902,9,469,3,0,0,0,0,4,7
141283,8,489,4,0,0,0,0,8,12
25475,4,638,57,4,1,1,0,100,163
133890,7,693,3,0,0,0,0,5,8
34926,10,798,1,0,0,0,0,3,4
62658,8,214,71,1,1,0,0,125,198
7519,11,812,2,0,0,0,0,2,4
112338,5,574,1,0,0,0,0,2,3
74957,9,202,2,0,0,0,0,2,4
110319,8,214,57,0,0,0,0,112,169
52928,7,741,1,0,0,0,0,3,4
51169,11,214,1,0,0,0,0,1,2
128375,6,132,70,5,0,1,1,93,170
159077,7,80,21,0,0,0,0,41,62
58678,5,455,21,0,0,0,0,37,58
24411,4,890,35,0,0,0,1,63,99
84578,4,890,18,0,0,0,0,25,43
1239,8,214,230,6,0,0,1,350,587
166242,6,132,101,2,1,0,0,178,282
54512,8,489,90,0,0,0,0,148,238
170028,6,455,167,2,1,0,0,293,463
147874,7,669,3,0,0,0,0,12,15
120211,8,306,1049,2,1,0,8,1906,2966
116848,10,831,1,0,0,0,0,0,1
34354,9,640,24,0,0,0,0,36,60
94727,8,214,98,2,0,0,0,167,267
8472,7,61,6,1,0,0,0,20,27
153509,7,61,1,0,0,0,0,4,5
2548,7,61,0,0,0,0,0,4,4
4793,7,61,5,0,0,0,0,8,13
163305,11,489,1,0,0,0,0,0,1
162504,11,489,1,0,0,0,0,0,1
77565,8,214,91,2,1,0,0,174,268
11368,7,634,2,0,0,0,1,5,8
150716,5,773,1,0,0,0,0,1,2
49295,9,819,3,0,0,0,0,6,9
169107,6,200,28,0,0,0,0,49,77
168692,8,214,163,2,1,0,0,276,442
83163,8,214,76,0,0,0,0,139,215
115287,8,214,2,0,0,0,0,3,5
87638,4,375,2,0,0,0,0,3,5
4217,5,124,6,0,0,0,0,11,17
143172,5,783,8,0,0,0,0,13,21
73250,6,132,158,7,1,2,0,267,435
170494,9,158,4,1,1,0,0,5,11
130990,7,587,21,0,0,0,0,29,50
119262,8,214,99,2,0,0,1,174,276
118386,8,306,922,0,0,0,6,1750,2678
156921,10,752,17,0,0,0,0,21,38
37559,9,175,2,0,0,0,0,3,5
75033,7,641,5,0,0,0,0,9,14
104015,10,111,6,0,0,0,0,7,13
82355,4,885,11,0,0,0,0,12,23
25103,6,200,73,1,0,0,0,151,225
110428,9,842,60,0,0,0,0,74,134
114409,8,214,809,19,7,1,4,1576,2416
50273,7,737,32,2,0,0,0,68,102
127719,7,484,2,0,0,0,0,4,6
109114,10,790,4,0,0,0,0,4,8
164143,8,800,413,10,3,0,2,739,1167
26964,4,752,258,5,3,1,1,422,690
116315,7,521,4,0,0,0,0,7,11
31568,6,132,19,1,0,0,0,37,57
19401,10,555,9,0,0,0,0,26,35
150979,5,479,16,0,0,0,0,24,40
30480,6,489,68,1,1,0,0,106,176
49258,8,214,1,0,0,0,0,1,2
104830,9,367,16,0,0,0,0,23,39
104154,7,126,8,0,0,0,0,22,30
165674,7,829,4,0,0,0,0,6,10
118691,6,404,26,2,0,0,1,38,67
11087,9,489,37,0,0,0,0,55,92
109105,8,717,239,3,0,1,1,507,751
27614,8,214,74,0,0,0,1,131,206
95789,9,175,1,0,0,0,0,0,1
96776,6,489,135,2,2,0,0,188,327
121858,4,174,1,0,0,0,0,0,1
135435,4,159,569,4,2,0,2,1000,1577
166231,4,159,529,3,1,0,5,922,1460
20236,9,483,4,0,0,0,0,8,12
147852,9,302,2,0,0,0,0,3,5
58521,9,302,7,0,0,0,0,20,27
9602,9,489,19,0,0,0,0,36,55
54088,7,61,41,0,0,0,1,79,121
23675,8,489,210,13,3,0,1,401,628
18112,6,404,72,0,0,0,0,117,189
43394,5,455,42,1,0,0,1,90,134
143903,9,78,6,0,0,0,0,12,18
131404,9,78,3,1,1,0,0,5,10
96709,4,159,18,0,0,0,0,22,40
148388,8,214,105,1,1,0,0,189,296
44135,6,455,69,0,0,0,0,152,221
45376,10,63,1,0,0,0,0,1,2
15147,5,479,181,7,1,0,3,269,461
20146,9,819,20,0,0,0,0,36,56
106155,8,214,92,1,1,0,0,167,261
128907,6,200,28,0,0,0,0,48,76
59145,8,214,57,0,0,0,0,100,157
53913,9,912,2,0,0,0,0,10,12
162492,11,306,4,0,0,0,0,2,6
107375,7,384,2,0,0,0,0,1,3
91051,7,384,5,0,0,0,0,11,16
9706,4,885,4,0,0,0,0,2,6
84575,4,885,4,0,0,0,0,5,9
20317,7,175,2,0,0,0,0,20,22
25932,8,214,2,0,0,0,0,4,6
109286,8,214,96,0,0,0,1,159,256
110338,8,214,47,0,0,0,0,101,148
82076,7,641,18,0,0,0,0,24,42
121531,9,657,7,0,0,0,1,15,23
32056,8,489,296,12,1,1,4,566,880
78629,9,367,2,0,0,0,0,5,7
155911,8,489,269,7,1,1,1,473,752
86118,10,355,2,0,0,0,0,4,6
46250,8,214,19,1,1,0,0,43,64
166202,7,56,4,0,0,0,0,11,15
155646,5,225,23,0,0,0,0,39,62
30137,8,800,135,3,0,1,0,298,437
130471,9,243,0,0,0,0,0,9,9
61408,7,748,1,0,0,0,0,0,1
143360,6,78,767,21,11,0,4,2354,3157
118634,9,640,11,0,0,0,0,22,33
82472,9,85,19,0,0,0,0,25,44
34938,6,785,14,3,0,0,1,24,42
87886,10,111,1,0,0,0,0,2,3
3410,6,290,28,5,1,0,0,61,95
130700,7,100,15,1,1,0,0,39,56
112473,7,489,35,1,1,0,0,56,93
125694,10,178,2,0,0,0,0,2,4
24351,5,404,75,0,0,0,1,140,216
121250,10,178,2,0,0,0,0,4,6
132381,9,380,16,2,1,0,0,27,46
167827,7,56,1,0,0,0,0,1,2
170509,6,800,34,1,0,0,0,67,102
16547,4,678,2,0,0,0,0,0,2
92619,5,76,4,0,0,0,0,6,10
146209,8,800,60,2,1,0,0,108,171
19397,5,124,47,0,0,0,0,66,113
83164,10,790,2,0,0,0,0,5,7
53842,8,214,40,0,0,0,0,82,122
27320,7,78,14,1,1,0,0,24,40
91476,11,623,2,0,0,0,0,4,6
146445,11,623,5,0,0,0,0,3,8
35919,10,104,8,0,0,0,0,13,21
401,11,214,1,0,0,0,0,1,2
123877,8,214,184,2,1,0,3,373,563
14010,5,783,8,1,0,0,1,16,26
57031,9,471,2,0,0,0,0,4,6
70556,6,200,6,0,0,0,0,10,16
106110,8,214,107,0,0,0,0,196,303
147145,7,196,13,1,1,0,0,32,47
82241,11,489,1,0,0,0,0,0,1
60547,9,302,1,0,0,0,0,2,3
150947,5,200,13,0,0,0,0,26,39
110578,9,46,1,0,0,0,0,5,6
88886,9,796,4,0,0,0,0,3,7
30679,10,628,4,0,0,0,0,6,10
46473,10,628,10,1,0,1,0,15,27
99088,7,800,4,0,0,0,0,7,11
122019,9,175,10,1,1,0,0,17,29
116892,9,175,4,0,0,0,0,8,12
114368,9,545,4,0,0,0,0,5,9
113689,9,78,14,0,0,0,0,29,43
121275,6,800,6,0,0,0,0,12,18
6232,8,214,38,1,0,0,0,83,122
34667,6,455,24,0,0,0,0,38,62
92255,6,200,7,0,0,0,0,17,24
62423,4,890,10,0,0,0,0,14,24
69133,9,912,4,0,0,0,0,13,17
57708,7,492,3,0,0,0,0,3,6
92172,9,632,1,0,0,0,0,1,2
89576,7,489,50,1,1,0,0,86,138
136007,8,214,0,0,0,0,0,1,1
50008,8,306,1,0,0,0,0,1,2
46071,7,611,2,0,0,0,0,4,6
11866,8,800,28,1,0,0,0,58,87
95382,10,392,4,0,0,0,0,10,14
66908,9,819,10,0,0,0,0,19,29
149732,10,81,3,0,0,0,0,2,5
142871,10,81,3,0,0,0,0,4,7
107680,5,118,7,1,1,0,2,28,39
43933,9,706,8,1,1,0,0,14,24
94689,9,706,2,0,0,0,0,3,5
65188,9,706,2,0,0,0,0,3,5
95060,9,706,2,0,0,0,0,3,5
54751,9,706,2,0,0,0,0,3,5
4396,9,706,2,0,0,0,0,3,5
61872,9,489,16,2,2,0,0,26,46
35832,9,489,12,0,0,0,0,20,32
140887,9,570,6,0,0,0,0,7,13
163868,9,353,2,0,0,0,0,1,3
11800,9,353,2,0,0,0,0,1,3
90607,10,903,1,0,0,0,0,0,1
82182,8,800,2,0,0,0,0,0,2
115557,8,214,36,0,0,0,0,69,105
119416,6,290,35,2,1,0,0,57,95
162488,5,124,11,0,0,0,0,22,33
104318,9,452,2,0,0,0,0,3,5
106296,7,521,8,0,0,0,0,14,22
147666,9,630,133,3,1,1,2,220,360
93662,10,159,7,0,0,0,0,13,20
33401,9,885,8,0,0,0,0,11,19
146428,5,800,6,0,0,0,0,8,14
118806,9,483,10,0,0,0,0,30,40
66287,11,800,9,0,0,0,0,8,17
134647,8,214,19,0,0,0,0,17,36
61895,11,124,1,0,0,0,0,0,1
57832,8,214,84,1,1,0,1,136,223
4261,9,399,6,0,0,0,0,9,15
55947,5,479,1,0,0,0,0,1,2
20162,8,214,160,2,0,0,0,256,418
19976,8,214,49,0,0,0,0,83,132
58822,9,640,111,0,0,0,0,179,290
109874,10,87,10,0,0,0,0,19,29
84538,10,436,2,0,0,0,1,3,6
159464,4,174,8,0,0,0,0,4,12
156731,5,159,48,0,0,0,1,102,151
45119,7,226,2,0,0,0,0,5,7
100276,7,563,2,0,0,0,0,3,5
16002,5,479,45,2,2,0,0,90,139
40629,5,371,1,0,0,0,0,2,3
12390,9,175,2,0,0,0,0,6,8
151639,8,403,2,0,0,0,0,4,6
108152,9,489,3,0,0,0,0,6,9
158566,9,658,2,0,0,0,0,3,5
34450,7,741,4,0,0,0,0,0,4
69517,9,597,4,0,0,0,0,9,13
164438,9,545,5,0,0,0,0,12,17
147185,7,56,6,0,0,0,0,14,20
144811,7,78,12,0,0,0,0,26,38
41859,9,380,4,0,0,0,0,7,11
74671,6,455,34,2,0,0,1,58,95
135282,10,797,1,0,0,0,0,2,3
154970,5,159,94,1,1,0,1,151,248
61039,9,380,2,0,0,0,0,3,5
37429,9,577,1,0,0,0,0,1,2
72170,10,743,6,0,0,0,0,26,32
150694,10,743,6,0,0,0,0,8,14
154623,9,589,8,0,0,0,0,18,26
104961,7,741,41,2,1,0,0,61,105
8063,9,630,3,0,0,0,0,0,3
2054,9,545,1,0,0,0,0,1,2
18160,7,872,4,0,0,1,0,8,13
86530,7,872,2,0,0,1,0,4,7
11946,9,313,2,0,0,0,0,1,3
23099,9,630,134,2,0,0,0,757,893
4465,6,800,3,0,0,0,0,2,5
80455,6,200,33,0,0,0,0,82,115
159692,9,630,32,0,0,0,0,128,160
74593,9,78,8,0,0,0,0,11,19
170508,11,623,2,0,0,0,0,2,4
163552,5,225,33,1,0,0,0,65,99
76136,5,455,36,1,0,0,0,54,91
49743,6,200,10,0,0,0,0,13,23
88173,10,322,1,0,0,0,0,1,2
47782,10,289,1,0,0,0,0,2,3
102619,10,322,1,0,0,0,0,3,4
78918,10,322,1,0,0,0,0,0,1
144999,7,521,2,0,0,0,0,4,6
83137,7,521,2,0,0,0,0,4,6
14185,6,404,12,0,0,0,0,28,40
19752,6,124,5,0,0,0,0,5,10
123923,7,56,19,0,0,0,0,27,46
168159,7,56,4,1,0,0,0,7,12
160698,7,56,11,1,1,0,0,23,36
96265,9,30,20,0,0,0,0,17,37
133437,5,479,172,3,1,0,0,331,507
60682,10,743,2,0,0,0,0,3,5
21061,10,903,5,0,0,0,0,14,19
147252,10,917,1,0,0,0,0,7,8
85733,10,917,8,0,0,0,0,16,24
98174,10,413,2,0,0,0,0,4,6
70318,9,497,8,0,0,0,0,15,23
159498,10,111,1,0,0,0,0,1,2
157293,6,922,10,0,0,0,0,24,34
108331,9,380,4,0,0,0,0,4,8
121787,8,717,157,18,4,1,0,391,571
12497,5,159,21,1,1,0,0,39,62
70628,5,455,8,0,0,0,0,14,22
103500,6,489,2,0,0,0,0,9,11
62999,6,455,50,0,0,0,0,93,143
100774,7,587,20,0,0,0,0,21,41
127020,9,575,2,0,0,0,0,4,6
63359,9,575,2,0,0,0,0,4,6
134969,4,519,41,3,0,0,1,83,128
43389,7,56,3,0,0,0,0,4,7
43283,9,489,88,0,0,0,1,179,268
116352,9,489,39,0,0,0,0,72,111
100074,6,51,26,1,1,0,0,51,79
28609,9,607,2,0,0,0,0,4,6
92260,8,214,563,10,6,0,2,1081,1662
28833,9,243,4,0,0,0,0,4,8
47464,4,36,5,0,0,0,0,12,17
31993,7,211,8,0,0,0,0,5,13
164250,11,214,0,3,0,0,0,0,3
123460,4,36,9,0,0,0,1,15,25
53323,10,355,4,0,0,0,0,13,17
22704,10,355,0,0,0,0,0,8,8
105421,8,174,35,0,0,0,0,63,98
45897,10,66,12,0,0,0,0,12,24
149262,9,819,28,0,0,0,1,53,82
120384,9,462,41,3,0,1,0,94,139
17614,5,455,14,0,0,0,0,22,36
150089,5,455,9,0,0,0,0,16,25
114012,9,314,2,0,0,0,0,6,8
168172,5,76,2,0,0,0,0,8,10
42283,7,488,26,0,0,0,0,45,71
138547,4,752,16,0,0,0,0,30,46
143544,6,514,13,0,0,0,0,23,36
62619,7,741,3,0,0,0,0,11,14
125485,6,514,12,0,0,0,0,26,38
128301,10,105,4,0,0,0,0,4,8
25889,10,799,4,0,0,0,0,4,8
3350,4,690,1,0,0,0,0,0,1
131872,10,797,21,0,0,0,0,42,63
12567,9,796,2,0,0,0,0,4,6
170556,10,60,2,0,0,0,0,3,5
47133,9,42,2,0,0,0,0,6,8
147016,8,800,40,0,0,0,0,58,98
9396,9,796,2,0,0,0,0,10,12
13712,9,796,4,0,0,0,0,5,9
143031,10,322,2,0,0,0,0,2,4
61790,10,550,2,0,0,0,0,2,4
124104,6,124,1,0,0,0,0,0,1
149100,5,118,25,1,0,0,0,47,73
29176,4,375,5,0,0,0,0,12,17
164960,4,885,138,0,0,0,0,229,367
80233,8,214,32,0,0,0,0,62,94
26657,7,175,0,0,0,0,0,19,19
64087,8,214,13,0,0,0,0,29,42
154726,9,589,0,0,0,0,0,2,2
107022,11,812,2,0,0,0,0,2,4
20302,10,289,4,0,0,0,0,6,10
58290,4,908,3,0,0,0,0,4,7
133887,5,455,14,1,1,0,0,41,57
157042,7,118,4,0,0,0,0,11,15
89218,5,800,15,1,1,0,0,25,42
17411,11,124,2,0,0,0,0,0,2
27505,8,214,17,0,0,0,0,22,39
118035,8,677,160,8,2,1,2,300,473
103586,4,569,12,1,0,0,0,30,43
29470,8,812,1,0,0,0,0,0,1
20206,9,782,2,0,0,0,0,5,7
55846,9,782,2,0,0,0,0,3,5
16487,9,782,2,0,0,0,0,5,7
104134,7,748,1,0,0,0,0,0,1
103228,7,373,2,0,0,0,0,4,6
36136,5,404,16,0,0,0,0,30,46
114120,9,874,6,0,0,0,0,7,13
89868,7,226,2,0,0,0,0,3,5
52158,9,838,2,0,0,0,0,4,6
66265,8,658,1,0,0,0,0,0,1
80445,7,56,8,0,0,0,0,10,18
90460,4,675,2,0,0,0,0,3,5
148776,8,800,280,14,4,0,2,436,736
68920,8,30,1,0,0,0,0,2,3
116546,8,214,390,2,1,0,2,736,1131
98926,5,821,9,0,0,0,1,13,23
169787,6,601,25,3,0,0,0,59,87
27211,9,462,20,0,0,0,0,44,64
105219,8,214,212,0,0,0,1,342,555
18797,9,374,10,0,0,0,0,16,26
109909,9,873,4,0,0,0,0,4,8
171018,6,106,5,0,0,0,0,7,12
140935,9,117,22,0,0,0,0,53,75
1393,7,56,6,0,0,0,0,17,23
121779,9,374,15,0,0,0,0,21,36
131084,9,374,16,2,1,0,0,50,69
50833,8,214,82,1,0,0,0,161,244
7783,6,51,81,6,2,0,0,201,290
130267,5,159,14,0,0,0,1,29,44
9522,8,214,1202,0,0,0,2,2143,3347
76220,9,471,3,0,0,0,0,5,8
46266,4,752,99,3,1,0,0,178,281
75983,5,34,1,0,0,0,0,2,3
40917,8,214,138,0,0,0,0,262,400
15828,6,51,111,3,1,0,2,244,361
59839,4,752,1,0,0,0,0,0,1
148438,8,214,115,0,0,0,1,206,322
42913,4,174,1,0,0,0,0,0,1
160802,6,455,6,0,0,0,0,14,20
131505,6,51,12,0,0,0,0,18,30
17309,9,658,12,1,1,0,0,25,39
98614,5,800,7,0,0,0,0,8,15
108468,6,290,16,4,2,0,0,35,57
18176,6,518,2,0,0,0,0,4,6
15732,9,471,2,0,0,0,0,4,6
35322,9,374,2,0,0,0,0,3,5
28903,10,628,2,0,0,0,0,4,6
78255,5,58,1,0,0,0,0,0,1
55479,8,214,296,0,0,0,0,511,807
166129,7,489,8,1,2,0,0,10,21
163402,5,455,5,0,0,0,0,9,14
37375,4,908,1,0,0,0,0,2,3
96283,9,78,2,0,0,0,0,4,6
10668,6,455,25,1,1,0,0,45,72
18574,6,821,14,0,0,0,1,27,42
147980,6,132,1,0,0,0,0,0,1
89795,7,800,6,0,0,0,0,9,15
38118,9,151,3,0,0,0,0,13,16
124158,9,151,1,0,0,0,0,4,5
94720,6,885,10,0,0,0,0,14,24
59459,9,456,2,0,0,0,0,3,5
96716,10,413,2,0,0,0,0,3,5
16097,9,302,2,0,0,0,0,3,5
38362,10,322,6,0,0,0,0,5,11
96690,9,100,11,2,1,0,2,25,41
40645,10,798,2,0,0,0,0,5,7
13360,10,111,2,0,0,0,0,4,6
19463,10,798,4,1,1,0,0,8,14
104598,9,640,5,0,0,0,0,8,13
155805,10,377,8,0,0,0,0,18,26
70297,10,377,6,2,2,0,0,28,38
92015,10,798,4,0,0,0,0,4,8
23880,10,322,2,0,0,0,0,3,5
63964,6,785,10,0,0,0,0,17,27
58716,10,798,0,0,0,0,0,3,3
132342,10,798,0,0,0,0,0,4,4
86016,10,798,4,0,0,0,0,5,9
4999,10,413,10,1,2,0,0,8,21
81767,9,819,9,0,0,0,0,19,28
56961,9,819,1,0,0,0,0,1,2
73067,4,923,2,0,0,0,0,3,5
159784,8,800,120,12,4,1,1,212,350
62606,9,873,0,0,0,0,0,14,14
28696,9,380,1,0,0,0,0,1,2
60193,9,640,36,0,0,0,0,63,99
149183,8,800,10,0,0,0,0,19,29
15043,9,374,2,0,1,0,0,3,6
116262,5,76,10,0,0,0,0,21,31
94930,11,214,2,0,0,0,0,0,2
120430,9,64,1,0,0,0,0,3,4
53324,10,111,1,0,0,0,0,1,2
47701,7,508,1,0,0,0,0,1,2
23192,8,214,51,0,0,0,0,99,150
26299,4,790,1,0,0,0,0,0,1
33384,4,306,4,0,0,0,0,6,10
144769,7,805,2,0,0,0,0,4,6
80212,10,355,0,0,0,0,0,8,8
140218,5,561,2,0,0,0,0,0,2
158956,9,560,2,0,0,0,0,4,6
113181,9,462,2,0,0,0,0,5,7
117138,5,118,9,0,0,0,0,12,21
146079,10,81,2,0,0,0,0,3,5
141698,9,243,2,0,0,0,0,7,9
127470,9,145,2,0,0,0,0,3,5
63776,9,828,2,0,0,0,0,4,6
38243,4,638,6,1,0,0,0,11,18
58954,7,508,2,0,0,0,0,5,7
131503,10,831,2,0,0,0,0,3,5
5769,7,100,211,7,2,2,0,386,608
79701,7,100,59,4,1,1,0,128,193
167744,9,43,2,0,0,0,0,4,6
91793,10,66,2,0,0,0,0,4,6
107289,10,413,10,0,0,0,0,11,21
153733,10,413,4,0,0,0,0,9,13
115648,7,822,1,0,0,0,0,2,3
5038,10,294,2,0,0,0,0,6,8
164569,9,640,10,0,0,0,0,13,23
99438,7,861,8,0,0,0,0,19,27
89275,7,100,6,0,0,0,0,17,23
67352,11,800,4,0,0,0,0,8,12
117051,4,890,7,0,0,0,0,14,21
121246,9,6,2,0,0,0,0,6,8
15148,6,235,2,0,0,0,0,2,4
40327,8,403,29,1,0,0,0,40,70
136736,7,100,4,0,0,0,0,7,11
46526,7,79,1,0,0,0,0,1,2
101195,10,111,0,0,0,0,0,4,4
17090,9,640,14,0,0,0,0,27,41
80785,7,521,5,0,0,0,0,19,24
101615,7,100,10,0,0,0,0,15,25
128179,9,640,2,0,0,0,0,7,9
103171,9,640,2,0,0,0,0,3,5
113869,8,562,12,0,0,0,0,14,26
163091,7,693,2,0,0,0,0,4,6
16213,9,607,2,0,0,0,0,4,6
5045,10,820,0,0,0,0,0,10,10
53233,9,489,6,0,0,0,0,3,9
105497,10,66,4,0,0,0,0,11,15
40704,10,781,2,0,0,0,1,13,16
60127,4,658,598,17,4,2,4,1577,2202
121439,6,174,3,0,0,0,0,0,3
96932,9,492,2,0,0,0,0,3,5
80639,4,658,477,6,1,0,4,1205,1693
143299,7,367,7,0,0,0,0,10,17
7276,9,367,9,0,0,0,0,17,26
157231,7,367,5,0,0,0,0,6,11
30211,9,367,8,0,0,0,0,9,17
2145,9,216,3,0,0,0,0,4,7
58690,10,413,0,0,0,0,0,4,4
2832,4,199,51,0,0,0,2,66,119
83027,8,214,1,0,0,0,0,0,1
25539,10,413,2,0,0,0,0,3,5
67593,10,798,2,0,0,0,0,3,5
153238,10,322,6,0,0,0,1,8,15
136617,7,38,1,0,0,0,0,0,1
122112,9,570,3,0,0,0,1,4,8
114396,8,214,198,1,0,0,1,449,649
120060,4,36,6,0,0,0,0,7,13
6320,6,404,38,0,0,0,0,74,112
127024,9,147,2,0,0,0,0,3,5
116293,9,706,4,0,0,0,0,8,12
11076,8,489,1,0,0,0,0,0,1
117368,7,367,8,0,0,0,0,0,8
154086,10,66,2,1,1,0,0,48,52
13345,7,175,2,0,0,0,0,13,15
45063,8,88,1,0,0,0,0,2,3
45746,4,174,1,0,0,0,0,1,2
5254,4,885,1,0,0,0,0,1,2
24637,10,66,4,0,0,0,0,4,8
99416,7,535,23,0,0,0,0,52,75
139535,7,535,6,0,0,0,0,20,26
67025,4,36,24,1,1,0,0,58,84
109910,4,658,3,0,0,0,0,8,11
48280,9,4,2,0,0,0,0,0,2
76458,6,200,30,0,0,0,0,50,80
77779,9,184,4,0,0,0,0,4,8
52506,9,184,4,0,0,0,0,8,12
79702,7,226,2,0,0,0,0,3,5
168242,7,864,9,1,0,1,0,3,14
42553,9,469,2,0,0,0,0,4,6
107894,9,632,3,0,0,0,0,4,7
111477,9,632,1,0,0,0,0,3,4
67527,11,800,19,0,0,0,0,15,34
153345,4,752,4,0,0,0,0,7,11
168039,4,200,9,0,0,0,0,27,36
12632,10,617,1,0,0,0,0,0,1
7355,10,701,21,0,0,0,0,26,47
130771,6,489,1,0,0,0,0,0,1
78584,7,175,2,0,0,0,0,2,4
65273,5,200,1,0,0,0,0,2,3
79355,9,100,1,0,0,0,0,0,1
50606,10,555,2,0,0,0,0,6,8
140500,7,885,1,0,1,0,0,0,2
130071,10,178,2,0,0,0,0,3,5
60162,5,518,4,0,0,0,0,8,12
157966,8,214,223,3,2,0,0,431,659
68787,5,518,4,0,0,0,0,10,14
153392,9,556,2,0,0,0,0,6,8
8088,7,157,7,0,0,0,0,12,19
135483,7,175,5,0,0,0,0,5,10
28787,4,453,4,0,0,0,0,6,10
89786,9,367,1,0,0,0,0,11,12
41182,8,403,2,0,0,0,0,0,2
84516,8,214,2,0,0,0,0,4,6
10058,8,214,1,0,0,0,0,2,3
18395,4,658,687,18,4,0,2,1208,1919
22644,8,214,3,0,0,0,0,7,10
47627,8,214,2,0,0,0,0,4,6
159291,8,214,2,0,0,0,0,4,6
78058,8,214,2,0,0,0,0,4,6
153209,8,214,2,0,0,0,0,4,6
50317,8,214,2,0,0,0,0,4,6
95172,8,214,3,0,0,0,0,6,9
136225,8,214,2,0,0,0,0,4,6
113620,8,214,2,0,0,0,0,4,6
15274,8,214,2,0,0,0,0,4,6
16432,8,214,2,0,0,0,0,4,6
91847,8,214,1,0,0,0,0,3,4
152481,8,214,2,0,0,0,0,4,6
53166,8,214,2,0,0,0,0,4,6
21050,8,214,3,0,0,0,0,7,10
61682,9,65,5,0,0,0,0,5,10
12433,9,65,2,0,0,0,0,8,10
40120,8,489,81,0,0,0,0,114,195
112154,9,842,15,0,0,0,0,7,22
29424,9,819,2,0,0,0,0,4,6
40050,7,126,1,0,0,0,0,0,1
144515,9,313,2,0,0,0,0,3,5
113616,4,752,1,0,0,0,0,1,2
131836,11,214,1,0,0,0,0,0,1
8047,9,706,2,0,0,0,0,3,5
42839,6,455,32,1,0,0,1,61,95
32410,6,174,2,0,0,0,0,4,6
92695,4,427,13,0,0,0,0,41,54
114783,7,149,6,0,0,0,0,6,12
108566,10,917,2,0,0,0,0,3,5
135466,10,917,4,0,0,0,0,23,27
113416,10,917,2,0,0,0,0,1,3
44547,4,36,13,0,0,0,0,29,42
49186,6,821,10,2,1,0,2,24,39
101231,6,821,10,4,4,0,1,20,39
102947,9,828,3,0,0,0,0,4,7
101493,7,755,7,0,0,0,0,13,20
86317,7,805,5,1,0,0,0,13,19
21586,4,458,4,0,0,0,0,6,10
73704,6,200,80,2,0,0,1,140,223
36281,8,800,199,10,2,1,2,298,512
169158,9,6,7,0,0,0,0,6,13
163618,11,244,1,0,0,0,0,0,1
34182,8,214,44,1,0,0,1,68,114
81168,9,489,6,0,0,0,0,5,11
106324,4,427,2,0,0,0,0,7,9
132986,7,295,1,0,0,0,0,1,2
4981,7,118,1,0,0,0,0,1,2
89472,10,797,3,0,0,0,0,4,7
53871,5,200,4,0,0,0,0,5,9
11659,7,157,4,0,0,0,0,4,8
103016,6,78,186,6,2,0,3,368,565
98075,9,658,5,0,0,0,0,9,14
94096,10,525,11,0,0,0,0,18,29
24918,7,484,2,0,0,0,0,4,6
154572,9,658,2,0,0,0,0,4,6
78526,9,6,1,0,0,0,0,2,3
91854,9,658,2,0,0,0,0,4,6
121009,6,306,715,15,0,2,7,1477,2216
165874,7,872,2,0,0,0,0,4,6
1394,8,800,42,0,0,0,0,93,135
103599,10,628,2,0,0,0,0,3,5
96775,9,78,16,1,0,0,0,28,45
77421,9,177,2,0,0,0,0,5,7
108697,10,87,2,0,0,0,0,2,4
95845,10,87,2,0,0,0,0,2,4
144619,10,87,10,0,0,0,0,7,17
143506,7,488,3,0,0,0,0,6,9
97956,7,488,4,0,0,0,0,8,12
57432,6,667,12,0,0,0,0,23,35
112965,7,484,10,0,0,1,0,23,34
45268,4,658,206,1,1,0,4,454,666
21437,5,200,2,0,0,0,0,4,6
76739,9,287,1,0,0,0,0,1,2
108703,9,640,37,0,0,0,0,75,112
114695,9,630,2,0,0,0,0,0,2
100423,10,790,4,0,0,0,0,4,8
58766,9,575,3,0,0,0,0,8,11
129927,9,819,8,0,0,0,0,17,25
22934,9,842,2,0,0,0,0,4,6
36675,4,569,2,0,0,0,0,4,6
114850,4,427,11,0,0,0,0,34,45
107956,4,36,8,0,0,0,0,21,29
85,7,611,2,0,0,0,0,4,6
81616,8,403,2,0,0,0,0,4,6
84076,9,246,8,0,0,0,0,15,23
11115,10,434,18,2,0,0,0,37,57
107497,5,200,8,0,0,0,0,19,27
71649,5,218,1,0,0,0,0,0,1
132896,5,561,1,0,0,0,0,0,1
100618,9,367,5,0,0,0,0,10,15
168181,8,30,1,0,0,0,0,1,2
70290,7,611,1,0,0,0,0,4,5
144105,9,315,151,9,6,0,1,238,405
92569,9,78,6,0,0,0,0,17,23
48127,9,315,2,0,0,0,0,3,5
158097,8,214,1,0,0,0,0,0,1
163172,7,748,0,0,0,0,0,5,5
125458,8,214,1,0,0,0,0,0,1
165644,8,214,1,0,0,0,0,0,1
80667,5,667,3,0,0,0,0,5,8
164230,9,145,2,0,0,0,0,3,5
26323,9,145,1,0,0,0,0,2,3
157136,9,145,1,0,0,0,0,2,3
150927,8,174,15,0,0,0,0,30,45
80791,4,885,78,1,1,0,0,149,229
12330,11,214,1,0,0,0,0,0,1
120935,9,842,2,0,0,0,0,4,6
170659,7,508,1,0,0,0,0,1,2
104381,7,508,1,0,0,0,0,1,2
7241,7,508,1,0,0,0,0,1,2
108882,7,508,1,0,0,0,0,0,1
52845,4,159,4,0,0,0,0,13,17
148898,9,374,2,1,0,0,0,0,3
65100,9,315,10,0,0,0,0,12,22
54294,6,489,1,0,0,0,0,1,2
10358,10,66,1,0,0,0,0,2,3
67954,10,322,2,0,0,0,0,2,4
165196,10,322,5,0,0,0,0,8,13
2427,10,111,6,0,0,0,0,9,15
99555,8,403,1,0,0,0,0,3,4
77099,6,643,1,0,0,0,0,3,4
137487,6,489,1,0,0,0,0,3,4
117643,10,413,12,0,0,0,0,8,20
117073,10,322,2,0,0,0,0,6,8
131378,10,798,1,0,0,0,0,1,2
127570,10,549,2,0,0,0,0,1,3
165117,6,489,1,0,0,0,0,3,4
15253,10,256,10,0,0,0,0,14,24
15214,7,263,1,0,0,0,0,1,2
75924,9,184,2,0,0,0,0,3,5
26835,10,289,11,0,0,0,0,22,33
83512,10,831,1,0,0,0,0,0,1
65123,6,800,1,0,0,0,0,0,1
151431,6,885,30,0,0,0,0,45,75
72600,5,453,2,0,0,0,0,9,11
126684,7,535,35,3,0,0,0,99,137
160294,7,535,3,0,0,0,0,2,5
66956,9,302,3,0,0,0,0,11,14
119383,9,131,3,0,0,0,0,4,7
58327,11,214,2,0,0,0,0,1,3
32474,7,535,1,0,0,0,0,1,2
28588,7,535,136,5,0,1,1,214,357
133266,7,535,1,0,0,0,0,1,2
46725,4,923,4,0,0,0,0,8,12
93557,9,800,20,0,0,0,0,4,24
16863,9,630,1,0,0,0,0,0,1
76530,8,717,186,5,2,1,2,364,560
94213,5,200,25,0,0,0,0,54,79
140001,4,800,2,0,0,0,0,4,6
166604,6,447,343,7,1,0,0,627,978
68410,7,56,0,1,1,0,0,0,2
166665,11,214,1,0,0,0,0,0,1
145130,7,822,4,0,0,0,0,8,12
227,6,141,40,0,0,0,0,64,104
18187,4,36,1,0,0,0,0,0,1
74572,8,403,3,0,0,0,0,0,3
56944,10,322,1,0,0,0,0,0,1
9787,9,65,1,0,0,0,0,2,3
76663,5,667,13,0,0,0,0,26,39
159853,4,690,1,0,0,0,0,0,1
57159,6,209,7,0,0,0,0,13,20
130445,4,375,25,0,0,0,0,43,68
171046,10,413,4,0,0,0,0,4,8
94322,10,66,2,0,0,0,0,9,11
34709,4,453,1,0,0,0,0,1,2
145393,10,413,4,0,0,0,0,4,8
24357,8,562,81,1,0,0,0,126,208
38710,8,562,97,0,0,0,0,164,261
87933,6,570,664,40,13,4,8,1245,1974
162614,9,6,2,0,0,0,0,4,6
117330,9,6,2,0,0,0,0,2,4
41445,9,6,23,1,0,0,0,22,46
120784,5,479,28,0,0,0,0,53,81
50250,9,819,5,0,0,0,0,12,17
3167,5,76,25,1,1,0,0,38,65
53742,7,864,6,0,0,0,0,13,19
143645,7,556,5,0,0,0,0,7,12
101727,7,805,6,0,0,0,0,18,24
163820,9,640,11,0,0,0,0,17,28
8975,9,819,7,2,0,0,0,18,27
55087,9,796,2,0,0,0,0,0,2
163747,10,413,2,0,0,0,0,6,8
99146,4,890,37,1,0,0,0,67,105
103747,5,200,34,0,0,0,0,63,97
135538,10,66,6,0,0,0,0,9,15
2511,8,174,2,0,0,0,0,3,5
21521,10,355,0,0,0,0,0,2,2
85340,10,172,2,0,0,0,0,3,5
65178,7,521,6,0,0,0,0,11,17
98328,5,118,1,0,0,0,0,3,4
112405,7,741,13,0,0,0,0,28,41
110148,9,246,3,0,0,0,0,4,7
36982,9,630,12,0,0,0,0,24,36
20383,6,165,121,4,1,0,1,375,502
115418,5,667,25,0,0,0,0,41,66
31317,8,214,2,0,0,0,0,3,5
140905,7,535,25,2,0,0,0,55,82
117604,7,660,1,0,0,0,0,1,2
163867,8,489,1,0,0,0,0,6,7
121393,6,290,10,2,0,1,0,23,36
6374,9,538,10,0,0,0,0,20,30
154155,10,474,44,2,1,0,0,91,138
9217,9,589,4,0,0,0,0,7,11
164702,7,693,1,0,0,0,0,0,1
158033,9,589,19,2,0,0,0,48,69
14366,7,391,6,0,0,0,0,11,17
134933,8,562,78,3,0,0,0,160,241
21643,9,589,20,0,0,0,0,33,53
135797,7,175,0,0,0,0,0,4,4
20352,8,489,38,1,0,0,0,78,117
91135,6,269,28,0,0,0,0,61,89
96997,7,196,2,0,0,0,0,16,18
98690,5,455,8,0,0,0,0,16,24
142755,9,469,4,0,0,0,0,7,11
36534,9,469,16,1,1,0,0,21,39
60569,7,578,8,0,0,0,0,14,22
160154,9,456,2,0,0,0,0,3,5
146509,9,469,4,0,0,0,0,6,10
48591,9,100,2,0,0,0,0,3,5
41081,5,159,12,0,0,0,0,19,31
139806,9,157,4,0,0,0,0,8,12
35504,8,623,75,1,1,0,1,145,223
138274,9,575,8,0,0,0,0,21,29
45760,6,141,2,1,1,0,0,3,7
53681,6,141,6,0,0,0,0,11,17
162033,11,800,17,4,0,0,0,10,31
130493,10,322,1,0,0,0,0,0,1
42752,10,322,1,0,0,0,0,0,1
131771,8,489,62,0,0,0,0,116,178
21010,4,752,3,0,0,0,0,4,7
154267,8,489,157,9,6,0,2,269,443
81528,8,403,2,0,0,0,0,4,6
92133,6,165,23,0,0,0,0,57,80
43867,9,800,11,0,0,0,0,46,57
92181,7,391,4,0,0,0,0,10,14
15713,10,355,10,0,0,0,0,23,33
68398,6,141,2,0,0,0,0,3,5
117880,8,916,1,0,0,0,0,2,3
96457,7,805,1,0,0,0,0,1,2
46827,11,306,4,0,0,0,0,11,15
164756,7,669,2,0,0,0,0,4,6
64983,8,244,2,0,0,0,0,0,2
20234,8,545,1,0,0,0,0,0,1
57277,11,306,1,0,0,0,0,3,4
104595,7,587,1,0,0,0,0,0,1
146106,4,890,20,0,0,0,0,40,60
84932,9,367,2,0,0,0,0,2,4
71600,9,909,2,0,0,0,0,4,6
48668,10,322,2,0,0,0,0,4,6
70733,10,413,2,0,0,0,0,6,8
2878,10,322,2,0,0,0,0,4,6
3735,9,819,3,0,0,0,0,9,12
49143,9,314,2,0,0,0,0,0,2
144690,9,243,8,0,0,0,0,10,18
149122,9,243,3,0,0,0,0,8,11
104930,9,367,3,0,0,0,0,3,6
43218,8,214,191,12,1,0,0,361,565
136465,10,628,1,0,0,0,0,2,3
28911,8,658,1,0,0,0,0,1,2
65873,10,29,1,0,0,0,0,3,4
120095,10,29,3,0,0,0,0,25,28
133253,8,214,2,0,0,0,0,0,2
150908,7,157,14,0,0,0,0,15,29
157783,9,30,4,0,0,0,0,5,9
49722,5,176,3,1,0,0,0,9,13
67901,9,315,1,1,0,0,0,2,4
162548,4,752,829,31,10,4,5,1512,2391
136002,9,429,1,0,0,0,0,1,2
132499,8,214,97,0,0,0,0,172,269
159839,4,752,279,10,3,0,4,537,833
87447,9,657,2,0,0,0,0,4,6
119007,9,575,6,0,0,0,0,9,15
108137,8,403,1,0,0,0,0,0,1
28736,4,375,1,0,0,0,0,2,3
89050,4,375,1,0,0,0,0,11,12
113750,11,812,2,1,0,0,0,1,4
147944,6,296,1,0,0,0,0,0,1
17712,9,842,34,0,0,0,0,129,163
111685,4,752,213,8,3,0,4,393,621
109328,6,489,62,1,1,0,1,90,155
125374,7,805,26,0,0,0,1,56,83
170833,7,805,0,0,0,0,0,8,8
129684,9,243,0,0,0,0,0,5,5
80493,9,243,2,0,0,0,0,8,10
90380,9,243,4,0,0,0,0,5,9
47994,5,200,6,0,0,0,0,7,13
66129,6,235,499,18,4,1,2,982,1506
145728,9,216,33,0,0,0,0,63,96
60879,8,214,140,1,0,0,0,248,389
59681,6,235,78,3,2,0,1,124,208
148103,9,457,1,0,0,0,0,1,2
47606,9,457,1,0,0,0,0,1,2
20660,9,85,2,0,0,0,0,3,5
112204,9,796,2,0,0,0,0,3,5
116779,9,203,2,0,0,0,0,3,5
136820,9,796,2,0,0,0,0,3,5
108163,10,917,5,0,0,0,0,17,22
84324,8,489,124,2,3,0,0,196,325
91965,10,722,2,0,0,0,0,4,6
126786,9,89,16,0,0,0,0,33,49
159532,9,640,23,0,0,0,0,42,65
4604,9,532,29,1,1,0,0,64,95
124427,7,175,12,0,0,0,0,32,44
85578,8,545,15,0,0,0,0,19,34
14168,9,341,8,0,0,0,0,5,13
3422,10,357,4,0,0,0,0,4,8
139740,10,357,2,0,0,0,0,3,5
30140,8,214,72,0,0,0,1,166,239
75388,8,800,25,1,1,0,0,39,66
7586,8,214,1,0,0,0,0,0,1
150394,6,800,189,26,2,0,1,431,649
120630,5,78,2,0,0,0,0,3,5
147289,9,640,11,0,0,0,0,19,30
114298,7,570,1,0,0,0,0,1,2
27941,7,829,1,0,0,0,0,1,2
83719,9,560,8,0,0,0,0,12,20
30300,6,209,1,0,0,0,0,0,1
163791,10,781,2,0,0,0,0,3,5
41024,9,819,6,0,0,0,0,12,18
68893,4,885,68,1,1,0,0,123,193
103714,9,341,2,0,0,0,0,3,5
49059,7,611,2,0,0,0,0,3,5
11571,9,341,7,0,0,0,0,12,19
38753,6,78,29,2,0,0,0,56,87
85316,9,360,1,0,0,0,0,1,2
106460,9,360,1,0,0,0,0,1,2
40263,4,658,91,6,0,0,0,174,271
158693,10,66,8,0,0,0,0,17,25
76753,8,562,108,3,0,0,0,205,316
24237,6,800,257,17,6,0,3,619,902
24383,8,885,1,0,0,0,0,0,1
134538,10,618,2,0,0,0,0,3,5
125095,5,58,5,0,0,0,0,9,14
97109,5,58,1,0,0,0,0,0,1
40933,7,38,512,0,0,0,4,1171,1687
69493,5,200,1,0,0,0,0,0,1
104485,7,864,7,0,0,0,0,1,8
112393,9,497,14,0,0,0,1,19,34
51569,7,912,2,0,0,0,0,0,2
41738,9,497,4,0,0,0,0,6,10
169906,7,384,2,0,0,0,0,0,2
73784,6,78,79,2,1,0,0,153,235
92509,10,66,7,0,0,0,0,12,19
110905,10,66,1,0,0,0,0,5,6
168690,9,46,2,0,0,0,0,3,5
27497,8,48,155,0,0,0,1,291,447
113357,9,885,4,0,0,0,0,6,10
18148,6,347,25,0,0,0,0,34,59
132248,6,141,2,0,0,0,0,6,8
22790,6,141,14,0,0,0,0,21,35
9455,6,514,2,0,0,0,0,4,6
152181,6,347,4,0,0,0,0,6,10
166844,9,429,2,0,0,0,0,0,2
156658,7,484,2,0,0,0,0,7,9
113815,7,484,2,0,0,0,0,4,6
35372,9,873,2,0,0,0,0,2,4
126223,7,484,0,0,0,0,0,6,6
104725,7,484,0,0,0,0,0,3,3
49133,8,658,8,0,0,0,0,25,33
66755,5,200,6,0,0,0,0,7,13
137722,7,575,12,2,0,0,0,31,45
90762,9,157,12,0,0,0,0,23,35
75903,5,159,9,0,0,0,0,10,19
44078,6,124,47,4,1,0,0,71,123
170647,6,269,226,0,0,0,3,421,650
88885,10,172,1,0,0,0,0,0,1
141095,9,607,4,0,0,0,0,8,12
160254,9,607,2,0,0,0,0,0,2
45908,6,124,9,0,0,0,0,9,18
8034,9,380,0,0,0,0,0,2,2
86698,9,380,48,0,0,0,0,65,113
161633,4,200,2,0,0,0,0,1,3
138774,5,66,115,7,4,2,0,208,336
82724,6,165,73,2,1,0,2,181,259
152436,6,165,16,0,0,0,0,37,53
71831,8,214,107,0,0,0,0,220,327
13137,10,66,2,0,0,0,0,7,9
78394,10,111,20,0,0,0,0,14,34
95897,10,111,6,0,0,0,0,10,16
51143,7,829,8,0,0,0,0,11,19
131241,7,175,4,0,0,0,0,10,14
27435,7,56,2,0,0,0,0,4,6
34800,4,885,136,2,1,0,1,277,417
16895,8,214,23,0,0,0,0,31,54
135043,11,623,2,0,0,0,0,1,3
70705,7,56,1,0,0,0,0,0,1
114211,8,489,105,2,1,0,2,182,292
138194,8,489,138,1,0,0,2,260,401
77053,9,560,2,0,0,0,0,3,5
79684,9,782,6,0,0,0,0,11,17
45020,4,658,125,1,0,0,0,238,364
38867,4,658,82,0,0,0,0,134,216
37311,7,842,45,1,0,0,0,77,123
77507,6,643,14,0,0,0,0,30,44
133707,6,235,10,0,0,0,0,35,45
159943,8,489,68,0,0,0,0,127,195
90711,9,842,1,0,0,0,0,1,2
36023,8,214,151,1,0,0,1,304,457
73824,10,917,3,0,0,0,0,11,14
123411,4,427,25,0,0,0,0,85,110
36573,8,489,47,1,0,0,1,85,134
170999,8,489,32,0,0,0,0,52,84
168708,7,660,1,0,0,0,0,4,5
130183,4,659,1,0,0,0,0,3,4
13430,11,623,2,0,0,0,0,5,7
122622,4,427,5,0,0,0,0,5,10
73327,4,427,7,0,0,0,0,12,19
12227,4,159,17,0,0,0,0,38,55
126859,8,885,2,0,0,0,0,0,2
142312,8,214,94,0,0,0,0,174,268
38472,10,781,2,0,0,0,0,4,6
66323,10,781,2,0,0,0,0,4,6
23306,7,805,14,0,0,0,0,32,46
64495,9,842,1,0,0,0,0,2,3
53018,9,842,2,0,0,0,0,4,6
91987,10,63,2,0,0,0,0,4,6
120184,4,800,1,0,0,0,0,1,2
66800,9,842,56,0,0,0,0,119,175
124074,7,492,1,0,0,0,0,2,3
159154,4,200,23,0,0,0,0,57,80
80331,8,812,19,1,0,0,0,32,52
47081,7,521,5,0,0,0,0,11,16
166009,4,174,2,0,0,0,0,0,2
168097,9,100,139,3,3,0,1,289,435
34157,8,800,25,0,0,0,0,44,69
167601,7,805,6,0,0,0,0,14,20
114979,4,658,11,0,0,0,0,41,52
147593,9,483,4,0,0,0,0,5,9
154985,7,805,8,0,0,0,0,15,23
94015,7,805,4,0,0,0,0,20,24
12585,7,805,14,0,0,0,0,24,38
94026,6,30,1,0,0,0,0,1,2
92259,6,165,10,0,0,0,0,25,35
13551,7,805,4,0,0,0,0,11,15
10094,6,885,1,0,0,0,0,0,1
76121,7,805,0,0,0,0,0,8,8
148723,9,65,3,0,0,0,0,1,4
158599,9,640,15,0,0,0,0,29,44
31220,9,630,4,0,0,0,0,7,11
90444,8,214,128,2,0,0,0,265,395
122068,8,214,732,0,0,0,2,1319,2053
50233,7,391,2,0,0,0,0,3,5
14604,8,214,740,2,0,0,3,1307,2052
64953,4,800,1,0,0,0,0,0,1
103036,5,893,1,0,0,0,0,0,1
73147,8,214,1012,1,0,0,4,1698,2715
54214,9,8,4,0,0,0,0,13,17
83617,8,214,184,3,1,0,0,350,538
149506,8,545,80,2,0,0,0,184,266
65729,8,545,34,1,0,0,0,77,112
81031,7,367,2,0,0,0,0,4,6
134580,6,800,253,7,1,0,3,669,933
109999,6,290,7,0,0,0,0,18,25
81202,9,630,11,0,0,0,0,22,33
37325,6,165,1,0,0,0,0,2,3
98221,7,508,2,0,0,0,0,7,9
10656,4,199,2,0,0,0,0,12,14
44276,10,653,1,0,0,0,0,1,2
48545,9,632,2,0,0,0,0,4,6
59058,8,30,1,0,0,0,0,1,2
141062,6,885,6,0,0,0,0,8,14
5722,4,159,35,5,2,0,0,74,116
79454,6,489,1806,81,39,7,17,3150,5100
97700,4,800,5005,220,110,2,18,8947,14302
37152,7,578,2,0,0,0,0,4,6
19760,7,578,2,0,0,0,0,2,4
56593,10,66,1,0,0,0,0,2,3
112045,10,111,1,0,0,0,0,2,3
29207,6,141,22,0,0,0,0,41,63
96006,7,611,2,0,0,0,0,4,6
119749,10,466,6,0,0,0,0,8,14
70896,6,306,1,0,0,0,0,0,1
165636,5,181,24,0,0,0,0,30,54
10008,9,842,103,6,2,1,0,145,257
89846,4,427,3,0,0,0,0,6,9
29950,8,214,369,7,2,0,2,769,1149
142,6,885,6,0,0,0,0,10,16
135529,5,699,32,1,1,0,0,59,93
71270,4,36,1,0,0,0,0,0,1
102754,8,214,201,3,2,0,0,531,737
92493,6,269,16,0,0,0,0,22,38
14879,8,30,0,1,0,0,0,0,1
156518,11,30,0,1,0,0,0,0,1
109917,9,630,20,0,0,0,0,27,47
133146,9,782,5,0,0,0,0,6,11
112908,8,214,1,0,0,0,0,1,2
102205,7,741,2,0,0,0,0,3,5
77597,7,30,6,0,0,0,0,12,18
89861,9,640,64,0,0,0,1,104,169
39023,8,214,446,10,4,1,1,756,1218
157861,5,489,32,2,0,1,0,45,80
92748,7,694,95,0,0,0,0,184,279
95278,8,214,2,0,0,0,0,4,6
157869,9,570,10,0,0,0,0,16,26
153085,5,58,12,0,0,0,0,18,30
136122,7,367,2,0,0,0,0,4,6
59309,5,404,10,0,0,0,0,11,21
7065,9,741,6,0,0,0,0,14,20
19018,8,214,6,0,0,0,0,10,16
25159,5,200,7,0,0,0,0,14,21
157084,9,607,7,0,0,0,0,18,25
138302,9,367,1,0,0,0,0,0,1
120515,9,367,1,0,0,0,0,0,1
20442,7,484,6,0,0,0,0,16,22
138330,7,484,0,0,0,0,0,20,20
55424,7,694,23,0,0,0,0,46,69
51768,9,497,22,1,0,0,0,30,53
98558,6,159,88,2,0,0,0,126,216
56710,7,118,2,0,0,0,0,4,6
86924,8,214,80,0,0,0,0,171,251
48917,7,694,4,0,0,0,0,39,43
21534,7,694,2,0,0,0,0,7,9
150557,9,885,4,2,2,0,0,3,11
163960,9,353,2,0,0,0,0,9,11
15840,5,347,16,0,0,0,0,33,49
164822,9,494,2,0,0,0,0,3,5
62491,9,494,2,0,0,0,0,4,6
143992,8,489,29,1,0,0,0,53,83
61595,4,691,36,0,0,0,0,72,108
3462,4,885,33,0,0,0,0,75,108
135474,11,214,1,0,0,0,0,1,2
114540,4,427,14,1,0,0,0,24,39
81978,4,199,1,0,0,0,0,0,1
127945,10,29,4,0,0,0,0,8,12
102047,7,148,13,0,0,0,0,24,37
54985,8,214,8,0,0,0,0,14,22
88743,9,842,391,6,1,2,0,608,1008
162365,9,374,31,0,0,0,0,64,95
122004,9,640,6,0,0,0,0,10,16
34766,4,375,20,0,0,0,0,44,64
44577,9,842,69,1,0,0,0,88,158
157480,9,842,26,0,0,0,0,46,72
128295,11,623,2,0,0,0,0,1,3
31846,7,630,12,1,1,0,0,43,57
137011,10,799,8,0,0,0,0,11,19
2759,11,214,2,0,0,0,0,1,3
51797,10,322,4,0,0,0,0,5,9
46553,6,78,31,0,0,0,0,52,83
99908,7,117,15,0,0,0,0,26,41
132628,10,111,2,0,0,0,0,4,6
163276,7,551,4,0,0,0,0,9,13
2563,10,208,6,0,0,0,0,23,29
34103,9,313,0,0,0,0,0,4,4
5243,6,269,10,0,0,0,0,19,29
145640,8,214,45,0,0,0,0,31,76
126196,5,667,26,0,0,0,0,35,61
149384,5,371,1,0,0,0,0,2,3
121350,9,8,1,0,0,0,0,9,10
22214,6,269,63,3,1,1,0,95,163
8159,6,453,2,0,0,0,0,4,6
159138,4,174,265,19,7,0,2,545,838
45197,6,235,8,0,0,0,0,15,23
28671,6,174,3,0,0,0,0,9,12
156586,10,917,2,0,0,0,0,3,5
72138,8,623,1,0,0,0,0,2,3
76755,8,214,88,1,0,0,1,168,258
47586,11,214,1,0,0,0,0,4,5
101893,5,489,43,2,1,0,1,79,126
162171,5,489,25,1,1,0,0,53,80
82848,5,885,17,1,0,0,1,30,49
65936,10,868,1,0,0,0,0,2,3
9518,7,157,12,1,0,0,0,27,40
140351,5,885,1,0,0,0,0,0,1
19101,11,812,0,0,0,0,0,13,13
70629,5,479,62,1,1,0,0,100,164
27279,5,225,2,0,0,0,0,1,3
155452,8,214,205,1,0,0,0,361,567
62338,4,800,3,0,0,0,0,5,8
147924,6,141,4,0,0,0,0,8,12
38342,4,375,2,0,0,0,0,1,3
106114,9,302,8,0,0,0,0,16,24
83139,5,518,4,0,0,0,0,11,15
95329,10,66,4,0,0,0,0,5,9
167151,9,157,10,0,0,0,0,13,23
121552,10,917,2,0,0,0,0,4,6
169750,10,111,5,0,0,0,0,9,14
167039,9,157,6,0,0,0,0,9,15
123184,8,214,237,1,0,0,0,481,719
89936,5,667,8,0,0,0,0,13,21
16488,6,200,6,0,0,0,0,10,16
111146,6,200,26,1,0,0,0,52,79
109064,9,575,12,0,0,0,0,14,26
59511,5,489,21,1,0,0,0,40,62
103887,8,214,82,7,1,0,0,134,224
34322,8,214,1,0,0,0,0,2,3
61433,9,380,2,0,0,0,0,4,6
153252,4,453,1,0,0,0,0,2,3
80081,6,132,19,0,0,0,0,46,65
39679,9,640,6,0,0,0,0,10,16
28220,5,225,11,0,0,0,0,20,31
126537,4,691,1159,66,31,3,8,2382,3649
95554,9,630,6,0,0,0,0,5,11
17694,4,885,95,0,0,0,1,168,264
111347,8,800,31,0,0,0,0,48,79
52915,4,300,229,16,6,0,6,414,671
149142,4,427,5,0,0,0,0,8,13
41953,5,200,10,1,0,0,0,17,28
34047,6,306,4,0,0,0,0,62,66
92696,9,380,1,0,0,0,0,2,3
146181,9,380,1,0,0,0,0,1,2
69606,9,380,1,0,0,0,0,2,3
131980,9,380,1,0,0,0,0,1,2
20039,10,66,0,0,0,0,0,3,3
40541,10,66,0,0,0,0,0,4,4
126033,8,693,1,0,0,0,0,0,1
91963,10,911,6,0,0,0,0,6,12
121950,8,489,474,12,3,2,4,866,1361
64381,10,493,2,0,0,0,0,1,3
156188,7,148,13,0,0,0,0,29,42
82688,9,630,16,0,0,0,0,23,39
130630,9,630,9,0,0,0,0,14,23
168659,4,300,126,2,1,1,0,164,294
123641,6,585,10,0,0,0,0,18,28
58162,4,800,39,0,0,0,0,80,119
31257,10,357,4,0,0,0,0,4,8
106714,8,214,384,16,3,2,3,739,1147
58037,5,561,2,0,0,0,0,4,6
5457,5,306,1,0,0,0,0,0,1
93016,9,325,6,0,0,0,0,7,13
17769,5,225,6,0,0,0,0,11,17
145482,4,124,400,7,2,0,5,837,1251
92436,7,117,17,0,0,0,0,30,47
143094,4,800,33,1,0,0,0,83,117
165859,9,282,6,0,0,0,0,7,13
138733,9,282,2,0,0,0,0,4,6
33273,9,282,2,0,0,0,0,3,5
165841,10,66,17,1,0,0,0,32,50
145854,5,58,6,0,0,0,0,14,20
111766,10,790,6,0,0,0,0,35,41
166522,9,630,20,0,0,0,0,33,53
144993,7,492,4,0,0,0,0,9,13
39392,9,842,28,0,0,0,0,38,66
161727,9,469,1,0,0,0,0,0,1
121191,6,269,25,0,0,0,0,52,77
7808,6,269,13,0,0,0,0,17,30
112647,9,374,2,0,0,0,0,3,5
62886,9,658,2,0,0,0,0,5,7
85275,9,575,7,0,0,0,0,11,18
99582,4,885,2,0,0,0,0,3,5
86397,5,124,4,0,0,0,0,3,7
68322,6,117,132,5,3,0,0,215,355
28321,6,269,35,0,0,0,0,72,107
33886,4,427,2,0,0,0,0,4,6
69727,7,80,88,7,1,0,0,153,249
44498,4,375,31,0,0,0,0,57,88
82617,4,885,35,0,0,0,0,72,107
76789,9,301,1,0,0,0,0,2,3
81301,10,66,2,0,0,0,0,4,6
168697,6,165,1,0,0,0,0,0,1
111495,6,235,36,1,0,0,0,62,99
62002,10,841,10,0,0,0,0,11,21
76249,6,269,24,0,0,0,1,55,80
152483,8,489,421,15,5,2,3,776,1222
147056,10,917,4,0,0,0,0,9,13
75965,6,800,1,0,0,0,0,0,1
42853,9,469,1,0,0,0,0,0,1
32756,9,469,1,0,0,0,0,0,1
108084,9,469,1,0,0,0,0,0,1
166494,8,717,70,4,0,0,0,154,228
132232,9,469,1,0,0,0,0,0,1
72302,9,100,118,3,1,1,2,213,338
4883,11,214,4,0,0,0,0,4,8
44269,8,717,9,0,0,0,0,38,47
164771,9,469,1,0,0,0,0,0,1
147074,8,800,28,1,1,0,0,70,100
167192,6,200,28,0,0,0,0,59,87
70445,8,214,43,0,0,0,0,79,122
96694,9,100,6,0,0,0,0,15,21
102315,6,141,2,0,0,0,0,4,6
65402,6,141,2,0,0,0,0,0,2
146940,6,200,19,1,0,0,0,37,57
94956,5,821,3,0,0,0,0,1,4
89289,9,100,2,0,0,0,0,4,6
82307,6,78,10,0,0,0,0,14,24
138031,7,521,2,0,0,0,0,3,5
144560,9,158,4,0,0,0,0,4,8
166652,9,158,8,0,0,0,0,10,18
150547,10,322,2,0,0,0,0,4,6
14045,4,885,13,0,0,0,0,19,32
156285,10,917,12,0,0,0,0,24,36
70483,10,66,2,0,0,0,0,4,6
162323,4,300,37,0,0,0,0,50,87
147699,4,800,51,3,1,0,0,116,171
57129,10,911,2,0,0,0,0,3,5
92994,6,785,0,1,2,0,0,0,3
115972,5,225,13,0,0,0,1,28,42
121262,5,225,4,0,0,0,0,11,15
132460,10,493,10,0,0,0,0,13,23
119682,11,214,4,0,0,0,0,3,7
155390,4,200,39,0,0,0,0,44,83
58324,9,8,2,0,0,0,0,2,4
52912,4,658,51,2,0,0,0,91,144
56312,8,622,297,17,5,0,2,556,877
30827,8,622,304,11,5,0,2,679,1001
128411,5,885,2,0,0,0,0,4,6
80274,4,159,1,0,0,0,0,0,1
98710,9,86,4,0,0,0,0,7,11
125061,8,885,8,0,0,0,0,24,32
111528,6,290,24,0,0,0,0,42,66
169993,9,456,6,0,0,0,0,11,17
150662,9,630,19,0,0,0,0,33,52
44217,7,77,3,0,0,0,0,4,7
156423,4,300,108,2,0,0,1,168,279
52748,9,361,30,0,0,0,0,54,84
116172,10,841,1,0,0,0,0,0,1
43884,6,165,3,0,0,0,0,7,10
148845,11,812,1,0,0,0,0,0,1
59462,7,611,8,0,0,0,0,10,18
63345,9,819,3,0,0,0,0,8,11
82779,8,885,121,0,1,0,0,194,316
154769,10,355,3,0,0,0,0,4,7
142870,10,289,1,0,0,0,0,1,2
52562,10,781,1,0,0,0,0,2,3
15247,7,379,6,1,1,0,0,15,23
102620,10,66,3,0,0,0,0,7,10
36726,9,640,14,0,0,0,0,34,48
134962,8,306,1,0,0,0,0,0,1
142376,6,667,14,0,0,0,0,19,33
125750,4,691,24,0,0,0,0,64,88
64123,9,282,2,0,0,0,0,4,6
11421,4,200,2,0,0,0,0,2,4
94187,11,812,1,0,0,0,0,0,1
62934,9,306,1,0,0,0,0,1,2
133956,11,214,1,0,0,0,0,1,2
138546,9,622,4,0,0,0,0,5,9
73003,6,269,10,0,0,0,0,31,41
149273,6,269,2,0,0,0,0,7,9
40713,4,124,294,6,2,1,4,737,1044
99220,10,66,20,3,0,1,0,100,124
143392,11,489,1,0,0,0,0,0,1
85868,5,699,30,0,0,0,0,53,83
94066,8,174,5,0,0,0,0,9,14
138207,11,214,4,0,0,0,0,5,9
104366,9,100,1,0,0,0,0,1,2
146409,10,66,1,0,0,0,0,2,3
79961,4,885,53,0,0,0,0,72,125
2801,5,561,15,0,0,0,0,28,43
28690,10,66,1,0,0,0,0,1,2
98238,10,831,6,0,0,0,0,19,25
59402,8,214,969,17,5,0,4,1698,2693
161524,10,66,2,0,0,0,0,5,7
59112,9,483,4,0,0,0,0,7,11
98065,9,483,2,0,0,0,0,4,6
30397,9,483,2,0,0,0,0,6,8
118503,9,243,2,0,0,0,0,4,6
73618,11,306,1,0,0,0,0,2,3
43813,4,174,1,0,0,0,0,0,1
3537,9,640,13,0,0,0,0,21,34
138122,8,403,322,0,0,0,4,575,901
161060,5,76,3,0,0,0,0,7,10
35994,9,282,7,0,0,0,1,20,28
131287,9,282,3,0,0,0,0,5,8
34793,4,36,1,0,0,0,0,0,1
102708,8,214,0,0,0,0,0,6,6
107042,5,76,6,0,0,0,0,11,17
76125,10,355,1,0,0,0,0,0,1
108177,5,479,21,0,0,0,0,22,43
121971,7,805,1,0,0,0,0,4,5
73806,8,489,3,0,0,0,0,1,4
169138,9,42,2,0,0,0,0,4,6
54538,9,314,2,0,0,0,0,6,8
95103,9,640,15,0,0,0,0,36,51
62769,7,521,2,0,0,0,0,4,6
88460,9,489,20,0,0,0,0,36,56
60723,8,214,1,1,0,0,0,2,4
125741,11,214,0,1,0,0,0,0,1
170569,8,489,3,0,0,0,0,3,6
29930,5,489,2,0,0,0,0,3,5
131618,4,300,88,5,3,0,1,162,259
6491,9,819,9,0,0,0,0,18,27
67435,5,570,2,0,0,0,0,3,5
161625,7,641,10,0,0,0,0,9,19
90781,10,322,2,0,0,0,0,2,4
153266,10,322,2,0,0,0,0,2,4
109356,5,225,4,0,0,0,1,6,11
61887,9,819,4,1,1,0,0,5,11
37988,11,489,2,0,0,0,0,1,3
16493,8,214,2,0,0,0,0,0,2
56715,8,214,89,0,0,0,0,147,236
79048,9,325,2,0,0,0,0,3,5
53902,9,117,20,0,0,0,0,62,82
73631,10,911,2,0,0,0,0,7,9
66833,7,254,2,0,0,0,0,7,9
30768,9,378,1,0,0,0,0,0,1
37239,4,678,53,1,1,0,1,98,154
2068,11,214,3,0,0,0,0,4,7
41340,9,630,4,0,0,0,0,18,22
80286,11,214,2,0,0,0,0,2,4
34250,8,885,51,0,0,0,0,103,154
141027,7,587,24,0,0,0,0,34,58
165973,4,159,13,0,0,0,0,21,34
135828,4,220,11,0,0,0,0,22,33
46705,6,232,18,0,0,0,0,34,52
82142,6,489,2,0,0,0,0,4,6
168945,9,842,1,0,0,0,0,3,4
123172,6,141,12,0,0,0,0,29,41
137151,7,741,3,0,0,0,0,7,10
160230,7,484,1,0,0,0,0,9,10
114558,6,141,46,0,0,0,0,77,123
166951,10,798,1,0,0,0,0,1,2
119337,10,798,1,0,0,0,0,1,2
94024,10,798,1,0,0,0,0,1,2
69813,7,630,8,2,0,0,0,20,30
131027,10,357,3,0,0,0,0,5,8
17908,6,51,80,2,0,0,0,141,223
82391,9,489,35,0,0,0,0,77,112
78679,7,864,6,0,0,0,0,6,12
66483,9,489,66,1,1,0,1,123,192
157110,7,864,2,0,0,0,0,4,6
135414,7,100,18,0,0,0,0,25,43
87904,7,100,13,0,0,0,0,25,38
88338,7,864,4,0,0,0,0,4,8
146560,7,842,9,0,0,0,0,10,19
162211,7,100,13,0,0,0,0,23,36
124900,7,117,2,0,0,0,0,0,2
38568,10,911,14,0,0,0,0,12,26
94231,9,469,1,0,0,0,0,0,1
74400,9,469,1,0,0,0,0,0,1
151259,9,469,1,0,0,0,0,0,1
62232,9,65,2,0,0,0,0,4,6
89999,11,214,4,0,0,0,0,2,6
27541,6,124,10,0,0,0,0,10,20
53280,7,578,4,0,0,0,0,12,16
157625,9,367,60,1,1,0,0,127,189
20081,5,71,9,0,0,0,0,12,21
32850,10,917,0,0,0,0,0,5,5
130808,10,60,4,0,0,0,0,12,16
9751,8,214,52,0,0,0,0,92,144
13445,9,86,13,1,0,0,0,24,38
119932,6,165,15,0,0,0,0,26,41
90080,9,325,4,0,0,0,0,5,9
159829,8,489,2,0,0,0,0,5,7
62907,6,269,3,0,0,0,0,4,7
66515,6,269,2,0,0,0,0,3,5
7686,7,800,2,0,0,0,0,3,5
143498,9,65,2,0,0,0,0,4,6
123061,9,151,2,0,0,0,0,7,9
86636,9,65,2,0,0,0,0,0,2
9322,9,819,11,0,0,0,0,20,31
145336,9,65,2,0,0,0,0,0,2
145153,10,355,4,0,0,0,0,4,8
101337,9,374,7,0,0,0,0,17,24
59949,10,178,9,0,0,0,0,16,25
112834,5,200,49,0,0,0,0,100,149
162741,5,58,18,0,0,0,0,26,44
20396,7,611,6,0,0,0,0,9,15
44848,7,295,2,0,0,0,0,3,5
73805,9,302,4,0,0,0,0,5,9
147990,10,903,2,0,0,0,0,8,10
57221,10,903,0,0,0,0,0,4,4
11340,9,489,1,0,0,0,0,2,3
145162,9,819,20,2,1,0,0,24,47
89251,8,489,20,0,0,0,0,26,46
110149,11,812,2,0,0,0,0,2,4
38335,4,752,2,0,0,0,0,2,4
149416,6,489,2,0,0,0,0,3,5
109137,11,489,4,0,0,0,0,3,7
103525,4,375,26,0,0,0,0,49,75
38930,7,842,8,0,0,0,0,17,25
26940,7,157,2,0,0,0,0,4,6
120815,10,322,2,0,0,0,0,4,6
20545,10,525,2,0,0,0,0,4,6
124350,5,181,458,31,7,2,6,920,1424
47767,11,214,2,0,0,0,0,4,6
4193,9,469,3,0,0,0,0,0,3
31410,10,466,22,2,1,0,0,160,185
5665,11,489,2,0,0,0,0,2,4
30710,8,623,44,0,0,0,0,65,109
72845,5,58,17,0,0,0,0,33,50
55085,9,65,2,0,0,0,0,3,5
84752,6,375,10,0,0,0,0,6,16
47027,9,158,0,1,1,0,0,0,2
80054,5,218,2,0,0,0,0,3,5
7833,5,455,2,0,0,0,0,3,5
19688,4,885,1,0,0,0,0,0,1
83278,9,314,10,0,0,0,0,18,28
119095,5,58,12,0,0,0,0,28,40
118333,7,306,1,1,0,0,0,2,4
9673,9,762,3,0,0,0,0,5,8
13142,6,141,22,0,0,0,0,41,63
70487,4,885,10,0,0,0,0,15,25
1470,11,214,8,0,0,0,0,10,18
91425,4,752,1,0,0,0,0,2,3
97638,9,483,2,0,0,0,0,3,5
53873,4,885,121,3,1,0,1,185,311
66013,11,403,1,0,0,0,0,0,1
117357,5,371,3,0,0,0,0,6,9
28762,5,225,31,1,0,0,0,75,107
9345,8,623,1,0,0,0,0,0,1
169099,6,235,11,0,0,0,0,20,31
60673,11,214,15,0,0,0,0,12,27
57216,8,800,2,0,0,0,0,6,8
12652,9,494,2,0,0,0,0,3,5
33770,5,667,19,2,1,0,0,36,58
74358,7,226,4,0,0,0,0,4,8
75970,11,214,1,0,0,0,0,0,1
138923,9,86,3,0,0,0,0,12,15
99598,9,487,14,0,0,0,0,29,43
46321,9,885,16,2,0,0,0,32,50
79009,8,214,88,4,1,1,1,163,258
79545,6,200,4,0,0,0,0,8,12
164568,9,487,20,1,1,0,0,36,58
163,9,570,2,0,0,0,0,3,5
101357,9,429,2,0,0,0,0,4,6
88685,8,623,239,0,0,0,0,477,716
119087,9,842,3,0,0,0,0,5,8
159791,8,489,3,0,0,0,0,0,3
7747,7,587,21,0,0,0,0,30,51
106871,5,408,2,0,0,0,0,4,6
138926,7,864,4,0,0,0,0,8,12
119963,4,36,12,0,0,0,0,10,22
50147,7,100,2,0,0,0,0,0,2
71912,5,58,19,0,0,0,0,39,58
81579,8,30,2,0,0,0,0,0,2
148458,6,141,10,0,0,0,0,18,28
80388,9,489,5,0,0,0,0,10,15
69717,7,484,22,3,0,0,0,72,97
68264,7,484,21,1,1,0,0,58,81
170877,9,773,9,0,0,0,0,13,22
116085,9,353,2,0,0,0,0,3,5
2210,7,896,1,0,0,0,0,2,3
22167,8,214,215,4,1,0,1,403,624
143484,10,66,2,0,0,0,0,4,6
124454,7,542,2,0,0,0,0,4,6
159076,7,896,1,0,0,0,0,2,3
28981,7,896,1,0,0,0,0,5,6
131968,5,181,9,1,1,0,0,14,25
117433,9,42,1,0,0,0,0,1,2
4325,9,367,4,0,0,0,0,0,4
49107,9,302,1,0,0,0,0,9,10
143260,10,63,2,0,0,0,0,4,6
137452,5,58,8,0,0,0,0,11,19
14586,9,85,4,0,0,0,0,8,12
126880,9,773,1,0,0,0,0,1,2
129027,5,58,26,0,0,0,0,56,82
152372,5,58,4,0,0,0,0,8,12
17857,9,842,13,0,0,0,0,31,44
152680,6,200,20,0,0,0,0,39,59
84450,9,46,2,0,0,0,0,3,5
94533,6,141,1,0,0,0,0,0,1
15869,6,141,1,0,0,0,0,0,1
124,6,141,1,0,0,0,0,0,1
158105,6,141,1,0,0,0,0,0,1
32364,6,141,3,0,0,0,0,4,7
58440,7,864,13,0,0,0,0,18,31
135721,9,85,2,0,0,0,0,3,5
50874,10,831,10,1,1,0,0,17,29
60859,7,864,3,0,0,0,0,14,17
99688,7,864,0,0,0,0,0,7,7
72376,11,214,4,0,0,0,0,8,12
157958,5,821,9,2,1,0,0,18,30
68217,5,78,3,0,0,0,0,1,4
50507,4,885,3,0,0,0,0,5,8
21607,4,885,2,0,0,0,0,3,5
159396,8,214,4,0,0,0,0,8,12
6839,10,81,1,0,0,0,0,0,1
137402,10,493,1,0,0,0,0,1,2
57282,10,392,0,1,0,0,0,0,1
56999,10,29,1,0,0,0,0,0,1
15787,10,917,12,0,0,0,0,19,31
24306,6,124,1,0,0,0,0,0,1
25225,9,483,2,0,0,0,0,5,7
37819,9,483,0,0,0,0,0,4,4
37522,9,483,0,0,0,0,0,7,7
60655,6,290,9,1,0,0,0,13,23
105384,10,807,4,0,0,0,0,9,13
73029,9,630,12,0,0,0,0,24,36
3641,9,658,2,0,0,0,0,4,6
80014,5,225,10,0,0,0,0,15,25
111643,11,214,8,0,0,0,0,9,17
30351,9,819,4,0,0,0,0,4,8
156244,9,842,2,0,0,0,0,4,6
92247,9,202,2,0,0,0,0,6,8
146701,7,306,6,0,0,0,0,8,14
12460,6,124,24,0,0,0,0,34,58
96476,11,623,3,0,0,0,0,5,8
47904,5,225,22,0,0,0,0,39,61
18968,9,175,2,0,0,0,0,4,6
3038,9,203,4,0,0,0,0,4,8
154607,5,58,2,0,0,0,0,4,6
166407,8,489,1,0,0,0,0,2,3
66403,9,6,2,0,0,0,0,6,8
103152,7,61,9,1,0,0,0,12,22
61588,10,628,1,0,0,0,0,10,11
166037,10,628,2,0,0,0,0,14,16
12806,5,885,1,0,0,0,0,1,2
77738,4,174,142,4,2,0,0,366,514
14471,7,611,2,0,0,0,0,3,5
58589,4,658,14,0,0,0,0,20,34
136626,10,466,6,0,0,0,0,12,18
63320,8,800,17,0,0,0,0,33,50
97213,9,8,3,0,0,0,0,7,10
63308,9,8,4,0,0,0,0,11,15
49425,4,174,31,0,0,0,0,73,104
133484,9,361,74,1,0,0,0,127,202
25843,7,484,10,0,0,0,0,27,37
164846,8,214,0,0,0,0,0,3,3
124746,8,800,11,0,0,0,0,23,34
18323,10,111,3,1,0,0,0,15,19
150839,8,489,1,0,0,0,0,0,1
57401,9,185,18,0,0,0,0,31,49
156511,9,243,2,0,0,0,0,4,6
148395,6,375,2,0,0,0,0,5,7
18951,5,667,9,0,0,0,0,14,23
111310,7,310,3,1,1,0,0,11,16
32592,9,246,6,0,0,0,0,8,14
47,7,310,1,0,0,0,0,3,4
45916,9,693,2,0,0,0,0,4,6
49790,9,497,2,0,0,0,0,5,7
25790,9,706,0,0,0,0,0,16,16
35089,10,66,2,0,0,0,0,3,5
56597,9,497,8,0,0,0,0,16,24
120466,10,63,2,0,0,0,0,3,5
50059,10,63,2,0,0,0,0,3,5
97908,9,497,16,0,0,0,0,30,46
36466,5,375,1,0,0,0,0,1,2
130580,5,489,10,0,0,0,1,18,29
106765,5,489,4,0,0,0,0,5,9
121602,4,174,3,0,0,0,0,0,3
157810,6,200,28,2,1,0,0,49,80
24611,6,200,10,0,0,0,0,14,24
170213,5,225,17,0,0,0,0,40,57
72396,7,570,4,0,0,0,0,6,10
168885,7,211,1,0,0,0,0,2,3
36328,9,315,8,0,0,0,0,15,23
94791,9,315,3,0,0,0,0,4,7
144867,11,214,8,0,0,0,0,12,20
30344,7,211,1,0,0,0,0,2,3
10368,11,214,2,0,0,0,0,2,4
77914,6,269,3,0,0,0,0,5,8
150709,8,623,5,0,0,0,0,3,8
101990,9,909,2,0,0,0,0,4,6
117250,9,819,12,0,0,0,0,22,34
41191,9,819,3,0,0,0,0,5,8
162196,9,107,2,0,0,0,0,7,9
2160,6,141,2,0,0,0,0,3,5
131949,7,611,2,0,0,0,0,6,8
25385,6,269,12,2,0,0,0,26,40
23207,4,375,10,0,0,0,0,16,26
161911,9,8,1,0,0,0,0,21,22
146724,7,484,2,0,0,0,0,6,8
115453,7,175,16,1,1,0,0,37,55
159278,8,214,7,0,0,0,0,8,15
129690,9,175,2,0,0,0,0,7,9
133015,9,570,2,0,0,0,0,4,6
96409,9,341,4,0,0,0,0,6,10
80251,10,555,2,0,0,0,0,3,5
46679,9,741,1,0,0,0,0,2,3
7884,5,667,6,1,1,0,0,10,18
170131,6,200,49,4,2,0,0,83,138
130839,6,235,9,0,0,0,0,15,24
99607,6,269,11,0,0,0,0,19,30
114621,10,911,1,0,0,0,0,2,3
64211,4,174,50,0,0,0,0,89,139
89446,5,58,4,0,0,0,0,9,13
105675,5,58,11,0,0,0,0,27,38
53059,8,214,2,0,0,0,0,4,6
63562,7,56,3,0,0,0,0,7,10
36785,7,669,1,0,0,0,0,1,2
1535,10,413,2,0,0,0,0,3,5
86626,9,46,2,0,0,0,0,3,5
151792,9,367,3,0,0,0,0,11,14
12586,9,819,2,0,0,0,0,6,8
154675,7,694,2,0,0,0,0,6,8
109523,6,141,6,0,0,0,0,12,18
7772,5,66,4,0,0,0,0,7,11
149288,10,555,2,0,0,0,0,5,7
137410,10,555,0,0,0,0,0,4,4
64652,10,555,2,0,0,0,0,4,6
68241,10,289,2,0,0,0,0,4,6
33810,9,89,2,0,0,0,0,4,6
147544,9,89,2,0,0,0,0,4,6
144601,9,538,1,0,0,0,0,0,1
53412,5,489,2,0,0,0,0,3,5
140306,10,628,2,0,0,0,0,3,5
152465,7,829,4,0,0,0,0,8,12
166193,9,538,41,3,2,0,0,61,107
140902,6,200,10,0,0,0,0,15,25
52884,5,821,1,0,0,0,0,1,2
41312,4,200,2,0,0,0,0,12,14
76703,9,313,1,0,0,0,0,2,3
212,9,361,8,0,0,0,0,16,24
135940,7,748,1,0,0,0,0,0,1
89312,9,100,5,1,0,0,0,9,15
16499,5,444,1,0,0,0,0,1,2
145555,7,521,1,0,0,0,0,0,1
85944,8,214,0,0,0,0,0,22,22
92107,4,453,1,0,0,0,0,1,2
91553,8,306,1,0,0,0,0,3,4
57918,10,111,1,0,0,0,0,1,2
109590,4,885,44,1,0,0,2,107,154
112298,9,657,3,0,0,0,0,4,7
167391,9,796,2,0,0,0,0,1,3
139413,9,796,1,0,0,0,0,0,1
148997,9,796,1,0,0,0,0,0,1
89644,9,796,1,0,0,0,1,0,2
13222,5,347,11,0,0,0,0,15,26
169818,9,796,2,0,0,0,0,0,2
3880,9,796,1,0,0,0,0,0,1
79034,9,796,1,0,0,0,0,0,1
8953,7,46,2,0,0,0,0,4,6
50890,7,489,1,0,0,0,0,1,2
71167,4,885,91,0,0,0,1,172,264
167858,10,200,6,0,0,0,0,8,14
164935,10,200,2,0,0,0,0,4,6
125024,4,159,1,0,0,0,0,0,1
54165,4,159,1,1,0,0,0,2,4
4175,4,885,153,3,0,0,1,296,453
92294,6,885,4,0,0,0,0,6,10
19692,9,630,5,0,0,0,0,3,8
91667,9,800,2,0,0,0,0,4,6
95014,9,510,1,0,0,0,0,0,1
143752,8,800,11,0,0,0,0,23,34
55130,9,575,8,1,0,1,0,20,30
145418,9,570,1,0,0,0,0,1,2
46554,9,773,1,0,0,0,0,0,1
74877,9,630,90,3,0,0,0,116,209
2775,7,484,1,0,0,0,0,3,4
98912,7,484,1,0,0,0,0,0,1
153531,8,214,593,0,0,0,1,1048,1642
71511,4,885,34,0,0,0,0,91,125
155071,9,429,4,0,0,0,0,10,14
83020,8,545,1,0,0,0,0,0,1
136747,8,30,1,0,0,0,0,0,1
142493,8,403,2,0,0,0,0,6,8
4454,11,489,1,0,0,0,0,0,1
125849,11,214,1,0,0,0,0,0,1
127890,9,819,3,0,0,0,0,5,8
136620,9,842,8,0,0,0,0,14,22
145625,9,353,1,0,0,0,0,0,1
101405,9,658,1,0,0,0,0,1,2
99383,4,638,3,0,0,0,0,12,15
70383,8,885,1,0,0,0,0,3,4
124768,11,214,2,0,0,0,0,4,6
3899,10,200,1,0,0,0,0,2,3
112805,7,117,2,0,0,0,0,4,6
127962,7,117,2,0,0,0,0,4,6
145435,9,658,2,0,0,0,0,4,6
73756,8,214,42,0,0,0,1,67,110
84162,5,78,3,0,0,0,0,3,6
31443,11,214,6,0,0,0,0,6,12
32569,5,225,7,0,0,0,0,12,19
132334,5,225,11,0,0,0,0,22,33
85087,9,367,1,0,0,0,0,0,1
34534,9,452,1,0,0,0,0,1,2
48277,9,379,17,0,0,0,0,36,53
26076,9,429,1,0,0,0,0,2,3
51715,9,429,1,0,0,0,0,1,2
149146,8,211,13,0,0,0,0,19,32
92670,7,829,5,0,0,0,0,12,17
25246,7,829,1,0,0,0,0,1,2
84870,7,226,1,0,0,0,0,0,1
130115,7,78,8,2,0,0,0,14,24
57058,8,214,1,0,0,0,0,0,1
34649,6,306,25,0,0,0,0,50,75
156222,9,243,2,0,0,0,0,2,4
117329,9,575,2,0,0,0,0,0,2
131690,9,693,0,0,0,0,0,11,11
13826,10,831,5,0,0,0,0,10,15
129276,10,831,3,0,0,0,0,7,10
142038,9,741,1,0,0,0,0,0,1
47573,10,831,1,0,0,0,0,6,7
47751,10,831,1,0,0,0,0,0,1
84274,10,831,3,0,0,0,0,4,7
105644,10,831,3,0,0,0,0,4,7
99797,10,289,1,0,0,0,0,1,2
111652,9,483,2,0,0,0,0,3,5
111174,9,175,2,0,0,0,0,2,4
56745,5,306,1,0,0,0,0,1,2
37611,5,58,3,0,0,0,0,9,12
110084,5,58,4,0,0,0,0,11,15
90228,7,587,10,0,0,0,0,16,26
52694,5,800,4,0,0,0,0,2,6
152150,9,800,2,0,0,0,0,4,6
35986,9,842,6,1,0,0,0,6,13
29626,6,269,18,0,0,0,0,35,53
158616,9,497,2,0,0,0,0,3,5
55245,7,489,1,0,0,0,0,0,1
158721,9,497,2,0,0,0,0,5,7
11697,4,658,1,0,0,0,0,1,2
103261,4,453,2,0,0,0,0,3,5
145675,4,885,22,0,0,0,0,41,63
46803,9,575,16,0,0,0,0,35,51
152012,10,111,12,1,0,0,1,22,36
23785,7,535,12,1,0,0,0,27,40
31902,7,492,2,0,0,0,0,3,5
2782,10,111,2,0,0,0,0,3,5
131552,4,885,46,2,0,0,0,95,143
129610,8,214,1,0,0,0,0,0,1
34658,9,706,0,0,0,0,0,3,3
102245,8,489,2,0,0,0,0,3,5
140877,9,575,10,0,0,0,0,13,23
97803,9,575,17,1,0,0,0,30,48
43110,6,232,109,2,0,0,1,160,272
32831,6,489,17,0,0,0,0,27,44
84915,9,575,28,2,0,0,1,42,73
62424,4,200,1,0,0,0,0,1,2
170906,6,200,7,0,0,0,0,13,20
18565,10,66,0,0,0,0,0,4,4
33345,11,214,1,0,0,0,0,0,1
8882,7,74,2,0,0,0,0,3,5
156287,11,214,2,0,0,0,0,3,5
107676,7,492,4,0,0,0,0,8,12
43179,7,645,1,0,0,0,0,1,2
37543,9,575,6,0,0,0,0,12,18
131778,5,306,24,1,1,0,0,38,64
56096,5,181,44,1,0,0,0,31,76
155029,7,492,4,0,0,0,0,3,7
52944,9,66,3,0,0,0,0,8,11
132508,9,302,2,0,0,0,0,0,2
17662,9,313,2,0,0,0,0,4,6
97430,7,163,1,0,0,0,0,0,1
28342,5,306,13,0,0,0,0,19,32
130995,6,290,14,0,0,0,0,14,28
100835,10,66,14,0,0,0,0,8,22
75413,8,214,2,0,0,0,0,4,6
149160,7,669,2,0,0,0,0,3,5
114077,9,640,2,0,0,0,0,4,6
96353,7,100,3,0,0,0,0,6,9
139885,5,667,1,0,0,0,0,1,2
160008,9,575,6,0,0,0,0,13,19
117624,6,200,8,0,0,0,0,14,22
90292,7,196,4,0,0,0,0,7,11
19332,6,232,21,1,1,0,0,46,69
162987,5,4,1,0,0,0,0,2,3
161205,10,831,4,1,0,0,0,5,10
110102,5,561,1,0,0,0,0,0,1
96860,7,587,19,0,0,0,0,31,50
29148,9,86,2,0,0,0,0,9,11
65889,5,667,10,0,0,0,0,19,29
76188,6,124,28,1,0,0,0,57,86
80812,9,367,1,0,0,0,0,0,1
68277,8,693,1,0,0,0,0,0,1
22469,4,891,6900,277,72,37,41,13537,20864
18562,10,413,2,0,0,0,0,3,5
112169,5,232,12,4,0,1,0,18,35
5418,5,181,63,9,1,0,0,129,202
22702,9,842,3,0,0,0,0,5,8
104196,9,185,4,0,0,0,0,6,10
96341,9,185,6,0,0,0,0,11,17
8846,8,800,3,0,0,0,0,2,5
56297,11,489,1,0,0,0,0,0,1
1142,6,232,27,0,0,0,0,61,88
26150,6,232,8,0,0,0,0,9,17
159306,6,545,7,0,0,0,0,10,17
96443,7,56,2,0,0,0,0,4,6
113148,9,374,24,0,0,0,0,44,68
106715,9,630,1,0,0,0,0,2,3
25847,9,95,2,0,0,0,0,4,6
143380,9,95,1,0,0,0,0,3,4
141123,4,800,2,0,0,0,0,3,5
105331,7,100,1,0,0,0,0,2,3
13946,10,493,1,0,0,0,0,1,2
24624,4,679,2,0,0,0,0,4,6
104393,5,667,2,0,0,0,0,2,4
73938,9,800,2,0,0,0,0,6,8
4824,7,630,12,0,0,0,0,47,59
78378,9,560,6,0,0,0,0,9,15
77211,9,46,4,0,0,0,0,9,13
6559,9,46,2,0,0,0,0,3,5
123296,5,545,16,1,0,0,0,32,49
48108,9,630,29,0,0,0,0,56,85
22892,4,679,6,0,0,0,0,6,12
16183,10,798,4,0,0,0,0,7,11
38875,10,798,0,0,0,0,0,4,4
82553,10,159,1,0,0,0,0,1,2
15682,7,829,1,0,0,0,0,3,4
94471,7,694,2,0,0,0,0,4,6
74455,6,785,1,0,0,0,0,1,2
7472,9,607,2,0,0,0,0,3,5
59646,7,829,1,0,0,0,0,1,2
41691,7,175,1,1,1,0,0,0,3
48958,9,842,2,0,0,0,0,4,6
86376,7,829,2,0,0,0,0,3,5
105688,8,306,1,0,0,0,0,0,1
148148,8,800,9,2,1,0,0,14,26
80332,7,202,4,0,0,0,0,8,12
3578,7,587,0,0,0,0,0,8,8
112749,10,799,6,0,0,0,0,10,16
93663,7,175,0,0,0,0,0,8,8
126447,9,117,13,0,0,0,0,17,30
102869,9,380,1,0,0,0,0,0,1
12847,7,175,6,0,0,0,0,15,21
50400,7,175,8,0,0,0,0,20,28
36026,6,585,6,0,0,0,0,9,15
43536,6,232,4,0,0,0,0,5,9
50201,6,643,24,0,0,0,1,85,110
164858,4,159,2,0,0,0,0,2,4
20983,9,640,411,0,0,0,3,846,1260
89657,8,800,66,5,1,0,0,172,244
150232,7,117,4,0,0,0,0,7,11
80969,9,535,6,1,1,0,0,10,18
16560,7,484,1,0,0,0,0,2,3
108915,11,545,0,2,0,0,0,0,2
145261,4,885,1,0,0,0,0,2,3
114633,7,489,1,0,0,0,0,0,1
169197,8,800,53,2,0,0,0,249,304
22022,10,66,2,0,0,0,0,6,8
3061,10,66,0,0,0,0,0,4,4
105118,10,66,28,1,1,0,0,66,96
106033,10,66,0,0,0,0,0,4,4
121236,4,388,1,0,0,0,0,0,1
86798,10,66,2,0,0,0,0,6,8
39204,9,532,2,0,0,0,0,19,21
74850,9,532,2,0,0,0,0,3,5
104265,9,532,2,0,0,0,0,3,5
113823,9,532,6,0,0,0,0,24,30
4820,10,628,4,0,0,0,0,4,8
45153,6,290,2,0,0,0,0,4,6
120926,5,489,7,2,0,0,0,12,21
34000,9,630,1,0,0,0,0,0,1
62217,10,66,2,0,0,0,0,3,5
52403,10,159,1,0,0,0,0,1,2
36098,9,819,1,0,0,0,0,1,2
34361,9,8,10,0,0,0,0,15,25
107449,7,379,2,0,0,0,0,6,8
113130,5,78,1,0,0,0,0,1,2
169294,7,773,6,0,0,0,0,10,16
87665,6,489,29,0,0,0,0,54,83
54452,9,374,3,0,0,0,0,5,8
40255,9,374,3,0,0,0,0,9,12
159367,9,374,7,0,0,0,0,6,13
117758,4,800,1,0,0,0,0,0,1
64730,6,489,62,0,0,0,2,105,169
152975,9,538,10,0,0,0,0,15,25
125600,6,200,13,0,0,0,1,25,39
123222,8,800,8,0,0,0,0,16,24
3165,9,762,1,0,0,0,0,1,2
48682,9,452,2,0,0,0,0,3,5
41914,9,100,2,0,0,0,0,3,5
110483,9,800,1,0,0,0,0,0,1
8449,9,800,2,1,1,0,0,2,6
8799,9,800,1,0,0,0,0,1,2
118814,9,538,43,1,1,0,0,80,125
170905,9,538,22,3,3,0,0,36,64
46485,11,623,6,0,0,0,0,6,12
93404,8,800,48,3,1,0,0,97,149
8794,10,903,10,1,1,0,0,10,22
158018,6,200,34,0,0,0,1,65,100
60285,6,200,43,1,1,0,1,96,142
72050,8,214,10,0,0,0,0,16,26
115490,9,575,4,0,0,0,0,4,8
47754,5,232,5,0,0,0,0,10,15
121578,4,200,1,0,0,0,0,0,1
25176,8,800,34,6,1,1,0,127,169
10287,6,269,6,0,0,0,0,10,16
107371,9,819,4,0,0,0,0,8,12
116056,10,87,2,0,0,0,0,3,5
27824,6,489,17,0,0,0,0,38,55
68365,9,489,6,0,0,0,0,8,14
15073,7,448,142,4,2,1,0,211,360
137440,9,158,6,3,0,0,1,68,78
116189,6,235,12,2,0,0,1,18,33
167195,4,453,13,0,0,0,0,25,38
57721,11,489,2,0,0,0,0,2,4
67652,6,124,12,0,0,0,0,19,31
15210,10,413,2,0,0,0,0,4,6
144421,5,232,83,1,3,0,0,139,226
45349,10,917,0,1,1,0,0,15,17
12108,10,917,0,0,0,0,0,5,5
140286,10,903,0,0,0,0,0,4,4
94767,9,630,17,0,0,0,0,24,41
44757,10,798,4,0,0,0,0,8,12
111475,9,65,4,0,0,0,0,0,4
35221,9,65,2,0,0,0,0,0,2
82532,9,560,2,0,0,0,0,4,6
96333,7,885,1,0,0,0,0,1,2
82126,9,158,1,0,0,0,0,2,3
10726,9,158,1,0,0,0,0,2,3
71204,9,158,1,0,0,0,0,1,2
30941,5,124,27,1,0,0,0,38,66
41121,4,453,1,0,0,0,0,1,2
109851,5,76,16,0,0,0,0,32,48
137447,9,684,1,0,0,0,0,1,2
25747,10,111,8,0,0,0,1,13,22
5856,9,483,1,0,0,0,0,1,2
42537,9,483,4,0,0,0,0,18,22
102071,9,353,1,0,0,0,0,2,3
98857,8,214,4,0,0,0,0,3,7
115187,10,798,2,0,0,0,0,3,5
35426,9,828,5,0,0,0,0,7,12
123214,9,302,89,0,0,0,4,230,323
118280,4,375,1,0,0,0,0,10,11
68704,8,489,1,0,0,0,0,2,3
132959,9,353,1,0,0,0,0,1,2
19322,9,838,2,0,0,0,0,4,6
35326,4,800,144,0,0,0,1,270,415
146898,5,667,3,0,0,0,0,5,8
98496,10,917,1,0,0,0,0,0,1
141158,10,917,1,0,0,0,0,0,1
40719,10,781,12,1,0,0,0,20,33
50329,4,174,25,1,1,0,0,37,64
72176,6,78,1,0,0,0,0,0,1
31436,11,306,1,0,0,0,0,0,1
66185,5,124,4,0,0,0,0,13,17
65853,7,587,5,0,0,0,0,8,13
44396,9,570,2,0,0,0,0,3,5
64229,8,545,102,3,2,0,0,168,275
83660,9,314,1,0,0,0,0,4,5
153263,4,159,1,0,0,0,0,2,3
70911,9,314,1,0,0,0,0,2,3
74884,7,367,2,0,0,0,0,7,9
45816,9,630,1,0,0,0,0,3,4
3222,10,111,2,0,0,0,0,4,6
140186,10,903,5,0,0,0,0,8,13
143112,6,290,1,0,0,0,0,0,1
82866,4,800,45,1,0,0,1,99,146
52855,5,200,2,0,0,0,0,0,2
151117,6,514,3,0,0,0,0,5,8
79290,9,842,13,0,0,0,0,16,29
44088,9,800,1,0,0,0,0,2,3
87555,9,65,1,0,0,0,0,2,3
98227,7,741,6,0,0,0,0,20,26
279,9,484,1,0,0,0,0,2,3
45367,9,842,2,0,0,0,0,2,4
159073,10,903,11,0,0,0,0,36,47
116804,10,903,1,0,0,0,0,2,3
136629,10,903,2,0,0,0,0,4,6
163474,7,892,2,0,0,0,0,3,5
49431,11,489,2,0,0,0,0,2,4
116092,7,800,2,0,0,0,0,3,5
8066,7,800,6,0,0,0,0,12,18
58016,7,645,2,0,0,0,0,3,5
74318,7,645,2,0,0,0,0,3,5
168269,10,799,2,0,0,0,0,6,8
101999,8,214,1,0,0,0,0,2,3
71369,9,246,1,0,0,0,0,1,2
80312,10,66,0,0,0,0,0,10,10
119509,10,66,0,0,0,0,0,5,5
87353,5,667,3,0,0,0,0,3,6
30640,9,489,10,0,0,0,0,15,25
20283,6,667,18,0,0,0,0,31,49
133027,5,124,10,0,0,0,0,24,34
73135,5,667,5,0,0,0,0,5,10
53210,9,405,1,0,0,0,0,0,1
162369,9,380,1,0,0,0,0,0,1
53530,10,797,2,0,0,0,0,3,5
132492,4,679,5,0,0,0,0,8,13
63494,4,679,1,0,0,0,0,1,2
50240,9,560,1,0,0,0,0,0,1
76710,4,679,3,0,0,0,0,7,10
129548,9,684,2,0,0,0,0,3,5
62414,9,684,4,0,0,0,0,5,9
57581,8,545,87,4,0,0,2,158,251
120035,9,380,1,0,0,0,0,1,2
19849,7,100,4,0,0,0,0,12,16
142132,7,100,0,0,0,0,0,3,3
43742,10,111,1,0,0,0,0,2,3
85169,9,100,2,0,0,0,0,4,6
152235,9,487,2,0,0,0,0,6,8
110066,6,269,9,0,0,0,0,18,27
81274,7,741,31,1,1,0,0,44,77
169114,9,630,6,0,0,0,0,13,19
116163,9,640,5,0,0,0,0,10,15
31184,10,917,6,0,0,0,0,18,24
7577,5,78,37,0,0,0,0,64,101
48022,9,89,1,0,0,0,0,0,1
37763,9,429,2,0,0,0,0,4,6
82236,10,790,4,0,0,0,0,7,11
109473,9,873,4,0,0,0,0,5,9
102206,5,124,2,0,0,0,0,3,5
35658,6,585,16,0,0,0,0,38,54
73301,7,61,2,0,0,0,0,4,6
53832,5,479,2,0,0,0,0,2,4
168054,10,682,2,0,0,0,0,6,8
7706,4,461,1,0,0,0,0,10,11
134280,7,741,1,0,0,0,0,0,1
41500,5,159,1,0,0,0,0,0,1
144425,4,200,1,0,0,0,0,0,1
111988,9,741,1,0,0,0,0,0,1
109891,10,917,2,0,0,0,0,15,17
95724,8,800,1,0,0,0,0,0,1
72628,7,61,10,0,0,0,0,9,19
62581,7,521,3,0,0,0,0,4,7
34932,9,302,1,0,0,0,0,2,3
40766,11,545,60,8,0,0,0,51,119
167374,5,58,5,0,0,0,0,10,15
1117,7,100,51,1,1,0,0,116,169
8133,8,211,2,0,0,0,0,1,3
68321,10,66,7,0,0,0,0,23,30
119794,5,181,12,2,1,0,0,18,33
125511,8,214,0,0,0,0,0,3,3
152151,7,100,1,0,0,0,0,1,2
135139,7,484,1,0,0,0,0,5,6
163352,10,413,1,0,0,0,0,0,1
17343,10,322,1,0,0,0,0,0,1
73426,10,917,2,0,0,0,0,9,11
105290,10,66,2,0,0,0,0,4,6
31096,9,630,8,0,0,0,0,33,41
161455,9,630,10,0,0,0,0,19,29
29768,9,630,3,0,0,0,0,8,11
132787,9,630,32,2,0,0,0,68,102
137062,9,630,6,0,0,0,0,9,15
103723,9,630,2,0,0,0,0,7,9
78755,9,819,2,0,0,0,0,4,6
101204,11,545,2,0,0,0,0,3,5
107685,9,374,3,0,0,0,0,3,6
93241,9,374,6,0,0,0,0,10,16
107657,7,74,8,0,0,0,0,12,20
1912,7,74,2,0,0,0,0,4,6
163187,5,232,2,0,0,0,0,5,7
149117,7,148,1,0,0,0,0,2,3
151218,7,148,1,0,0,0,0,2,3
28205,5,225,2,0,0,0,0,7,9
144517,7,373,2,0,0,0,0,4,6
121885,6,269,8,0,0,0,0,15,23
10746,4,679,6,0,0,0,0,11,17
55862,6,235,2,0,0,0,0,3,5
143511,9,314,2,0,0,0,0,4,6
90123,7,472,1,0,0,0,0,1,2
49670,7,157,1,0,0,0,0,1,2
34076,7,508,2,0,0,0,0,6,8
21727,11,623,2,0,0,0,0,1,3
15025,5,200,14,0,0,0,0,26,40
100532,11,885,0,1,0,0,0,0,1
89664,8,885,0,1,0,0,0,0,1
145014,8,214,30,0,0,0,0,37,67
133530,8,214,48,0,0,0,0,90,138
144793,9,538,1,0,0,0,0,7,8
165242,8,545,1,0,0,0,0,1,2
139856,6,489,276,0,0,0,2,527,805
146801,9,100,21,0,0,0,0,20,41
3424,10,903,1,0,0,0,0,2,3
115632,8,800,15,0,0,0,0,27,42
105133,9,640,22,0,0,0,1,40,63
45822,7,56,1,0,0,0,0,0,1
166575,8,214,32,2,1,0,1,51,87
61971,4,159,2,0,0,0,0,2,4
23448,11,214,2,0,0,0,0,2,4
124159,8,306,1,0,0,0,0,0,1
160237,4,800,27,0,0,0,0,57,84
121316,8,800,1,0,0,0,0,0,1
70366,5,821,5,0,0,0,0,12,17
23737,9,535,2,0,0,0,0,3,5
129417,10,807,2,0,0,0,0,8,10
96639,11,214,1,0,0,0,0,1,2
94208,8,623,1,0,0,0,0,0,1
147217,11,214,3,0,0,0,0,1,4
116018,8,800,12,1,0,0,1,23,37
30836,9,538,1,0,0,0,0,2,3
137156,4,658,2,0,0,0,0,3,5
92750,10,917,6,0,0,0,0,13,19
145073,10,917,4,1,0,0,0,8,13
104453,6,489,79,0,0,0,2,149,230
93902,9,487,4,0,0,0,0,10,14
86311,9,487,2,0,0,0,0,3,5
95089,8,489,1,0,0,0,0,0,1
49349,5,381,1,0,0,0,0,1,2
54186,7,484,7,2,1,1,0,25,36
69408,4,800,2,0,0,0,0,3,5
54940,6,209,2,0,0,0,0,3,5
46856,9,489,3,0,0,0,0,8,11
11388,10,722,1,0,0,0,0,3,4
128504,4,519,86,0,0,0,0,155,241
21710,4,519,70,0,0,0,0,142,212
22125,9,8,4,0,0,0,0,5,9
35848,4,375,201,0,0,0,1,360,562
75845,4,519,473,20,17,0,3,1254,1767
14481,4,519,514,19,20,2,0,1434,1989
156479,8,545,54,4,0,0,1,93,152
136210,6,235,1,0,0,0,0,1,2
99525,9,640,4,0,0,0,0,11,15
135373,4,519,153,6,1,0,0,326,486
97965,7,587,4,0,0,0,0,6,10
29499,4,752,3,0,0,0,0,8,11
152580,4,752,2,0,0,0,0,4,6
603,10,172,4,0,0,0,0,5,9
27673,4,519,27,1,1,0,0,66,95
34345,5,232,2,0,0,0,0,4,6
4881,7,56,7,0,0,0,0,17,24
58539,4,306,251,0,0,0,4,615,870
153446,10,66,4,0,0,0,0,5,9
117102,10,917,4,0,0,0,0,18,22
76618,9,483,2,0,0,0,0,6,8
79741,9,483,6,0,0,0,0,7,13
151236,4,519,557,15,15,0,0,1374,1961
144938,9,175,1,0,0,0,0,2,3
105010,11,124,2,0,0,0,0,0,2
111110,9,202,1,0,0,0,0,1,2
81731,9,202,1,0,0,0,0,1,2
127564,9,202,2,0,0,0,0,3,5
129624,9,640,34,3,0,1,0,55,93
58592,4,519,2,0,0,0,0,3,5
5273,7,61,2,0,0,0,0,4,6
97539,7,367,111,0,0,0,0,138,249
51583,7,367,5,0,0,0,0,9,14
27334,7,367,4,0,0,0,0,9,13
103750,10,208,0,0,0,0,0,4,4
15220,10,208,0,0,0,0,0,4,4
168669,9,100,11,0,0,0,0,29,40
73520,6,885,53,0,0,0,0,118,171
123333,4,188,2,0,0,0,0,4,6
154758,9,632,2,0,0,0,0,6,8
112567,9,100,21,0,0,0,0,49,70
113511,11,214,0,2,0,0,0,0,2
10627,10,603,4,0,0,0,0,16,20
90547,10,322,2,0,0,0,0,5,7
128366,9,575,2,0,0,0,0,3,5
22511,9,302,2,0,0,0,0,4,6
43900,9,185,4,0,0,0,0,10,14
127588,9,185,6,0,0,0,0,5,11
63932,11,244,3,0,0,0,0,1,4
87356,8,214,345,0,0,0,1,654,1000
53316,7,587,1,0,0,0,0,2,3
13823,5,667,2,0,0,0,0,3,5
112534,9,538,5,0,0,0,0,3,8
94706,10,87,4,0,0,0,0,4,8
138244,10,87,2,0,0,0,0,4,6
135679,10,743,2,0,0,0,0,5,7
87003,10,743,2,0,0,0,0,5,7
165717,7,492,2,0,0,0,0,4,6
46740,6,131,31,1,1,0,0,72,105
81171,4,519,252,11,2,0,1,731,997
31119,10,87,2,0,0,0,0,3,5
66281,10,87,2,0,0,0,0,5,7
90500,9,302,12,0,0,0,0,28,40
105549,5,159,1,0,0,0,0,2,3
32533,4,800,51,1,0,0,0,96,148
65652,7,589,7,0,0,0,0,18,25
84895,9,302,10,0,0,0,0,20,30
81729,9,909,2,0,0,0,0,4,6
119255,9,85,2,0,0,0,0,4,6
141783,5,118,6,0,0,0,0,13,19
139498,11,306,6,0,0,0,0,5,11
104267,8,214,1,0,0,0,0,1,2
72721,10,798,1,0,0,0,0,3,4
22136,10,798,1,0,0,0,0,2,3
8456,8,214,9,0,0,0,0,12,21
128435,9,538,10,0,0,0,0,11,21
145271,9,538,6,0,0,0,0,4,10
154200,6,58,6,0,0,0,0,10,16
30213,9,622,4,0,0,0,0,11,15
111452,9,538,4,0,0,0,1,17,22
77132,9,912,4,0,0,0,0,6,10
58309,9,538,2,0,0,0,0,4,6
67393,9,483,3,1,1,0,0,6,11
162165,10,798,6,0,0,0,0,13,19
113693,10,322,2,0,0,0,0,6,8
31566,11,812,2,0,0,0,0,2,4
15067,8,489,2,0,0,0,0,4,6
67774,7,489,6,2,0,0,0,7,15
54988,9,315,4,0,0,0,0,6,10
106749,9,315,1,0,0,0,0,4,5
81885,5,58,2,0,0,0,0,6,8
3194,9,399,5,0,0,0,0,11,16
88266,6,200,25,1,1,0,1,50,78
37039,6,885,42,2,0,0,0,96,140
137049,6,141,2,0,0,0,0,4,6
70569,5,131,4,0,0,0,0,5,9
129394,9,842,3,0,0,0,0,9,12
6258,8,545,46,3,0,0,2,92,143
82882,7,489,7,1,0,0,0,12,20
3649,8,214,3,0,0,0,0,0,3
37371,4,159,10,0,0,0,0,23,33
23961,11,375,1,0,0,0,0,0,1
97065,11,800,1,0,0,0,0,0,1
58565,8,214,64,0,0,0,0,113,177
144597,10,903,1,0,0,0,0,1,2
157281,10,903,2,0,0,0,0,4,6
101706,10,903,1,0,0,0,0,1,2
50332,4,36,9,0,0,0,0,23,32
32301,10,111,15,0,0,0,0,21,36
51885,8,693,2,0,0,0,0,2,4
72301,9,575,4,0,0,0,0,4,8
147789,6,800,4,0,0,0,0,8,12
10855,5,489,8,0,0,0,0,15,23
95811,10,466,2,0,0,0,0,3,5
127503,9,6,1,0,0,0,0,0,1
96435,8,489,2,0,0,0,0,0,2
95502,9,457,1,0,0,0,0,0,1
119345,9,313,2,0,0,0,0,4,6
128979,8,214,112,4,0,0,0,230,346
36547,9,399,3,0,0,0,0,10,13
100310,8,214,126,1,0,0,1,266,394
92560,9,157,1,0,0,0,0,1,2
136914,11,214,2,0,0,0,0,2,4
90437,9,367,1,0,0,0,0,3,4
97697,6,131,6,0,0,0,0,13,19
154906,11,489,2,0,0,0,0,1,3
37453,5,76,7,0,0,0,0,10,17
112101,8,214,2,0,0,0,0,3,5
132758,9,570,4,0,0,0,0,10,14
67784,11,812,2,0,0,0,0,3,5
75026,9,630,0,0,0,0,0,12,12
53061,9,538,3,0,0,0,0,6,9
5974,7,694,2,0,0,0,0,4,6
151556,11,489,4,0,0,0,0,3,7
78550,7,61,1,0,0,0,0,0,1
126205,7,484,2,0,0,0,0,3,5
170926,9,185,1,0,0,0,0,2,3
163049,7,563,4,0,0,0,0,4,8
154522,6,124,19,0,0,0,0,38,57
162956,4,679,4,0,0,0,0,14,18
76752,4,679,2,0,0,0,0,4,6
92205,6,489,1,0,0,0,0,0,1
16839,8,214,506,29,3,0,1,918,1457
76661,10,628,1,0,0,0,0,1,2
130478,7,61,14,1,0,0,1,28,44
118175,6,885,29,0,0,0,1,38,68
48330,9,640,21,2,1,0,0,40,64
27970,7,694,6,0,0,0,0,6,12
6642,9,842,2,0,0,0,0,4,6
82622,7,805,1,0,0,0,0,3,4
164241,7,805,1,0,0,0,0,2,3
135439,7,748,4,0,0,0,0,7,11
116141,11,214,4,0,0,0,0,1,5
131372,4,885,0,1,0,0,0,0,1
47933,9,629,1,0,0,0,0,4,5
79442,9,315,2,0,0,0,0,0,2
44798,6,785,4,0,0,0,0,12,16
12694,7,587,6,0,0,0,0,6,12
76409,10,917,2,0,0,0,0,3,5
93816,5,821,1,0,0,0,0,0,1
7410,4,885,1,0,0,0,0,0,1
71419,9,46,1,0,0,0,0,2,3
27573,9,46,1,0,0,0,0,2,3
154692,7,484,8,0,0,0,0,14,22
111998,9,483,1,0,0,0,0,0,1
143420,4,200,1,0,0,0,0,0,1
28955,4,200,49,0,0,0,0,87,136
123695,4,36,7,0,0,0,0,13,20
115893,9,873,1,0,0,0,0,1,2
73492,11,214,2,0,0,0,0,2,4
30252,7,611,2,0,0,0,0,3,5
37659,8,214,330,1,1,0,3,617,952
133223,7,484,1,0,0,0,0,2,3
86471,7,484,4,0,0,0,0,3,7
61660,9,532,8,0,0,0,0,17,25
8326,9,532,0,0,0,0,0,4,4
728,9,575,28,1,1,0,0,44,74
94887,9,314,4,0,0,0,0,4,8
21959,8,800,9,0,0,0,0,17,26
93029,11,214,6,0,0,0,0,9,15
12575,10,722,12,0,0,0,0,30,42
68699,10,682,1,0,0,0,0,2,3
152877,10,799,2,0,0,0,0,2,4
73974,4,592,6,0,0,0,0,10,16
43542,5,124,2,0,0,0,0,3,5
12594,10,413,2,0,0,0,0,3,5
25501,9,622,2,0,0,0,0,0,2
123004,9,175,16,0,0,0,0,30,46
63897,6,235,2,0,0,0,0,5,7
88805,9,175,6,0,0,0,0,14,20
29059,9,489,6,0,0,0,0,9,15
144430,9,456,4,0,0,0,0,3,7
63226,6,545,8,3,1,0,0,4,16
44796,5,800,1,0,0,0,0,0,1
126573,10,111,1,0,0,0,0,1,2
103201,6,537,6,0,0,0,0,11,17
145508,6,800,6,0,0,0,0,14,20
131665,6,667,6,0,0,0,0,9,15
76891,11,812,1,0,0,0,0,1,2
160336,4,300,6,0,0,0,0,3,9
73347,8,214,150,0,0,0,0,261,411
21877,10,111,6,0,0,0,0,14,20
52028,10,29,2,0,0,0,0,6,8
116209,9,560,20,2,1,1,0,28,52
168225,9,175,4,0,0,0,0,6,10
30814,4,137,3,0,0,0,0,5,8
125350,7,306,1,0,0,0,0,0,1
52496,5,200,4,0,0,0,0,6,10
33020,9,184,2,0,0,0,0,2,4
7823,10,918,2,0,0,0,0,4,6
54143,10,918,2,0,0,0,0,4,6
4137,9,374,94,4,0,2,0,144,244
157485,5,347,2,0,0,0,0,4,6
72346,10,256,2,0,0,0,0,4,6
125200,5,693,4,0,0,0,0,6,10
83729,10,29,2,0,0,0,0,4,6
148218,4,199,2,0,0,0,0,3,5
52389,5,76,4,0,0,0,0,6,10
120238,7,126,4,0,0,0,0,5,9
3744,9,78,2,0,0,0,0,4,6
71902,5,76,4,0,0,0,0,6,10
162712,7,601,11,0,0,0,0,14,25
28637,7,601,9,0,0,0,0,18,27
93583,9,100,2,0,0,0,0,8,10
114095,9,100,7,0,0,0,0,23,30
109000,9,560,1,0,0,0,0,1,2
20737,11,403,5,0,0,0,0,4,9
58541,9,912,4,0,0,0,0,5,9
126792,9,456,2,0,0,0,0,3,5
111980,5,58,2,0,0,0,0,3,5
61458,9,489,4,0,0,0,0,0,4
64868,9,640,24,1,0,0,0,40,65
104953,10,357,2,0,0,0,0,10,12
79193,5,489,2,0,0,0,0,4,6
132746,4,159,2,0,0,0,0,5,7
98172,5,238,1,0,0,0,0,1,2
63278,7,896,18,3,3,0,0,23,47
44909,9,575,2,0,0,0,0,5,7
4185,9,374,9,0,0,0,0,18,27
70756,7,521,4,0,0,0,0,6,10
79254,4,200,1,0,0,0,0,1,2
113350,11,545,5,0,0,0,0,10,15
104554,4,800,2,0,0,0,0,0,2
116011,8,214,16,0,0,0,0,35,51
158091,7,157,1,0,0,0,0,0,1
39278,9,399,2,0,0,0,0,0,2
159067,7,56,3,0,0,0,0,7,10
12358,9,4,6,0,0,0,0,13,19
4023,9,483,2,0,0,0,0,4,6
30928,9,483,2,0,0,0,0,5,7
85250,5,489,6,0,0,0,0,11,17
77392,8,545,6,2,0,0,0,3,11
1660,7,805,2,0,0,0,0,4,6
113466,10,29,2,0,0,0,0,2,4
67806,5,347,2,0,0,0,0,8,10
130902,7,489,8,0,0,0,0,10,18
148016,9,842,1,0,0,0,0,0,1
150509,7,472,2,0,0,0,0,3,5
162875,9,819,2,0,0,0,0,4,6
82939,7,896,2,0,0,0,0,4,6
157240,7,448,0,0,0,0,0,8,8
95586,11,124,2,0,0,0,0,2,4
38722,9,489,4,0,0,0,0,6,10
92933,6,51,271,10,2,3,0,443,729
104989,9,630,1,0,0,0,0,0,1
29627,9,100,0,0,0,0,0,8,8
81067,9,100,10,0,0,0,0,12,22
88514,9,456,4,0,0,0,0,8,12
46151,9,456,2,0,0,0,0,4,6
151072,9,456,2,0,0,0,0,4,6
167211,9,302,6,0,0,0,0,13,19
77468,5,76,7,0,0,0,0,12,19
48048,8,489,1,0,0,0,0,5,6
127209,7,448,2,0,0,0,0,11,13
130999,7,448,0,0,0,0,0,4,4
132028,5,200,4,0,0,0,0,7,11
72517,9,449,2,0,0,0,0,3,5
133922,7,118,2,0,0,0,0,4,6
25440,4,306,4,0,0,0,0,10,14
95363,5,200,2,0,0,0,0,11,13
152102,9,145,2,0,0,0,0,6,8
84960,4,200,50,0,0,0,0,91,141
100429,9,145,2,0,0,0,0,4,6
59324,8,489,1,0,0,0,0,0,1
43160,7,374,2,0,0,0,0,3,5
68716,7,207,6,0,0,0,0,14,20
118431,7,148,2,0,0,0,0,3,5
16365,11,214,1,0,0,0,0,0,1
19396,9,640,8,0,0,0,0,17,25
52249,4,200,193,0,0,0,1,350,544
70979,9,570,2,0,0,0,0,4,6
134353,4,200,216,0,0,0,4,428,648
155189,9,79,2,0,0,0,0,4,6
93654,10,653,5,0,0,0,0,13,18
74878,11,214,2,0,0,0,0,2,4
52974,7,693,5,1,0,0,0,11,17
1169,4,365,2,0,0,0,0,2,4
100176,4,679,2,0,0,0,0,2,4
87440,9,489,6,0,0,0,0,4,10
5992,6,821,5,0,0,0,1,7,13
148976,6,821,5,0,0,0,1,10,16
40187,6,821,2,1,0,0,1,5,9
139177,6,821,2,0,0,0,1,5,8
25488,4,36,8,0,0,0,0,15,23
144848,11,677,4,0,0,0,0,4,8
10561,7,748,0,0,0,0,0,4,4
95247,8,306,4,0,0,0,0,4,8
154945,5,455,0,1,0,0,0,0,1
108644,9,838,2,0,0,0,0,4,6
156237,10,111,1,0,0,0,0,1,2
132114,10,111,1,0,0,0,0,1,2
155059,8,489,1,0,0,0,0,0,1
140290,11,545,1,0,0,0,0,0,1
72703,9,374,1,0,0,0,0,3,4
110352,9,374,1,0,0,0,0,2,3
105472,9,469,1,0,0,0,0,1,2
140099,9,374,1,1,0,0,0,2,4
6079,9,374,1,0,0,0,0,1,2
67364,7,232,1,1,0,0,0,3,5
113329,5,225,13,0,0,0,0,22,35
144566,8,800,2,0,0,0,0,0,2
34983,11,214,0,1,0,0,0,0,1
68880,7,448,0,0,0,0,0,6,6
32063,7,448,0,0,0,0,0,4,4
168890,7,448,0,0,0,0,0,4,4
58738,7,611,2,0,0,0,0,3,5
150075,7,508,2,0,0,0,0,3,5
49068,7,611,10,0,0,0,0,7,17
67437,6,141,2,0,0,0,0,3,5
156228,9,456,2,0,0,0,0,3,5
166500,5,78,1,0,0,0,0,2,3
162710,5,58,6,2,0,0,0,12,20
165317,6,200,2,0,0,0,0,6,8
86400,7,587,2,0,0,0,0,3,5
122553,8,489,2,0,0,0,0,7,9
119493,10,868,2,0,0,0,0,2,4
18267,9,456,1,0,0,0,0,0,1
134791,6,643,1,0,0,0,0,1,2
97168,7,892,2,0,0,0,0,2,4
115156,5,885,1,0,0,0,0,0,1
18809,7,741,24,0,0,0,0,30,54
143003,4,36,5,0,0,0,0,10,15
139595,9,630,1,0,0,0,0,0,1
121811,8,677,208,0,0,0,1,353,562
86083,9,100,2,0,0,0,0,5,7
79130,10,586,13,0,0,0,0,15,28
21133,10,917,1,0,0,0,0,0,1
61882,11,623,1,0,0,0,0,0,1
75661,9,773,1,0,0,0,0,3,4
144345,9,819,6,0,0,0,0,13,19
94733,8,244,1,0,0,0,0,0,1
83118,9,630,5,1,0,0,0,12,18
130120,9,314,1,0,0,0,0,1,2
106415,4,137,1,0,0,0,0,1,2
169451,5,800,1,0,0,0,0,3,4
169300,4,800,3,0,0,0,0,0,3
118121,8,214,16,0,0,0,0,29,45
147249,9,387,0,0,0,0,0,3,3
37790,8,214,3,0,0,0,0,22,25
109662,4,375,3,0,0,0,0,0,3
97588,9,399,1,0,0,0,0,2,3
103608,7,630,1,0,0,0,0,2,3
143942,5,4,1,0,0,0,0,0,1
63457,8,214,20,1,0,0,0,72,93
2762,9,360,1,0,0,0,0,3,4
156167,9,360,1,0,0,0,0,2,3
59513,9,360,1,0,0,0,0,3,4
47596,6,643,8,0,0,0,0,9,17
43042,10,256,6,0,0,0,0,8,14
165870,9,360,2,0,0,0,0,6,8
47000,4,679,22,0,0,0,0,48,70
64062,8,214,2,0,0,0,0,3,5
126131,9,819,2,0,0,0,0,6,8
108954,7,641,6,0,0,0,0,19,25
26599,9,387,16,1,0,0,0,24,41
70725,6,643,32,0,0,0,0,43,75
11378,4,752,1,0,0,0,0,0,1
43024,7,587,3,0,0,0,0,0,3
9480,10,917,4,0,0,0,0,8,12
155724,4,885,1,0,0,0,0,0,1
63484,5,427,1,0,0,0,0,2,3
76944,9,315,4,0,0,0,0,6,10
28392,9,813,1,0,0,0,0,0,1
111673,11,677,1,0,0,0,0,0,1
93690,8,214,20,0,0,0,0,39,59
114275,8,885,4,0,0,0,0,4,8
150248,10,628,14,0,0,0,0,20,34
7847,10,628,3,0,0,0,0,7,10
56355,10,628,0,0,0,0,0,5,5
161184,5,347,6,0,0,0,0,11,17
37515,8,214,19,0,0,0,0,64,83
157005,10,917,1,0,0,0,0,2,3
78865,10,917,1,0,0,0,0,4,5
34443,8,885,2,0,0,0,0,1,3
4140,9,100,6,0,0,0,0,14,20
144654,11,214,2,0,0,0,0,3,5
17009,9,489,11,0,0,0,0,10,21
148951,9,640,6,0,0,0,0,11,17
56911,8,214,29,0,0,0,0,55,84
136789,10,798,1,0,0,0,0,2,3
144701,5,783,2,0,0,0,0,3,5
148092,7,872,8,0,0,0,0,16,24
121637,5,78,2,0,0,0,0,4,6
102035,9,151,4,0,0,0,0,10,14
40708,10,628,2,0,0,0,0,6,8
118473,7,731,2,0,0,0,0,3,5
164080,9,469,4,0,0,0,0,4,8
98187,8,214,2,0,0,0,0,5,7
66125,11,214,2,0,0,0,0,2,4
102200,9,842,0,0,0,0,0,2,2
149791,10,917,2,0,0,0,0,4,6
159305,4,159,1,0,0,0,0,0,1
128325,9,380,2,0,0,0,0,3,5
157229,4,159,85,6,3,0,0,173,267
44109,9,429,2,0,0,0,0,7,9
31604,5,479,68,1,0,0,0,108,177
53308,9,630,2,0,0,0,0,3,5
26221,9,510,6,0,0,0,0,5,11
74973,7,484,2,0,0,0,0,7,9
155665,7,484,8,0,0,0,0,16,24
100927,5,783,2,0,0,0,0,4,6
158052,5,699,1,0,0,0,0,2,3
39100,7,224,5,0,0,0,0,11,16
100970,7,224,7,0,0,0,0,22,29
28923,9,100,2,0,0,0,0,4,6
30930,7,508,2,0,0,0,0,4,6
142726,7,148,2,0,0,0,0,3,5
135606,9,575,2,0,0,0,0,8,10
118369,6,131,6,0,0,0,0,16,22
103399,10,621,1,0,0,0,0,4,5
51014,7,484,2,0,0,0,0,3,5
168009,7,226,2,0,0,0,0,3,5
137355,8,306,1,0,0,0,0,3,4
6953,9,842,8,0,0,0,0,7,15
72914,8,214,15,0,0,0,0,19,34
100975,4,137,2,0,0,0,0,4,6
26419,11,489,1,0,0,0,0,3,4
23031,9,100,2,0,0,0,0,0,2
163286,9,100,14,0,0,0,0,12,26
157266,10,29,2,0,0,0,0,4,6
142284,9,819,5,0,0,0,0,6,11
2703,7,367,2,0,0,0,0,5,7
25498,6,131,14,0,0,0,0,21,35
80546,6,131,4,0,0,0,0,4,8
155736,10,799,2,0,0,0,0,4,6
83568,10,66,2,0,0,0,0,3,5
81324,6,643,6,0,0,0,0,13,19
32461,8,214,1,0,0,0,0,0,1
4830,9,873,2,0,0,0,0,4,6
19728,10,799,2,0,0,0,0,3,5
149552,10,355,2,0,0,0,0,4,6
22131,10,413,1,0,0,0,0,0,1
167261,8,489,1,0,0,0,0,0,1
127002,10,918,1,0,0,0,0,0,1
122602,10,798,1,0,0,0,0,2,3
19841,11,214,1,0,0,0,0,0,1
126636,10,798,1,0,0,0,0,1,2
149819,6,59,2,0,0,0,0,7,9
61529,7,387,1,0,0,0,0,5,6
73376,6,347,2,0,0,0,0,5,7
108544,9,874,2,0,0,0,0,3,5
12853,8,214,31,1,1,0,0,49,82
55661,11,214,1,0,0,0,0,0,1
99308,8,214,1,0,0,0,0,4,5
81420,4,885,6,0,0,0,0,10,16
143486,4,461,1,0,0,0,0,0,1
119210,7,211,1,0,0,0,0,0,1
150771,9,874,1,0,0,0,0,1,2
28929,9,387,0,0,0,0,0,4,4
125136,7,367,6,0,0,0,0,9,15
116009,8,885,6,0,0,0,0,10,16
69778,8,885,31,0,0,0,1,56,88
4151,9,387,2,0,0,0,0,0,2
10766,9,387,4,1,0,1,0,8,14
130426,9,387,3,1,0,0,0,8,12
70972,5,489,6,0,0,0,0,12,18
127121,11,623,4,0,0,0,0,4,8
113651,8,214,1,0,0,0,0,2,3
162666,9,483,3,0,0,0,0,4,7
90939,4,752,3,0,0,0,0,1,4
168790,8,623,3,0,0,0,0,0,3
56104,4,453,3,0,0,0,0,0,3
20783,9,380,2,0,0,0,0,2,4
164268,9,429,2,0,0,0,0,2,4
121222,4,800,1,0,0,0,0,4,5
21361,5,371,2,0,0,0,0,5,7
59484,9,374,9,0,0,0,0,2,11
37556,9,632,1,0,0,0,0,1,2
105218,9,100,1,0,0,0,0,4,5
19998,9,378,2,0,0,0,0,2,4
105826,9,66,4,0,0,0,0,19,23
70535,9,66,0,0,0,0,0,4,4
136381,9,66,2,0,0,0,0,19,21
4196,11,545,1,0,0,0,0,4,5
129591,10,322,1,0,0,0,0,1,2
39763,8,623,1,0,0,0,0,0,1
138809,6,789,2,0,0,0,0,4,6
57619,8,214,111,0,0,0,0,210,321
82972,10,66,2,0,0,0,0,3,5
38130,9,719,2,0,0,0,0,0,2
86451,10,798,2,0,0,0,0,3,5
15405,7,228,2,0,0,0,0,4,6
139687,4,885,16,0,0,0,0,54,70
8299,9,538,15,0,0,0,0,56,71
120843,10,111,48,2,2,0,1,55,108
162672,9,630,60,1,0,0,0,15,76
154125,8,403,2,0,0,0,0,2,4
23875,11,623,3,0,0,0,0,0,3
40133,4,200,1,0,0,0,0,0,1
132082,8,766,28,0,0,0,1,75,104
24613,5,232,12,0,0,0,0,8,20
110648,7,148,2,0,0,0,0,5,7
80924,7,148,2,0,0,0,0,7,9
34341,9,741,1,0,0,0,0,2,3
157656,7,148,2,0,0,0,0,3,5
124316,11,545,1,0,0,0,0,0,1
130953,6,235,1,0,0,0,0,0,1
69872,8,30,1,0,0,0,0,0,1
47427,5,200,2,0,0,0,0,3,5
127911,5,78,7,0,1,0,0,19,27
52462,6,235,1,0,0,0,0,0,1
45647,5,306,2,0,0,0,0,0,2
33830,9,374,2,0,0,0,0,3,5
57960,9,374,2,0,0,0,0,5,7
94485,5,106,1,0,0,0,0,0,1
139653,9,314,2,0,0,0,0,4,6
62431,8,214,2,0,0,0,0,3,5
58395,7,100,4,0,0,0,0,8,12
104271,8,214,1,0,0,0,0,1,2
87477,6,347,3,0,0,0,0,13,16
44057,6,885,8,0,0,0,0,17,25
80015,8,766,9,0,0,0,0,17,26
46381,4,159,5,0,0,0,0,13,18
13282,8,124,12,0,0,0,0,42,54
110427,10,820,2,0,0,0,0,6,8
90277,9,575,2,0,0,0,0,3,5
108471,9,819,2,0,0,0,0,4,6
43009,10,111,4,0,0,0,0,5,9
64890,10,111,2,0,0,0,0,7,9
36653,10,111,4,0,0,0,0,8,12
41927,4,800,19,0,0,0,0,46,65
71785,8,658,1,0,0,0,0,0,1
139690,9,353,2,0,0,0,0,5,7
60164,9,353,2,0,0,0,0,7,9
136207,7,157,4,0,0,0,0,6,10
95231,7,157,3,0,0,0,0,6,9
46361,10,111,3,0,0,0,0,8,11
50482,8,489,159,9,1,1,0,275,445
88735,5,489,2,0,0,0,0,4,6
108637,6,800,14,0,0,0,0,39,53
170684,10,903,8,0,0,0,0,24,32
56487,9,100,2,0,0,0,0,3,5
17103,5,885,78,4,0,0,0,137,219
119133,9,243,2,0,0,0,0,1,3
138393,9,374,3,1,0,0,0,9,13
9083,9,374,3,0,0,0,0,7,10
76179,6,131,9,0,0,0,0,11,20
103147,8,214,130,2,2,0,0,192,326
144055,9,570,2,0,0,0,0,4,6
145365,9,556,1,0,0,0,0,2,3
38665,8,214,100,0,0,0,0,147,247
163645,4,679,971,22,10,0,4,1902,2909
79371,4,679,18,1,0,0,0,36,55
108099,9,489,4,0,0,0,0,4,8
113734,4,200,19,3,1,0,0,31,54
107510,10,66,2,0,0,0,0,2,4
144511,10,66,1,0,0,0,0,1,2
45864,8,766,5,0,0,0,0,10,15
22224,5,667,5,0,0,0,0,6,11
109432,10,618,2,0,0,0,0,4,6
63916,9,387,1,0,0,0,0,0,1
158013,8,214,25,0,0,0,0,49,74
81465,8,693,2,0,0,0,0,1,3
129658,6,263,4,0,0,0,0,4,8
156963,10,781,10,0,0,0,0,24,34
43061,8,214,69,0,0,0,0,121,190
147292,8,124,3,0,0,0,0,3,6
121725,8,124,1,0,0,0,0,0,1
154534,8,124,3,0,0,0,0,1,4
58968,8,214,1,0,0,0,0,2,3
98709,8,214,1,0,0,0,0,0,1
140997,8,214,1,0,0,0,0,0,1
119386,8,214,1,0,0,0,0,0,1
15694,8,596,1,0,0,0,0,0,1
65676,8,124,1,0,0,0,0,0,1
94580,8,124,1,0,0,0,0,0,1
167605,8,124,1,0,0,0,0,0,1
63774,8,306,1,0,0,0,0,0,1
81598,8,306,1,0,0,0,0,0,1
14042,5,489,2,0,0,0,0,4,6
147257,8,306,1,0,0,0,0,0,1
31755,10,549,8,0,0,0,0,7,15
163639,8,766,3,0,0,0,1,18,22
150230,9,387,15,1,1,0,0,56,73
145449,9,387,7,0,0,0,0,8,15
87562,4,375,61,2,0,0,0,125,188
165106,8,214,1,0,0,0,0,0,1
170042,8,214,1,0,0,0,0,0,1
164483,7,56,1,0,0,0,0,2,3
26591,5,66,4,0,0,0,0,5,9
14947,4,658,1,0,0,0,0,0,1
22847,4,174,1,0,0,0,0,0,1
103607,9,575,1,0,0,0,0,1,2
77828,9,575,1,0,0,0,0,2,3
108851,4,679,8,0,0,0,0,15,23
45960,8,306,2,0,0,0,0,0,2
41524,10,322,1,0,0,0,0,1,2
34609,10,322,1,0,0,0,0,1,2
54041,4,375,16,0,0,0,0,36,52
72364,9,374,4,0,0,0,0,7,11
101614,4,375,22,0,0,0,0,30,52
103967,6,200,1,0,0,0,0,2,3
80087,11,214,0,2,0,0,0,0,2
167323,5,200,2,0,0,0,0,3,5
24625,11,214,1,0,0,0,0,0,1
56530,8,403,2,0,0,0,0,3,5
92899,9,640,6,0,0,0,0,12,18
128680,4,780,2,0,0,0,0,0,2
15047,7,79,2,0,0,0,0,8,10
64542,6,200,6,0,0,0,0,10,16
84240,9,100,4,0,0,0,0,11,15
86522,6,124,14,1,1,0,0,49,65
142196,8,489,36,5,0,0,0,149,190
125724,7,630,0,0,0,0,0,15,15
140380,4,174,9,0,0,0,0,36,45
52699,11,545,8,0,0,0,0,12,20
130306,6,174,1,0,0,0,0,9,10
77588,6,174,8,0,0,0,0,15,23
111238,6,235,4,0,0,0,0,8,12
152954,9,589,3,0,0,0,0,2,5
130169,10,466,2,0,0,0,0,4,6
124086,7,589,2,0,0,0,0,3,5
161988,7,246,2,0,0,0,0,4,6
82352,6,885,1,0,0,0,0,1,2
137063,9,42,2,0,0,0,0,4,6
74644,9,538,6,0,0,0,0,10,16
44850,10,903,0,0,0,0,0,4,4
47094,9,8,2,0,0,0,0,7,9
26042,5,479,2,0,0,0,0,7,9
148739,5,885,1,0,0,0,0,1,2
67815,8,800,8,0,0,0,1,17,26
54260,6,537,2,0,0,0,0,4,6
38064,7,100,2,0,0,0,0,7,9
79428,7,731,4,0,0,0,0,8,12
88839,9,630,0,0,0,0,0,12,12
132652,9,630,1,0,0,0,0,5,6
115393,7,731,0,0,0,0,0,8,8
56576,7,731,0,0,0,0,0,4,4
84272,10,779,4,0,0,0,0,7,11
21564,4,885,1,0,0,0,0,2,3
98500,8,885,1,0,0,0,0,4,5
7269,8,214,97,0,0,0,0,182,279
60085,7,484,0,0,0,0,0,7,7
15113,11,214,2,0,0,0,0,2,4
157368,9,42,4,0,0,0,0,9,13
110105,10,911,4,0,0,0,0,10,14
165012,4,200,9,0,0,0,0,10,19
54509,4,200,8,0,0,0,0,0,8
101527,6,514,4,0,0,0,0,7,11
22528,9,100,0,0,0,0,0,4,4
16768,4,159,1,0,0,0,0,0,1
5698,6,131,4,0,0,0,0,8,12
87345,7,157,4,0,0,0,0,5,9
41,9,489,2,0,0,0,0,4,6
110511,8,766,2,0,0,0,0,3,5
156639,8,885,7,0,0,0,0,20,27
60319,6,347,4,0,0,0,0,2,6
94089,11,812,2,0,0,0,0,2,4
147888,10,917,0,0,0,0,0,6,6
8300,9,640,3,0,0,0,0,4,7
74563,10,603,2,0,0,0,0,9,11
40311,10,603,2,0,0,0,0,2,4
33779,7,80,8,0,0,0,0,13,21
120370,10,111,2,0,0,0,0,3,5
138261,10,256,2,0,0,0,0,3,5
163999,10,549,1,0,0,0,0,0,1
17635,9,640,2,0,0,0,0,6,8
81377,10,322,2,0,0,0,0,4,6
45862,10,322,4,1,0,0,0,6,11
51920,10,322,2,0,0,0,0,4,6
143780,4,679,2,0,0,0,0,4,6
47082,7,587,2,0,0,0,0,3,5
78196,10,111,3,0,0,0,0,4,7
145826,8,124,1,0,0,0,0,5,6
99997,4,200,6,0,0,0,0,10,16
150221,4,174,8,0,0,0,0,13,21
56326,7,175,6,0,0,0,0,14,20
78756,7,175,0,1,0,0,0,12,13
62956,7,175,0,0,0,0,0,4,4
49728,7,175,0,1,1,0,0,4,6
124042,5,174,7,0,0,0,0,12,19
61456,9,243,7,4,1,1,0,38,51
163034,11,306,1,0,0,0,0,0,1
10497,5,479,6,0,0,0,0,15,21
140540,8,766,3,0,0,0,0,5,8
18786,8,623,4,0,0,0,0,7,11
133420,4,200,3,0,0,0,0,4,7
17279,10,628,1,0,0,0,0,3,4
101903,8,214,118,0,0,0,0,216,334
144311,7,312,1,0,0,0,0,2,3
167287,4,658,0,0,0,0,0,1,1
49418,7,427,1,0,0,0,0,0,1
136643,10,799,4,0,0,0,0,8,12
21683,9,630,2,0,0,0,0,1,3
160936,10,841,8,0,0,0,0,15,23
155969,11,214,2,0,0,0,0,3,5
109371,9,65,0,0,0,0,0,9,9
153963,4,159,6,0,0,0,0,12,18
153250,9,489,4,0,0,0,0,5,9
52075,6,306,1,0,0,0,0,2,3
79445,6,269,8,1,0,0,0,28,37
39381,11,658,1,0,0,0,0,2,3
100964,4,885,1,0,0,0,0,0,1
143863,8,214,61,0,0,0,0,91,152
130555,6,800,2,0,0,0,0,8,10
34249,4,752,1,0,0,0,0,0,1
62543,8,489,89,0,0,0,0,150,239
102040,10,787,2,0,0,0,0,4,6
63970,9,157,6,1,0,0,0,19,26
52858,10,66,4,0,0,0,0,23,27
89286,9,577,1,0,0,0,0,2,3
120568,9,577,1,0,0,0,0,1,2
170565,7,61,2,0,0,0,0,6,8
86463,8,800,6,0,0,0,0,9,15
27358,4,36,4,0,0,0,0,13,17
77311,11,214,6,1,0,0,0,3,10
48654,9,489,4,0,0,0,0,6,10
96055,8,306,1,0,0,0,0,1,2
37115,4,885,19,0,0,0,0,31,50
79401,9,79,2,0,0,0,0,3,5
115658,9,456,2,0,0,0,0,3,5
85465,4,519,63,1,0,0,0,134,198
167804,4,519,78,1,0,0,0,154,233
102466,6,117,3,0,0,0,0,6,9
31056,4,519,77,1,0,0,0,129,207
21804,9,487,2,0,0,0,0,4,6
157494,10,555,2,0,0,0,0,4,6
96809,10,903,3,0,0,0,0,8,11
14902,5,800,1,0,0,0,0,1,2
47824,4,658,6,0,0,0,0,8,14
139096,9,315,1,0,0,0,0,1,2
161263,4,602,8,0,0,0,0,14,22
165009,4,36,1,0,0,0,0,1,2
77953,8,403,13,1,1,0,0,16,31
145232,10,628,0,0,0,0,0,4,4
114875,9,375,4,0,0,0,1,14,19
129231,4,658,21,0,0,0,0,41,62
121846,8,306,1,0,0,0,0,0,1
70823,10,917,1,0,0,0,0,0,1
127881,6,103,1,0,0,0,0,1,2
40210,9,117,6,0,0,0,0,9,15
67264,9,117,4,0,0,0,0,9,13
24375,6,453,2,0,0,0,0,13,15
108032,6,347,0,0,0,0,0,11,11
16866,6,235,1,0,0,0,0,6,7
103552,4,453,0,0,0,0,0,4,4
75675,4,453,0,0,0,0,0,6,6
107247,6,165,2,0,0,0,0,4,6
65505,7,864,1,0,0,0,0,2,3
24046,7,864,1,0,0,0,0,2,3
54345,6,269,1,0,0,0,0,1,2
167654,4,602,0,0,0,0,0,4,4
24401,10,111,0,0,0,0,0,6,6
69690,9,630,1,0,0,0,0,1,2
23595,6,366,1,0,0,0,0,1,2
4724,8,30,46,1,0,0,0,82,129
41225,9,556,1,0,0,0,0,0,1
99310,10,797,2,0,0,0,0,4,6
96331,8,30,62,2,0,0,1,142,207
116242,5,76,0,0,0,0,0,5,5
44400,5,76,0,0,0,0,0,6,6
146237,5,78,11,0,0,0,0,13,24
77878,8,622,8,0,0,0,0,16,24
15366,5,200,6,2,1,0,0,41,50
79943,4,885,1,0,0,0,0,0,1
121727,4,675,1,0,0,0,0,0,1
126319,11,623,2,0,0,0,0,2,4
84798,4,602,4,0,0,0,0,4,8
116873,4,159,2,0,0,0,0,3,5
154776,8,885,12,1,0,0,0,21,34
68956,5,200,0,0,0,0,0,4,4
16752,5,200,2,0,0,0,0,8,10
159893,7,800,0,0,0,0,0,3,3
157271,4,602,0,0,0,0,0,3,3
58245,8,30,2,0,0,0,0,4,6
115625,7,741,2,0,0,0,0,4,6
59315,4,602,2,0,0,0,0,9,11
143611,9,367,2,0,0,0,0,4,6
23982,10,357,2,0,0,0,0,3,5
153239,9,838,0,0,0,0,0,4,4
12914,9,838,0,0,0,0,0,4,4
166154,6,174,5,0,0,1,2,14,22
166170,6,78,5,0,0,0,0,6,11
33727,4,658,6,0,0,0,0,9,15
151640,8,885,7,0,0,0,0,5,12
125405,7,587,2,0,0,0,0,3,5
71896,11,214,3,0,0,0,0,5,8
154187,10,903,12,2,1,0,0,18,33
114527,9,302,1,0,0,0,0,4,5
107543,7,56,2,0,0,0,0,6,8
133547,7,56,1,0,0,0,0,3,4
60817,7,56,2,1,0,0,0,6,9
10222,7,100,2,0,0,0,0,4,6
31322,10,178,1,0,0,0,0,7,8
17563,8,214,24,0,0,0,0,31,55
56368,5,489,1,0,0,0,0,1,2
85696,10,831,2,0,0,0,0,3,5
102302,10,831,2,0,0,0,0,4,6
118568,8,885,2,1,0,0,0,2,5
70172,8,885,2,1,0,0,0,5,8
85836,8,489,4,0,0,0,0,21,25
75539,8,214,178,6,0,0,1,299,484
113233,6,261,10,0,0,0,0,90,100
123063,4,200,2,0,0,0,0,2,4
129091,8,489,26,0,0,0,0,67,93
130923,10,586,1,0,0,0,0,1,2
106194,8,622,4,0,0,0,0,7,11
2811,8,622,4,0,0,0,0,9,13
138201,10,617,4,0,0,0,1,10,15
60712,4,375,28,1,0,0,0,47,76
134201,7,496,4,0,0,0,0,4,8
111047,7,496,4,0,0,0,0,4,8
89028,7,373,2,0,0,0,0,4,6
95894,6,200,2,0,0,0,0,4,6
33985,7,611,2,0,0,0,0,4,6
166278,11,214,3,2,0,0,0,2,7
134915,10,603,0,0,0,0,0,4,4
128381,4,159,0,0,0,0,0,4,4
9283,10,66,0,1,1,0,0,8,10
155355,6,269,10,0,0,0,0,16,26
63099,8,885,2,0,0,0,0,1,3
24002,11,623,3,0,0,0,0,4,7
42028,9,750,2,0,0,0,0,3,5
29226,11,403,3,0,0,0,0,10,13
6867,11,214,3,0,0,0,0,7,10
117969,7,367,1,0,0,0,0,2,3
7903,11,214,7,0,0,0,0,3,10
38279,10,628,1,0,0,0,0,2,3
53964,10,781,1,0,0,0,0,1,2
24518,10,831,2,0,0,0,0,7,9
126826,10,178,1,0,0,0,0,1,2
43662,5,489,3,0,0,0,0,3,6
135939,6,885,1,0,0,0,0,3,4
76477,10,628,1,0,0,0,0,1,2
41015,10,831,2,0,0,0,0,7,9
52824,10,81,4,0,0,0,0,8,12
34682,10,722,1,0,0,0,0,1,2
68555,9,469,1,0,0,0,0,1,2
63683,10,111,6,0,0,0,0,9,15
107017,8,214,2,0,0,0,0,3,5
128039,6,165,2,0,0,0,0,3,5
2278,8,214,1,0,0,0,0,2,3
151230,8,885,4,0,0,0,0,7,11
130435,9,216,8,0,0,0,0,13,21
1885,8,214,4,0,0,0,0,6,10
103677,4,519,25,0,0,0,0,19,44
91833,7,535,13,0,0,0,0,20,33
158878,8,885,1,0,0,0,0,0,1
66242,8,214,4,0,0,0,0,9,13
24416,9,575,2,0,0,0,0,0,2
38976,8,214,1,0,0,0,0,5,6
2964,8,214,2,0,0,0,0,4,6
151862,8,30,1,0,0,0,0,0,1
169088,7,731,1,0,0,0,0,1,2
94703,8,214,33,1,0,0,2,45,81
134126,7,824,2,0,0,0,0,4,6
142794,8,800,1,0,0,0,0,1,2
135266,8,214,18,0,0,0,0,34,52
139931,8,214,12,0,0,0,0,27,39
113040,5,66,2,0,0,0,0,3,5
93236,11,214,2,0,0,0,0,2,4
58911,11,214,2,0,0,0,0,1,3
77163,9,387,5,0,0,0,0,5,10
21282,10,66,4,0,0,0,0,5,9
97731,9,95,2,0,0,0,0,3,5
10812,6,537,2,0,0,0,0,2,4
25197,7,521,1,0,0,0,0,0,1
77496,8,489,5,0,0,0,0,9,14
13153,7,472,2,0,0,0,0,4,6
168210,8,489,4,0,0,0,0,7,11
16259,5,159,2,0,0,0,0,4,6
51894,8,489,4,0,0,0,0,9,13
57561,6,131,4,0,0,0,0,8,12
101898,6,200,2,0,0,0,0,14,16
69731,9,367,2,0,0,0,0,5,7
85824,10,697,2,0,0,0,0,5,7
146648,10,697,2,0,0,0,0,6,8
17080,4,602,1,0,0,0,0,1,2
151289,8,214,0,0,0,0,0,8,8
57171,10,159,1,0,0,0,0,0,1
163090,10,256,12,2,0,0,0,16,30
160615,9,158,2,0,0,0,0,5,7
131881,5,225,1,0,0,0,0,1,2
124493,6,124,3,0,0,0,0,4,7
117891,5,479,6,0,0,0,0,6,12
123620,4,375,0,0,0,0,0,5,5
81242,4,800,1,0,0,0,0,2,3
86355,9,315,2,0,0,0,0,6,8
88558,11,214,6,0,0,0,0,2,8
2805,10,831,0,0,0,0,0,4,4
165796,5,800,2,0,0,0,0,3,5
93952,8,403,9,0,0,0,0,11,20
119147,7,74,1,0,0,0,0,1,2
21996,8,403,8,1,0,0,0,15,24
47645,10,799,1,0,0,0,0,2,3
2259,10,799,4,0,0,0,0,4,8
67986,10,799,3,0,0,0,0,5,8
10934,10,701,1,0,0,0,0,0,1
124946,10,799,1,0,0,0,0,3,4
137672,6,78,1,0,0,0,0,0,1
60586,8,885,3,1,0,0,0,6,10
35371,4,602,0,0,0,0,1,0,1
104127,8,489,1,0,0,0,0,0,1
115970,8,885,2,0,0,0,0,3,5
21499,5,479,6,0,0,0,0,5,11
127696,5,479,8,0,0,0,0,14,22
145291,7,224,5,0,0,0,0,5,10
144206,9,158,0,0,0,0,0,5,5
102211,6,420,2,0,0,0,0,4,6
886,8,489,4,0,0,0,0,9,13
141540,7,773,1,0,0,0,0,3,4
104732,7,773,1,0,0,0,0,1,2
107147,5,479,1,0,0,0,0,0,1
95944,5,775,1,0,0,0,0,1,2
75727,7,587,2,0,0,0,0,4,6
31537,11,306,0,0,0,0,0,1,1
87789,8,214,0,0,0,0,0,10,10
58281,4,602,2,0,0,0,0,8,10
116285,8,214,6,0,0,0,0,9,15
369,8,214,2,0,0,0,0,3,5
142316,10,66,4,0,0,0,0,20,24
136125,9,535,2,0,0,0,0,5,7
39022,5,200,2,0,0,0,0,3,5
8741,5,885,2,0,0,0,0,8,10
126625,11,214,2,0,0,0,0,1,3
157851,8,885,2,0,0,0,0,4,6
30114,9,483,2,0,0,0,0,3,5
53569,9,483,1,0,0,0,0,1,2
135136,9,387,1,0,0,0,0,0,1
41616,9,560,2,0,0,0,0,4,6
6638,8,214,2,0,0,0,0,3,5
98565,8,214,2,0,0,0,0,0,2
76381,9,202,1,0,0,0,0,1,2
47852,6,489,2,0,0,0,0,4,6
85929,5,489,8,0,0,0,0,12,20
164334,9,526,1,0,0,0,0,0,1
46107,6,159,4,0,0,0,0,5,9
99186,7,896,6,0,0,0,0,15,21
106158,7,896,2,0,0,0,0,4,6
45054,5,159,2,0,0,0,0,4,6
35270,8,90,2,0,0,0,0,4,6
111450,4,200,4,0,0,0,0,7,11
28165,11,214,2,0,0,0,0,1,3
164006,4,602,2,0,0,0,0,3,5
112715,10,66,2,0,0,0,0,3,5
141501,5,479,1,0,0,0,0,2,3
128818,10,628,2,0,0,0,0,4,6
13308,8,885,4,0,0,0,0,10,14
1668,9,842,4,1,1,0,0,6,12
68045,10,111,1,0,0,0,0,0,1
80319,8,403,1,0,0,0,0,1,2
156490,8,214,12,0,0,0,0,13,25
72772,8,214,0,0,0,0,0,3,3
123218,8,214,0,0,0,0,0,4,4
158117,11,214,6,0,0,0,0,6,12
10460,11,489,1,0,0,0,0,2,3
80466,10,917,2,1,0,0,0,3,6
72516,10,256,2,0,0,0,0,3,5
36490,8,214,7,0,0,0,0,8,15
62738,8,403,1,0,0,0,0,1,2
151684,6,174,2,0,0,0,0,4,6
126851,4,453,1,0,0,0,0,0,1
74765,11,214,2,0,0,0,0,2,4
95157,11,489,1,0,0,0,0,0,1
11278,9,367,1,0,0,0,0,1,2
113891,9,538,6,0,0,0,0,5,11
34636,8,885,1,0,0,0,0,1,2
117323,5,174,4,0,0,0,0,6,10
133744,6,159,2,0,0,0,0,3,5
